game_id,alt_game_id,season,week,gameday,weekday,gametime,away_team,away_score,home_team,home_score,location,result,total,gsis,pfr,pff
2006090700,2006_01_MIA_PIT,2006,1,2006-09-07,Thursday,20:30,MIA,17,PIT,28,Home,11,45,28861,200609070pit,3758
2006091000,2006_01_ATL_CAR,2006,1,2006-09-10,Sunday,13:00,ATL,20,CAR,6,Home,-14,26,28862,200609100car,3693
2006091001,2006_01_NO_CLE,2006,1,2006-09-10,Sunday,13:00,NO,19,CLE,14,Home,-5,33,28863,200609100cle,3746
2006091002,2006_01_SEA_DET,2006,1,2006-09-10,Sunday,13:00,SEA,9,DET,6,Home,-3,15,28864,200609100det,3747
2006091003,2006_01_PHI_HOU,2006,1,2006-09-10,Sunday,13:00,PHI,24,HOU,10,Home,-14,34,28866,200609100htx,3748
2006091004,2006_01_CIN_KC,2006,1,2006-09-10,Sunday,13:00,CIN,23,KC,10,Home,-13,33,28867,200609100kan,3749
2006091005,2006_01_BUF_NE,2006,1,2006-09-10,Sunday,13:00,BUF,17,NE,19,Home,2,36,28868,200609100nwe,3759
2006091006,2006_01_DEN_STL,2006,1,2006-09-10,Sunday,13:00,DEN,10,STL,18,Home,8,28,28869,200609100ram,3692
2006091007,2006_01_BAL_TB,2006,1,2006-09-10,Sunday,13:00,BAL,27,TB,0,Home,-27,27,28870,200609100tam,3750
2006091008,2006_01_NYJ_TEN,2006,1,2006-09-10,Sunday,13:00,NYJ,23,TEN,16,Home,-7,39,28871,200609100oti,3751
2006091009,2006_01_SF_ARI,2006,1,2006-09-10,Sunday,16:15,SF,27,ARI,34,Home,7,61,28874,200609100crd,3752
2006091010,2006_01_CHI_GB,2006,1,2006-09-10,Sunday,16:15,CHI,26,GB,0,Home,-26,26,28865,200609100gnb,3753
2006091011,2006_01_DAL_JAX,2006,1,2006-09-10,Sunday,16:15,DAL,17,JAX,24,Home,7,41,28872,200609100jax,3754
2006091012,2006_01_IND_NYG,2006,1,2006-09-10,Sunday,20:15,IND,26,NYG,21,Home,-5,47,28873,200609100nyg,3755
2006091100,2006_01_MIN_WAS,2006,1,2006-09-11,Monday,19:00,MIN,19,WAS,16,Home,-3,35,28876,200609110was,3756
2006091101,2006_01_SD_OAK,2006,1,2006-09-11,Monday,22:15,SD,27,OAK,0,Home,-27,27,28875,200609110rai,3757
2006091700,2006_02_TB_ATL,2006,2,2006-09-17,Sunday,13:00,TB,3,ATL,14,Home,11,17,28877,200609170atl,3760
2006091701,2006_02_OAK_BAL,2006,2,2006-09-17,Sunday,13:00,OAK,6,BAL,28,Home,22,34,28878,200609170rav,3775
2006091702,2006_02_DET_CHI,2006,2,2006-09-17,Sunday,13:00,DET,7,CHI,34,Home,27,41,28879,200609170chi,3774
2006091703,2006_02_CLE_CIN,2006,2,2006-09-17,Sunday,13:00,CLE,17,CIN,34,Home,17,51,28880,200609170cin,3773
2006091704,2006_02_NO_GB,2006,2,2006-09-17,Sunday,13:00,NO,34,GB,27,Home,-7,61,28881,200609170gnb,3772
2006091705,2006_02_HOU_IND,2006,2,2006-09-17,Sunday,13:00,HOU,24,IND,43,Home,19,67,28882,200609170clt,3771
2006091706,2006_02_BUF_MIA,2006,2,2006-09-17,Sunday,13:00,BUF,16,MIA,6,Home,-10,22,28883,200609170mia,3770
2006091707,2006_02_CAR_MIN,2006,2,2006-09-17,Sunday,13:00,CAR,13,MIN,16,Home,3,29,28884,200609170min,3769
2006091708,2006_02_NYG_PHI,2006,2,2006-09-17,Sunday,13:00,NYG,30,PHI,24,Home,-6,54,28885,200609170phi,3768
2006091709,2006_02_STL_SF,2006,2,2006-09-17,Sunday,16:05,STL,13,SF,20,Home,7,33,28890,200609170sfo,3767
2006091710,2006_02_ARI_SEA,2006,2,2006-09-17,Sunday,16:05,ARI,10,SEA,21,Home,11,31,28891,200609170sea,3766
2006091711,2006_02_KC_DEN,2006,2,2006-09-17,Sunday,16:15,KC,6,DEN,9,Home,3,15,28886,200609170den,3765
2006091712,2006_02_NE_NYJ,2006,2,2006-09-17,Sunday,16:15,NE,24,NYJ,17,Home,-7,41,28888,200609170nyj,3764
2006091713,2006_02_TEN_SD,2006,2,2006-09-17,Sunday,16:15,TEN,7,SD,40,Home,33,47,28889,200609170sdg,3763
2006091714,2006_02_WAS_DAL,2006,2,2006-09-17,Sunday,20:15,WAS,10,DAL,27,Home,17,37,28887,200609170dal,3762
2006091800,2006_02_PIT_JAX,2006,2,2006-09-18,Monday,20:30,PIT,0,JAX,9,Home,9,9,28892,200609180jax,3761
2006092400,2006_03_NYJ_BUF,2006,3,2006-09-24,Sunday,13:00,NYJ,28,BUF,20,Home,-8,48,28893,200609240buf,3776
2006092401,2006_03_GB_DET,2006,3,2006-09-24,Sunday,13:00,GB,31,DET,24,Home,-7,55,28895,200609240det,3788
2006092402,2006_03_WAS_HOU,2006,3,2006-09-24,Sunday,13:00,WAS,31,HOU,15,Home,-16,46,28896,200609240htx,3777
2006092403,2006_03_JAX_IND,2006,3,2006-09-24,Sunday,13:00,JAX,14,IND,21,Home,7,35,28897,200609240clt,3778
2006092404,2006_03_TEN_MIA,2006,3,2006-09-24,Sunday,13:00,TEN,10,MIA,13,Home,3,23,28898,200609240mia,3779
2006092405,2006_03_CHI_MIN,2006,3,2006-09-24,Sunday,13:00,CHI,19,MIN,16,Home,-3,35,28899,200609240min,3780
2006092406,2006_03_CIN_PIT,2006,3,2006-09-24,Sunday,13:00,CIN,28,PIT,20,Home,-8,48,28900,200609240pit,3781
2006092407,2006_03_CAR_TB,2006,3,2006-09-24,Sunday,13:00,CAR,26,TB,24,Home,-2,50,28901,200609240tam,3782
2006092408,2006_03_BAL_CLE,2006,3,2006-09-24,Sunday,16:05,BAL,15,CLE,14,Home,-1,29,28894,200609240cle,3783
2006092409,2006_03_STL_ARI,2006,3,2006-09-24,Sunday,16:15,STL,16,ARI,14,Home,-2,30,28904,200609240crd,3784
2006092410,2006_03_PHI_SF,2006,3,2006-09-24,Sunday,16:15,PHI,38,SF,24,Home,-14,62,28905,200609240sfo,3785
2006092411,2006_03_NYG_SEA,2006,3,2006-09-24,Sunday,16:15,NYG,30,SEA,42,Home,12,72,28902,200609240sea,3786
2006092412,2006_03_DEN_NE,2006,3,2006-09-24,Sunday,20:15,DEN,17,NE,7,Home,-10,24,28903,200609240nwe,3787
2006092500,2006_03_ATL_NO,2006,3,2006-09-25,Monday,20:30,ATL,3,NO,23,Home,20,26,28906,200609250nor,3789
2006100100,2006_04_ARI_ATL,2006,4,2006-10-01,Sunday,13:00,ARI,10,ATL,32,Home,22,42,28907,200610010atl,3790
2006100101,2006_04_SD_BAL,2006,4,2006-10-01,Sunday,13:00,SD,13,BAL,16,Home,3,29,28908,200610010rav,3791
2006100102,2006_04_MIN_BUF,2006,4,2006-10-01,Sunday,13:00,MIN,12,BUF,17,Home,5,29,28909,200610010buf,3792
2006100103,2006_04_NO_CAR,2006,4,2006-10-01,Sunday,13:00,NO,18,CAR,21,Home,3,39,28910,200610010car,3793
2006100104,2006_04_MIA_HOU,2006,4,2006-10-01,Sunday,13:00,MIA,15,HOU,17,Home,2,32,28911,200610010htx,3794
2006100105,2006_04_SF_KC,2006,4,2006-10-01,Sunday,13:00,SF,0,KC,41,Home,41,41,28912,200610010kan,3795
2006100106,2006_04_IND_NYJ,2006,4,2006-10-01,Sunday,13:00,IND,31,NYJ,28,Home,-3,59,28913,200610010nyj,3796
2006100107,2006_04_DAL_TEN,2006,4,2006-10-01,Sunday,13:00,DAL,45,TEN,14,Home,-31,59,28915,200610010oti,3797
2006100108,2006_04_DET_STL,2006,4,2006-10-01,Sunday,16:05,DET,34,STL,41,Home,7,75,28914,200610010ram,3798
2006100109,2006_04_NE_CIN,2006,4,2006-10-01,Sunday,16:15,NE,38,CIN,13,Home,-25,51,28917,200610010cin,3799
2006100110,2006_04_CLE_OAK,2006,4,2006-10-01,Sunday,16:15,CLE,24,OAK,21,Home,-3,45,28919,200610010rai,3800
2006100111,2006_04_JAX_WAS,2006,4,2006-10-01,Sunday,16:15,JAX,30,WAS,36,Home,6,66,28916,200610010was,3801
2006100112,2006_04_SEA_CHI,2006,4,2006-10-01,Sunday,20:15,SEA,6,CHI,37,Home,31,43,28918,200610010chi,3802
2006100200,2006_04_GB_PHI,2006,4,2006-10-02,Monday,20:30,GB,9,PHI,31,Home,22,40,28920,200610020phi,3803
2006100800,2006_05_CLE_CAR,2006,5,2006-10-08,Sunday,13:00,CLE,12,CAR,20,Home,8,32,28921,200610080car,3804
2006100801,2006_05_BUF_CHI,2006,5,2006-10-08,Sunday,13:00,BUF,7,CHI,40,Home,33,47,28922,200610080chi,3805
2006100802,2006_05_STL_GB,2006,5,2006-10-08,Sunday,13:00,STL,24,GB,21,Home,-3,45,28923,200610080gnb,3806
2006100803,2006_05_TEN_IND,2006,5,2006-10-08,Sunday,13:00,TEN,13,IND,14,Home,1,27,28924,200610080clt,3807
2006100804,2006_05_DET_MIN,2006,5,2006-10-08,Sunday,13:00,DET,17,MIN,26,Home,9,43,28926,200610080min,3808
2006100805,2006_05_MIA_NE,2006,5,2006-10-08,Sunday,13:00,MIA,10,NE,20,Home,10,30,28927,200610080nwe,3809
2006100806,2006_05_TB_NO,2006,5,2006-10-08,Sunday,13:00,TB,21,NO,24,Home,3,45,28928,200610080nor,3810
2006100807,2006_05_WAS_NYG,2006,5,2006-10-08,Sunday,13:00,WAS,3,NYG,19,Home,16,22,28932,200610080nyg,3811
2006100808,2006_05_KC_ARI,2006,5,2006-10-08,Sunday,16:05,KC,23,ARI,20,Home,-3,43,28931,200610080crd,3812
2006100809,2006_05_NYJ_JAX,2006,5,2006-10-08,Sunday,16:05,NYJ,0,JAX,41,Home,41,41,28925,200610080jax,3813
2006100810,2006_05_OAK_SF,2006,5,2006-10-08,Sunday,16:05,OAK,20,SF,34,Home,14,54,28933,200610080sfo,3814
2006100811,2006_05_DAL_PHI,2006,5,2006-10-08,Sunday,16:15,DAL,24,PHI,38,Home,14,62,28929,200610080phi,3815
2006100812,2006_05_PIT_SD,2006,5,2006-10-08,Sunday,20:15,PIT,13,SD,23,Home,10,36,28930,200610080sdg,3816
2006100900,2006_05_BAL_DEN,2006,5,2006-10-09,Monday,20:30,BAL,3,DEN,13,Home,10,16,28934,200610090den,3817
2006101500,2006_06_NYG_ATL,2006,6,2006-10-15,Sunday,13:00,NYG,27,ATL,14,Home,-13,41,28935,200610150atl,3823
2006101501,2006_06_CAR_BAL,2006,6,2006-10-15,Sunday,13:00,CAR,23,BAL,21,Home,-2,44,28936,200610150rav,3824
2006101502,2006_06_HOU_DAL,2006,6,2006-10-15,Sunday,13:00,HOU,6,DAL,34,Home,28,40,28937,200610150dal,3821
2006101503,2006_06_BUF_DET,2006,6,2006-10-15,Sunday,13:00,BUF,17,DET,20,Home,3,37,28938,200610150det,3822
2006101504,2006_06_PHI_NO,2006,6,2006-10-15,Sunday,13:00,PHI,24,NO,27,Home,3,51,28939,200610150nor,3830
2006101505,2006_06_SEA_STL,2006,6,2006-10-15,Sunday,13:00,SEA,30,STL,28,Home,-2,58,28940,200610150ram,3828
2006101506,2006_06_CIN_TB,2006,6,2006-10-15,Sunday,13:00,CIN,13,TB,14,Home,1,27,28941,200610150tam,3829
2006101507,2006_06_TEN_WAS,2006,6,2006-10-15,Sunday,13:00,TEN,25,WAS,22,Home,-3,47,28942,200610150was,3827
2006101508,2006_06_MIA_NYJ,2006,6,2006-10-15,Sunday,16:15,MIA,17,NYJ,20,Home,3,37,28945,200610150nyj,3831
2006101509,2006_06_KC_PIT,2006,6,2006-10-15,Sunday,16:15,KC,7,PIT,45,Home,38,52,28943,200610150pit,3826
2006101510,2006_06_SD_SF,2006,6,2006-10-15,Sunday,16:15,SD,48,SF,19,Home,-29,67,28946,200610150sfo,3825
2006101511,2006_06_OAK_DEN,2006,6,2006-10-15,Sunday,20:15,OAK,3,DEN,13,Home,10,16,28944,200610150den,3820
2006101600,2006_06_CHI_ARI,2006,6,2006-10-16,Monday,20:30,CHI,24,ARI,23,Home,-1,47,28947,200610160crd,3832
2006102200,2006_07_PIT_ATL,2006,7,2006-10-22,Sunday,13:00,PIT,38,ATL,41,Home,3,79,28948,200610220atl,3833
2006102201,2006_07_NE_BUF,2006,7,2006-10-22,Sunday,13:00,NE,28,BUF,6,Home,-22,34,28949,200610220buf,3834
2006102202,2006_07_CAR_CIN,2006,7,2006-10-22,Sunday,13:00,CAR,14,CIN,17,Home,3,31,28950,200610220cin,3835
2006102203,2006_07_JAX_HOU,2006,7,2006-10-22,Sunday,13:00,JAX,7,HOU,27,Home,20,34,28952,200610220htx,3838
2006102204,2006_07_SD_KC,2006,7,2006-10-22,Sunday,13:00,SD,27,KC,30,Home,3,57,28953,200610220kan,3839
2006102205,2006_07_GB_MIA,2006,7,2006-10-22,Sunday,13:00,GB,34,MIA,24,Home,-10,58,28954,200610220mia,3842
2006102206,2006_07_DET_NYJ,2006,7,2006-10-22,Sunday,13:00,DET,24,NYJ,31,Home,7,55,28955,200610220nyj,3840
2006102207,2006_07_PHI_TB,2006,7,2006-10-22,Sunday,13:00,PHI,21,TB,23,Home,2,44,28956,200610220tam,3843
2006102208,2006_07_DEN_CLE,2006,7,2006-10-22,Sunday,16:05,DEN,17,CLE,7,Home,-10,24,28951,200610220cle,3836
2006102209,2006_07_WAS_IND,2006,7,2006-10-22,Sunday,16:15,WAS,22,IND,36,Home,14,58,28957,200610220clt,3837
2006102210,2006_07_ARI_OAK,2006,7,2006-10-22,Sunday,16:15,ARI,9,OAK,22,Home,13,31,28958,200610220rai,3841
2006102211,2006_07_MIN_SEA,2006,7,2006-10-22,Sunday,16:15,MIN,31,SEA,13,Home,-18,44,28959,200610220sea,3844
2006102300,2006_07_NYG_DAL,2006,7,2006-10-23,Monday,20:30,NYG,36,DAL,22,Home,-14,58,28960,200610230dal,3845
2006102900,2006_08_SF_CHI,2006,8,2006-10-29,Sunday,13:00,SF,10,CHI,41,Home,31,51,28961,200610290chi,3851
2006102901,2006_08_ATL_CIN,2006,8,2006-10-29,Sunday,13:00,ATL,29,CIN,27,Home,-2,56,28962,200610290cin,3850
2006102902,2006_08_ARI_GB,2006,8,2006-10-29,Sunday,13:00,ARI,14,GB,31,Home,17,45,28964,200610290gnb,3847
2006102903,2006_08_SEA_KC,2006,8,2006-10-29,Sunday,13:00,SEA,28,KC,35,Home,7,63,28965,200610290kan,3848
2006102904,2006_08_BAL_NO,2006,8,2006-10-29,Sunday,13:00,BAL,35,NO,22,Home,-13,57,28966,200610290nor,3854
2006102905,2006_08_TB_NYG,2006,8,2006-10-29,Sunday,13:00,TB,3,NYG,17,Home,14,20,28971,200610290nyg,3857
2006102906,2006_08_JAX_PHI,2006,8,2006-10-29,Sunday,13:00,JAX,13,PHI,6,Home,-7,19,28967,200610290phi,3856
2006102907,2006_08_HOU_TEN,2006,8,2006-10-29,Sunday,13:00,HOU,22,TEN,28,Home,6,50,28968,200610290oti,3858
2006102908,2006_08_STL_SD,2006,8,2006-10-29,Sunday,16:05,STL,24,SD,38,Home,14,62,28973,200610290sdg,3853
2006102909,2006_08_NYJ_CLE,2006,8,2006-10-29,Sunday,16:15,NYJ,13,CLE,20,Home,7,33,28963,200610290cle,3849
2006102910,2006_08_IND_DEN,2006,8,2006-10-29,Sunday,16:15,IND,34,DEN,31,Home,-3,65,28969,200610290den,3846
2006102911,2006_08_PIT_OAK,2006,8,2006-10-29,Sunday,16:15,PIT,13,OAK,20,Home,7,33,28972,200610290rai,3855
2006102912,2006_08_DAL_CAR,2006,8,2006-10-29,Sunday,20:15,DAL,35,CAR,14,Home,-21,49,28970,200610290car,3852
2006103000,2006_08_NE_MIN,2006,8,2006-10-30,Monday,20:30,NE,31,MIN,7,Home,-24,38,28974,200610300min,3859
2006110500,2006_09_CIN_BAL,2006,9,2006-11-05,Sunday,13:00,CIN,20,BAL,26,Home,6,46,28975,200611050rav,3870
2006110501,2006_09_GB_BUF,2006,9,2006-11-05,Sunday,13:00,GB,10,BUF,24,Home,14,34,28976,200611050buf,3869
2006110502,2006_09_MIA_CHI,2006,9,2006-11-05,Sunday,13:00,MIA,31,CHI,13,Home,-18,44,28977,200611050chi,3868
2006110503,2006_09_ATL_DET,2006,9,2006-11-05,Sunday,13:00,ATL,14,DET,30,Home,16,44,28978,200611050det,3872
2006110504,2006_09_TEN_JAX,2006,9,2006-11-05,Sunday,13:00,TEN,7,JAX,37,Home,30,44,28979,200611050jax,3871
2006110505,2006_09_HOU_NYG,2006,9,2006-11-05,Sunday,13:00,HOU,10,NYG,14,Home,4,24,28985,200611050nyg,3861
2006110506,2006_09_KC_STL,2006,9,2006-11-05,Sunday,13:00,KC,31,STL,17,Home,-14,48,28980,200611050ram,3866
2006110507,2006_09_NO_TB,2006,9,2006-11-05,Sunday,13:00,NO,31,TB,14,Home,-17,45,28981,200611050tam,3865
2006110508,2006_09_DAL_WAS,2006,9,2006-11-05,Sunday,13:00,DAL,19,WAS,22,Home,3,41,28982,200611050was,3867
2006110509,2006_09_MIN_SF,2006,9,2006-11-05,Sunday,16:05,MIN,3,SF,9,Home,6,12,28987,200611050sfo,3864
2006110510,2006_09_DEN_PIT,2006,9,2006-11-05,Sunday,16:15,DEN,31,PIT,20,Home,-11,51,28983,200611050pit,3863
2006110511,2006_09_CLE_SD,2006,9,2006-11-05,Sunday,16:15,CLE,25,SD,32,Home,7,57,28986,200611050sdg,3862
2006110512,2006_09_IND_NE,2006,9,2006-11-05,Sunday,20:15,IND,27,NE,20,Home,-7,47,28984,200611050nwe,3860
2006110600,2006_09_OAK_SEA,2006,9,2006-11-06,Monday,20:30,OAK,0,SEA,16,Home,16,16,28988,200611060sea,3873
2006111200,2006_10_CLE_ATL,2006,10,2006-11-12,Sunday,13:00,CLE,17,ATL,13,Home,-4,30,28989,200611120atl,3885
2006111201,2006_10_SD_CIN,2006,10,2006-11-12,Sunday,13:00,SD,49,CIN,41,Home,-8,90,28990,200611120cin,3887
2006111202,2006_10_SF_DET,2006,10,2006-11-12,Sunday,13:00,SF,19,DET,13,Home,-6,32,28991,200611120det,3882
2006111203,2006_10_BUF_IND,2006,10,2006-11-12,Sunday,13:00,BUF,16,IND,17,Home,1,33,28992,200611120clt,3884
2006111204,2006_10_HOU_JAX,2006,10,2006-11-12,Sunday,13:00,HOU,13,JAX,10,Home,-3,23,28993,200611120jax,3883
2006111205,2006_10_KC_MIA,2006,10,2006-11-12,Sunday,13:00,KC,10,MIA,13,Home,3,23,28994,200611120mia,3881
2006111206,2006_10_GB_MIN,2006,10,2006-11-12,Sunday,13:00,GB,23,MIN,17,Home,-6,40,28995,200611120min,3880
2006111207,2006_10_NYJ_NE,2006,10,2006-11-12,Sunday,13:00,NYJ,17,NE,14,Home,-3,31,29001,200611120nwe,3879
2006111208,2006_10_CHI_NYG,2006,10,2006-11-12,Sunday,20:15,CHI,38,NYG,20,Home,-18,58,28999,200611120nyg,3876
2006111209,2006_10_WAS_PHI,2006,10,2006-11-12,Sunday,13:00,WAS,3,PHI,27,Home,24,30,28998,200611120phi,3877
2006111210,2006_10_NO_PIT,2006,10,2006-11-12,Sunday,16:15,NO,31,PIT,38,Home,7,69,28996,200611120pit,3875
2006111211,2006_10_BAL_TEN,2006,10,2006-11-12,Sunday,13:00,BAL,27,TEN,26,Home,-1,53,28997,200611120oti,3888
2006111212,2006_10_DEN_OAK,2006,10,2006-11-12,Sunday,16:05,DEN,17,OAK,13,Home,-4,30,29002,200611120rai,3878
2006111213,2006_10_DAL_ARI,2006,10,2006-11-12,Sunday,16:15,DAL,27,ARI,10,Home,-17,37,29000,200611120crd,3886
2006111214,2006_10_STL_SEA,2006,10,2006-11-12,Sunday,16:15,STL,22,SEA,24,Home,2,46,29003,200611120sea,3874
2006111300,2006_10_TB_CAR,2006,10,2006-11-13,Monday,20:30,TB,10,CAR,24,Home,14,34,29004,200611130car,3889
2006111900,2006_11_ATL_BAL,2006,11,2006-11-19,Sunday,13:00,ATL,10,BAL,24,Home,14,34,29005,200611190rav,3893
2006111901,2006_11_STL_CAR,2006,11,2006-11-19,Sunday,13:00,STL,0,CAR,15,Home,15,15,29006,200611190car,3890
2006111902,2006_11_PIT_CLE,2006,11,2006-11-19,Sunday,13:00,PIT,24,CLE,20,Home,-4,44,29007,200611190cle,3891
2006111903,2006_11_IND_DAL,2006,11,2006-11-19,Sunday,16:15,IND,14,DAL,21,Home,7,35,29015,200611190dal,3898
2006111904,2006_11_NE_GB,2006,11,2006-11-19,Sunday,13:00,NE,35,GB,0,Home,-35,35,29008,200611190gnb,3896
2006111905,2006_11_BUF_HOU,2006,11,2006-11-19,Sunday,13:00,BUF,24,HOU,21,Home,-3,45,29009,200611190htx,3894
2006111906,2006_11_OAK_KC,2006,11,2006-11-19,Sunday,13:00,OAK,13,KC,17,Home,4,30,29010,200611190kan,3895
2006111907,2006_11_MIN_MIA,2006,11,2006-11-19,Sunday,13:00,MIN,20,MIA,24,Home,4,44,29011,200611190mia,3899
2006111908,2006_11_CIN_NO,2006,11,2006-11-19,Sunday,13:00,CIN,31,NO,16,Home,-15,47,29013,200611190nor,3900
2006111909,2006_11_CHI_NYJ,2006,11,2006-11-19,Sunday,13:00,CHI,10,NYJ,0,Home,-10,10,29012,200611190nyj,3902
2006111910,2006_11_TEN_PHI,2006,11,2006-11-19,Sunday,13:00,TEN,31,PHI,13,Home,-18,44,29014,200611190phi,3901
2006111911,2006_11_WAS_TB,2006,11,2006-11-19,Sunday,13:00,WAS,17,TB,20,Home,3,37,29016,200611190tam,3904
2006111912,2006_11_DET_ARI,2006,11,2006-11-19,Sunday,16:05,DET,10,ARI,17,Home,7,27,29017,200611190crd,3892
2006111913,2006_11_SEA_SF,2006,11,2006-11-19,Sunday,16:05,SEA,14,SF,20,Home,6,34,29019,200611190sfo,3903
2006111914,2006_11_SD_DEN,2006,11,2006-11-19,Sunday,20:15,SD,35,DEN,27,Home,-8,62,29018,200611190den,3897
2006112000,2006_11_NYG_JAX,2006,11,2006-11-20,Monday,20:30,NYG,10,JAX,26,Home,16,36,29020,200611200jax,3905
2006112300,2006_12_MIA_DET,2006,12,2006-11-23,Thursday,12:30,MIA,27,DET,10,Home,-17,37,29023,200611230det,3908
2006112301,2006_12_TB_DAL,2006,12,2006-11-23,Thursday,16:25,TB,10,DAL,38,Home,28,48,29022,200611230dal,3907
2006112302,2006_12_DEN_KC,2006,12,2006-11-23,Thursday,20:00,DEN,10,KC,19,Home,9,29,29021,200611230kan,3906
2006112600,2006_12_NO_ATL,2006,12,2006-11-26,Sunday,13:00,NO,31,ATL,13,Home,-18,44,29024,200611260atl,3912
2006112601,2006_12_PIT_BAL,2006,12,2006-11-26,Sunday,13:00,PIT,0,BAL,27,Home,27,27,29025,200611260rav,3910
2006112602,2006_12_JAX_BUF,2006,12,2006-11-26,Sunday,13:00,JAX,24,BUF,27,Home,3,51,29026,200611260buf,3911
2006112603,2006_12_CIN_CLE,2006,12,2006-11-26,Sunday,13:00,CIN,30,CLE,0,Home,-30,30,29027,200611260cle,3913
2006112604,2006_12_PHI_IND,2006,12,2006-11-26,Sunday,20:15,PHI,21,IND,45,Home,24,66,29033,200611260clt,3909
2006112605,2006_12_ARI_MIN,2006,12,2006-11-26,Sunday,13:00,ARI,26,MIN,31,Home,5,57,29028,200611260min,3919
2006112606,2006_12_CHI_NE,2006,12,2006-11-26,Sunday,16:15,CHI,13,NE,17,Home,4,30,29032,200611260nwe,3918
2006112607,2006_12_HOU_NYJ,2006,12,2006-11-26,Sunday,13:00,HOU,11,NYJ,26,Home,15,37,29029,200611260nyj,3917
2006112608,2006_12_SF_STL,2006,12,2006-11-26,Sunday,13:00,SF,17,STL,20,Home,3,37,29030,200611260ram,3914
2006112609,2006_12_NYG_TEN,2006,12,2006-11-26,Sunday,16:15,NYG,21,TEN,24,Home,3,45,29035,200611260oti,3920
2006112610,2006_12_CAR_WAS,2006,12,2006-11-26,Sunday,13:00,CAR,13,WAS,17,Home,4,30,29031,200611260was,3915
2006112611,2006_12_OAK_SD,2006,12,2006-11-26,Sunday,16:05,OAK,14,SD,21,Home,7,35,29034,200611260sdg,3916
2006112700,2006_12_GB_SEA,2006,12,2006-11-27,Monday,20:30,GB,24,SEA,34,Home,10,58,29036,200611270sea,3921
2006113000,2006_13_BAL_CIN,2006,13,2006-11-30,Thursday,20:00,BAL,7,CIN,13,Home,6,20,29037,200611300cin,3922
2006120300,2006_13_KC_CLE,2006,13,2006-12-03,Sunday,13:00,KC,28,CLE,31,Home,3,59,29040,200612030cle,3923
2006120301,2006_13_NYJ_GB,2006,13,2006-12-03,Sunday,13:00,NYJ,38,GB,10,Home,-28,48,29041,200612030gnb,3926
2006120302,2006_13_JAX_MIA,2006,13,2006-12-03,Sunday,16:05,JAX,24,MIA,10,Home,-14,34,29042,200612030mia,3931
2006120303,2006_13_DET_NE,2006,13,2006-12-03,Sunday,13:00,DET,21,NE,28,Home,7,49,29043,200612030nwe,3932
2006120304,2006_13_SF_NO,2006,13,2006-12-03,Sunday,13:00,SF,10,NO,34,Home,24,44,29044,200612030nor,3933
2006120305,2006_13_DAL_NYG,2006,13,2006-12-03,Sunday,16:15,DAL,23,NYG,20,Home,-3,43,29050,200612030nyg,3934
2006120306,2006_13_TB_PIT,2006,13,2006-12-03,Sunday,16:15,TB,3,PIT,20,Home,17,23,29048,200612030pit,3928
2006120307,2006_13_ARI_STL,2006,13,2006-12-03,Sunday,13:00,ARI,34,STL,20,Home,-14,54,29045,200612030ram,3930
2006120308,2006_13_IND_TEN,2006,13,2006-12-03,Sunday,13:00,IND,17,TEN,20,Home,3,37,29046,200612030oti,3936
2006120309,2006_13_ATL_WAS,2006,13,2006-12-03,Sunday,13:00,ATL,24,WAS,14,Home,-10,38,29047,200612030was,3929
2006120310,2006_13_HOU_OAK,2006,13,2006-12-03,Sunday,16:05,HOU,23,OAK,14,Home,-9,37,29051,200612030rai,3935
2006120311,2006_13_SEA_DEN,2006,13,2006-12-03,Sunday,20:15,SEA,23,DEN,20,Home,-3,43,29049,200612030den,3927
2006120312,2006_13_SD_BUF,2006,13,2006-12-03,Sunday,13:00,SD,24,BUF,21,Home,-3,45,29038,200612030buf,3925
2006120313,2006_13_MIN_CHI,2006,13,2006-12-03,Sunday,13:00,MIN,13,CHI,23,Home,10,36,29039,200612030chi,3924
2006120400,2006_13_CAR_PHI,2006,13,2006-12-04,Monday,20:30,CAR,24,PHI,27,Home,3,51,29052,200612040phi,3937
2006120700,2006_14_CLE_PIT,2006,14,2006-12-07,Thursday,20:00,CLE,7,PIT,27,Home,20,34,29053,200612070pit,3938
2006121000,2006_14_NYG_CAR,2006,14,2006-12-10,Sunday,13:00,NYG,27,CAR,13,Home,-14,40,29054,200612100car,3951
2006121001,2006_14_OAK_CIN,2006,14,2006-12-10,Sunday,13:00,OAK,10,CIN,27,Home,17,37,29055,200612100cin,3952
2006121002,2006_14_NO_DAL,2006,14,2006-12-10,Sunday,20:15,NO,42,DAL,17,Home,-25,59,29056,200612100dal,3945
2006121003,2006_14_MIN_DET,2006,14,2006-12-10,Sunday,13:00,MIN,30,DET,20,Home,-10,50,29057,200612100det,3946
2006121004,2006_14_TEN_HOU,2006,14,2006-12-10,Sunday,13:00,TEN,26,HOU,20,Home,-6,46,29058,200612100htx,3947
2006121005,2006_14_IND_JAX,2006,14,2006-12-10,Sunday,13:00,IND,17,JAX,44,Home,27,61,29059,200612100jax,3949
2006121006,2006_14_BAL_KC,2006,14,2006-12-10,Sunday,13:00,BAL,20,KC,10,Home,-10,30,29060,200612100kan,3948
2006121007,2006_14_NE_MIA,2006,14,2006-12-10,Sunday,13:00,NE,0,MIA,21,Home,21,21,29064,200612100mia,3944
2006121008,2006_14_BUF_NYJ,2006,14,2006-12-10,Sunday,16:15,BUF,31,NYJ,13,Home,-18,44,29066,200612100nyj,3943
2006121009,2006_14_ATL_TB,2006,14,2006-12-10,Sunday,13:00,ATL,17,TB,6,Home,-11,23,29061,200612100tam,3941
2006121010,2006_14_PHI_WAS,2006,14,2006-12-10,Sunday,13:00,PHI,21,WAS,19,Home,-2,40,29062,200612100was,3942
2006121011,2006_14_SEA_ARI,2006,14,2006-12-10,Sunday,16:05,SEA,21,ARI,27,Home,6,48,29065,200612100crd,3950
2006121012,2006_14_GB_SF,2006,14,2006-12-10,Sunday,16:05,GB,30,SF,19,Home,-11,49,29067,200612100sfo,3940
2006121013,2006_14_DEN_SD,2006,14,2006-12-10,Sunday,16:15,DEN,20,SD,48,Home,28,68,29063,200612100sdg,3939
2006121100,2006_14_CHI_STL,2006,14,2006-12-11,Monday,20:30,CHI,42,STL,27,Home,-15,69,29068,200612110ram,3953
2006121400,2006_15_SF_SEA,2006,15,2006-12-14,Thursday,20:00,SF,24,SEA,14,Home,-10,38,29069,200612140sea,3954
2006121600,2006_15_DAL_ATL,2006,15,2006-12-16,Saturday,20:00,DAL,38,ATL,28,Home,-10,66,29070,200612160atl,3955
2006121700,2006_15_CLE_BAL,2006,15,2006-12-17,Sunday,13:00,CLE,17,BAL,27,Home,10,44,29071,200612170rav,3958
2006121701,2006_15_MIA_BUF,2006,15,2006-12-17,Sunday,13:00,MIA,0,BUF,21,Home,21,21,29072,200612170buf,3957
2006121702,2006_15_PIT_CAR,2006,15,2006-12-17,Sunday,13:00,PIT,37,CAR,3,Home,-34,40,29073,200612170car,3959
2006121703,2006_15_TB_CHI,2006,15,2006-12-17,Sunday,13:00,TB,31,CHI,34,Home,3,65,29079,200612170chi,3960
2006121704,2006_15_DET_GB,2006,15,2006-12-17,Sunday,13:00,DET,9,GB,17,Home,8,26,29074,200612170gnb,3961
2006121705,2006_15_NYJ_MIN,2006,15,2006-12-17,Sunday,13:00,NYJ,26,MIN,13,Home,-13,39,29082,200612170min,3963
2006121706,2006_15_HOU_NE,2006,15,2006-12-17,Sunday,13:00,HOU,7,NE,40,Home,33,47,29076,200612170nwe,3965
2006121707,2006_15_PHI_NYG,2006,15,2006-12-17,Sunday,16:15,PHI,36,NYG,22,Home,-14,58,29075,200612170nyg,3966
2006121708,2006_15_JAX_TEN,2006,15,2006-12-17,Sunday,13:00,JAX,17,TEN,24,Home,7,41,29078,200612170oti,3968
2006121709,2006_15_DEN_ARI,2006,15,2006-12-17,Sunday,16:05,DEN,37,ARI,20,Home,-17,57,29081,200612170crd,3956
2006121710,2006_15_KC_SD,2006,15,2006-12-17,Sunday,20:15,KC,9,SD,20,Home,11,29,29080,200612170sdg,3962
2006121711,2006_15_STL_OAK,2006,15,2006-12-17,Sunday,16:15,STL,20,OAK,0,Home,-20,20,29083,200612170rai,3967
2006121712,2006_15_WAS_NO,2006,15,2006-12-17,Sunday,13:00,WAS,16,NO,10,Home,-6,26,29077,200612170nor,3964
2006121800,2006_15_CIN_IND,2006,15,2006-12-18,Monday,20:30,CIN,16,IND,34,Home,18,50,29084,200612180clt,3969
2006122100,2006_16_MIN_GB,2006,16,2006-12-21,Thursday,20:00,MIN,7,GB,9,Home,2,16,29085,200612210gnb,3970
2006122300,2006_16_KC_OAK,2006,16,2006-12-23,Saturday,20:00,KC,20,OAK,9,Home,-11,29,29086,200612230rai,3971
2006122400,2006_16_CAR_ATL,2006,16,2006-12-24,Sunday,13:00,CAR,10,ATL,3,Home,-7,13,29087,200612240atl,3983
2006122401,2006_16_TEN_BUF,2006,16,2006-12-24,Sunday,13:00,TEN,30,BUF,29,Home,-1,59,29088,200612240buf,3982
2006122402,2006_16_TB_CLE,2006,16,2006-12-24,Sunday,13:00,TB,22,CLE,7,Home,-15,29,29089,200612240cle,3981
2006122403,2006_16_CHI_DET,2006,16,2006-12-24,Sunday,13:00,CHI,26,DET,21,Home,-5,47,29090,200612240det,3977
2006122404,2006_16_IND_HOU,2006,16,2006-12-24,Sunday,13:00,IND,24,HOU,27,Home,3,51,29091,200612240htx,3979
2006122405,2006_16_NE_JAX,2006,16,2006-12-24,Sunday,13:00,NE,24,JAX,21,Home,-3,45,29092,200612240jax,3980
2006122406,2006_16_NO_NYG,2006,16,2006-12-24,Sunday,13:00,NO,30,NYG,7,Home,-23,37,29093,200612240nyg,3972
2006122407,2006_16_BAL_PIT,2006,16,2006-12-24,Sunday,13:00,BAL,31,PIT,7,Home,-24,38,29094,200612240pit,3973
2006122408,2006_16_WAS_STL,2006,16,2006-12-24,Sunday,13:00,WAS,31,STL,37,Home,6,68,29095,200612240ram,3976
2006122409,2006_16_ARI_SF,2006,16,2006-12-24,Sunday,16:05,ARI,26,SF,20,Home,-6,46,29098,200612240sfo,3975
2006122410,2006_16_CIN_DEN,2006,16,2006-12-24,Sunday,16:15,CIN,23,DEN,24,Home,1,47,29096,200612240den,3978
2006122411,2006_16_SD_SEA,2006,16,2006-12-24,Sunday,16:15,SD,20,SEA,17,Home,-3,37,29099,200612240sea,3974
2006122500,2006_16_PHI_DAL,2006,16,2006-12-25,Monday,17:00,PHI,23,DAL,7,Home,-16,30,29097,200612250dal,3984
2006122501,2006_16_NYJ_MIA,2006,16,2006-12-25,Monday,20:30,NYJ,13,MIA,10,Home,-3,23,29100,200612250mia,3985
2006123000,2006_17_NYG_WAS,2006,17,2006-12-30,Saturday,20:00,NYG,34,WAS,28,Home,-6,62,29101,200612300was,3986
2006123100,2006_17_BUF_BAL,2006,17,2006-12-31,Sunday,16:15,BUF,7,BAL,19,Home,12,26,29102,200612310rav,3998
2006123101,2006_17_GB_CHI,2006,17,2006-12-31,Sunday,20:15,GB,26,CHI,7,Home,-19,33,29112,200612310chi,4000
2006123102,2006_17_PIT_CIN,2006,17,2006-12-31,Sunday,13:00,PIT,23,CIN,17,Home,-6,40,29114,200612310cin,3999
2006123103,2006_17_DET_DAL,2006,17,2006-12-31,Sunday,13:00,DET,39,DAL,31,Home,-8,70,29103,200612310dal,3993
2006123104,2006_17_CLE_HOU,2006,17,2006-12-31,Sunday,13:00,CLE,6,HOU,14,Home,8,20,29104,200612310htx,3996
2006123105,2006_17_MIA_IND,2006,17,2006-12-31,Sunday,16:15,MIA,22,IND,27,Home,5,49,29113,200612310clt,3997
2006123106,2006_17_JAX_KC,2006,17,2006-12-31,Sunday,13:00,JAX,30,KC,35,Home,5,65,29105,200612310kan,3995
2006123107,2006_17_STL_MIN,2006,17,2006-12-31,Sunday,13:00,STL,41,MIN,21,Home,-20,62,29106,200612310min,3989
2006123108,2006_17_CAR_NO,2006,17,2006-12-31,Sunday,13:00,CAR,31,NO,21,Home,-10,52,29108,200612310nor,3990
2006123109,2006_17_OAK_NYJ,2006,17,2006-12-31,Sunday,13:00,OAK,3,NYJ,23,Home,20,26,29107,200612310nyj,3991
2006123110,2006_17_ATL_PHI,2006,17,2006-12-31,Sunday,16:15,ATL,17,PHI,24,Home,7,41,29109,200612310phi,3992
2006123111,2006_17_SEA_TB,2006,17,2006-12-31,Sunday,13:00,SEA,23,TB,7,Home,-16,30,29110,200612310tam,3987
2006123112,2006_17_NE_TEN,2006,17,2006-12-31,Sunday,13:00,NE,40,TEN,23,Home,-17,63,29111,200612310oti,4001
2006123113,2006_17_SF_DEN,2006,17,2006-12-31,Sunday,16:15,SF,26,DEN,23,Home,-3,49,29115,200612310den,3994
2006123114,2006_17_ARI_SD,2006,17,2006-12-31,Sunday,16:15,ARI,20,SD,27,Home,7,47,29116,200612310sdg,3988
2007010600,2006_18_DAL_SEA,2006,18,2007-01-06,Saturday,20:00,DAL,20,SEA,21,Home,1,41,29183,200701060sea,4003
2007010601,2006_18_KC_IND,2006,18,2007-01-06,Saturday,16:30,KC,8,IND,23,Home,15,31,29182,200701060clt,4002
2007010700,2006_18_NYG_PHI,2006,18,2007-01-07,Sunday,16:35,NYG,20,PHI,23,Home,3,43,29185,200701070phi,4005
2007010701,2006_18_NYJ_NE,2006,18,2007-01-07,Sunday,13:00,NYJ,16,NE,37,Home,21,53,29184,200701070nwe,4004
2007011300,2006_19_PHI_NO,2006,19,2007-01-13,Saturday,20:00,PHI,24,NO,27,Home,3,51,29187,200701130nor,4007
2007011301,2006_19_IND_BAL,2006,19,2007-01-13,Saturday,16:30,IND,15,BAL,6,Home,-9,21,29186,200701130rav,4006
2007011400,2006_19_SEA_CHI,2006,19,2007-01-14,Sunday,13:00,SEA,24,CHI,27,Home,3,51,29188,200701140chi,4008
2007011401,2006_19_NE_SD,2006,19,2007-01-14,Sunday,16:30,NE,24,SD,21,Home,-3,45,29189,200701140sdg,4009
2007012100,2006_20_NO_CHI,2006,20,2007-01-21,Sunday,15:00,NO,14,CHI,39,Home,25,53,29190,200701210chi,4010
2007012101,2006_20_NE_IND,2006,20,2007-01-21,Sunday,18:30,NE,34,IND,38,Home,4,72,29191,200701210clt,4011
2007020400,2006_21_IND_CHI,2006,21,2007-02-04,Sunday,18:25,IND,29,CHI,17,Neutral,-12,46,29192,200702040chi,4012
2007090600,2007_01_NO_IND,2007,1,2007-09-06,Thursday,20:30,NO,10,IND,41,Home,31,51,29195,200709060clt,731
2007090900,2007_01_DEN_BUF,2007,1,2007-09-09,Sunday,13:00,DEN,15,BUF,14,Home,-1,29,29196,200709090buf,732
2007090901,2007_01_PIT_CLE,2007,1,2007-09-09,Sunday,13:00,PIT,34,CLE,7,Home,-27,41,29197,200709090cle,733
2007090902,2007_01_PHI_GB,2007,1,2007-09-09,Sunday,13:00,PHI,13,GB,16,Home,3,29,29198,200709090gnb,734
2007090903,2007_01_KC_HOU,2007,1,2007-09-09,Sunday,13:00,KC,3,HOU,20,Home,17,23,29199,200709090htx,735
2007090904,2007_01_ATL_MIN,2007,1,2007-09-09,Sunday,13:00,ATL,3,MIN,24,Home,21,27,29201,200709090min,737
2007090905,2007_01_NE_NYJ,2007,1,2007-09-09,Sunday,13:00,NE,38,NYJ,14,Home,-24,52,29202,200709090nyj,738
2007090906,2007_01_CAR_STL,2007,1,2007-09-09,Sunday,13:00,CAR,27,STL,13,Home,-14,40,29203,200709090ram,739
2007090907,2007_01_MIA_WAS,2007,1,2007-09-09,Sunday,13:00,MIA,13,WAS,16,Home,3,29,29204,200709090was,740
2007090908,2007_01_DET_OAK,2007,1,2007-09-09,Sunday,16:15,DET,36,OAK,21,Home,-15,57,29205,200709090rai,741
2007090909,2007_01_CHI_SD,2007,1,2007-09-09,Sunday,16:15,CHI,3,SD,14,Home,11,17,29206,200709090sdg,742
2007090910,2007_01_TB_SEA,2007,1,2007-09-09,Sunday,16:15,TB,6,SEA,20,Home,14,26,29207,200709090sea,743
2007090911,2007_01_NYG_DAL,2007,1,2007-09-09,Sunday,20:25,NYG,35,DAL,45,Home,10,80,29208,200709090dal,744
2007090912,2007_01_TEN_JAX,2007,1,2007-09-09,Sunday,13:00,TEN,13,JAX,10,Home,-3,23,29200,200709090jax,736
2007091000,2007_01_BAL_CIN,2007,1,2007-09-10,Monday,19:10,BAL,20,CIN,27,Home,7,47,29209,200709100cin,745
2007091001,2007_01_ARI_SF,2007,1,2007-09-10,Monday,22:25,ARI,17,SF,20,Home,3,37,29210,200709100sfo,746
2007091600,2007_02_HOU_CAR,2007,2,2007-09-16,Sunday,13:00,HOU,34,CAR,21,Home,-13,55,29211,200709160car,747
2007091601,2007_02_CIN_CLE,2007,2,2007-09-16,Sunday,13:00,CIN,45,CLE,51,Home,6,96,29212,200709160cle,748
2007091602,2007_02_ATL_JAX,2007,2,2007-09-16,Sunday,13:00,ATL,7,JAX,13,Home,6,20,29213,200709160jax,749
2007091603,2007_02_GB_NYG,2007,2,2007-09-16,Sunday,13:00,GB,35,NYG,13,Home,-22,48,29214,200709160nyg,750
2007091604,2007_02_BUF_PIT,2007,2,2007-09-16,Sunday,13:00,BUF,3,PIT,26,Home,23,29,29215,200709160pit,751
2007091605,2007_02_SF_STL,2007,2,2007-09-16,Sunday,13:00,SF,17,STL,16,Home,-1,33,29216,200709160ram,752
2007091606,2007_02_NO_TB,2007,2,2007-09-16,Sunday,13:00,NO,14,TB,31,Home,17,45,29217,200709160tam,753
2007091607,2007_02_IND_TEN,2007,2,2007-09-16,Sunday,13:00,IND,22,TEN,20,Home,-2,42,29218,200709160oti,754
2007091608,2007_02_SEA_ARI,2007,2,2007-09-16,Sunday,16:05,SEA,20,ARI,23,Home,3,43,29219,200709160crd,755
2007091609,2007_02_MIN_DET,2007,2,2007-09-16,Sunday,16:05,MIN,17,DET,20,Home,3,37,29220,200709160det,756
2007091610,2007_02_DAL_MIA,2007,2,2007-09-16,Sunday,16:05,DAL,37,MIA,20,Home,-17,57,29221,200709160mia,757
2007091611,2007_02_NYJ_BAL,2007,2,2007-09-16,Sunday,16:15,NYJ,13,BAL,20,Home,7,33,29222,200709160rav,758
2007091612,2007_02_KC_CHI,2007,2,2007-09-16,Sunday,16:15,KC,10,CHI,20,Home,10,30,29223,200709160chi,759
2007091613,2007_02_OAK_DEN,2007,2,2007-09-16,Sunday,16:15,OAK,20,DEN,23,Home,3,43,29224,200709160den,760
2007091614,2007_02_SD_NE,2007,2,2007-09-16,Sunday,20:25,SD,14,NE,38,Home,24,52,29225,200709160nwe,761
2007091700,2007_02_WAS_PHI,2007,2,2007-09-17,Monday,20:40,WAS,20,PHI,12,Home,-8,32,29226,200709170phi,762
2007092300,2007_03_ARI_BAL,2007,3,2007-09-23,Sunday,13:00,ARI,23,BAL,26,Home,3,49,29227,200709230rav,763
2007092301,2007_03_SD_GB,2007,3,2007-09-23,Sunday,13:00,SD,24,GB,31,Home,7,55,29228,200709230gnb,764
2007092302,2007_03_IND_HOU,2007,3,2007-09-23,Sunday,13:00,IND,30,HOU,24,Home,-6,54,29229,200709230htx,765
2007092303,2007_03_MIN_KC,2007,3,2007-09-23,Sunday,13:00,MIN,10,KC,13,Home,3,23,29230,200709230kan,766
2007092304,2007_03_BUF_NE,2007,3,2007-09-23,Sunday,13:00,BUF,7,NE,38,Home,31,45,29231,200709230nwe,768
2007092305,2007_03_MIA_NYJ,2007,3,2007-09-23,Sunday,13:00,MIA,28,NYJ,31,Home,3,59,29232,200709230nyj,767
2007092306,2007_03_DET_PHI,2007,3,2007-09-23,Sunday,13:00,DET,21,PHI,56,Home,35,77,29233,200709230phi,769
2007092307,2007_03_SF_PIT,2007,3,2007-09-23,Sunday,13:00,SF,16,PIT,37,Home,21,53,29234,200709230pit,770
2007092308,2007_03_STL_TB,2007,3,2007-09-23,Sunday,13:00,STL,3,TB,24,Home,21,27,29235,200709230tam,771
2007092309,2007_03_JAX_DEN,2007,3,2007-09-23,Sunday,16:05,JAX,23,DEN,14,Home,-9,37,29236,200709230den,772
2007092310,2007_03_CLE_OAK,2007,3,2007-09-23,Sunday,16:05,CLE,24,OAK,26,Home,2,50,29237,200709230rai,773
2007092311,2007_03_CIN_SEA,2007,3,2007-09-23,Sunday,16:05,CIN,21,SEA,24,Home,3,45,29238,200709230sea,774
2007092312,2007_03_CAR_ATL,2007,3,2007-09-23,Sunday,16:15,CAR,27,ATL,20,Home,-7,47,29239,200709230atl,775
2007092313,2007_03_NYG_WAS,2007,3,2007-09-23,Sunday,16:15,NYG,24,WAS,17,Home,-7,41,29240,200709230was,776
2007092314,2007_03_DAL_CHI,2007,3,2007-09-23,Sunday,20:25,DAL,34,CHI,10,Home,-24,44,29241,200709230chi,777
2007092400,2007_03_TEN_NO,2007,3,2007-09-24,Monday,20:40,TEN,31,NO,14,Home,-17,45,29242,200709240nor,778
2007093000,2007_04_HOU_ATL,2007,4,2007-09-30,Sunday,13:00,HOU,16,ATL,26,Home,10,42,29243,200709300atl,779
2007093001,2007_04_NYJ_BUF,2007,4,2007-09-30,Sunday,13:00,NYJ,14,BUF,17,Home,3,31,29244,200709300buf,780
2007093002,2007_04_BAL_CLE,2007,4,2007-09-30,Sunday,13:00,BAL,13,CLE,27,Home,14,40,29245,200709300cle,781
2007093003,2007_04_STL_DAL,2007,4,2007-09-30,Sunday,13:00,STL,7,DAL,35,Home,28,42,29246,200709300dal,782
2007093004,2007_04_CHI_DET,2007,4,2007-09-30,Sunday,13:00,CHI,27,DET,37,Home,10,64,29247,200709300det,783
2007093005,2007_04_OAK_MIA,2007,4,2007-09-30,Sunday,13:00,OAK,35,MIA,17,Home,-18,52,29248,200709300mia,784
2007093006,2007_04_GB_MIN,2007,4,2007-09-30,Sunday,13:00,GB,23,MIN,16,Home,-7,39,29249,200709300min,785
2007093007,2007_04_TB_CAR,2007,4,2007-09-30,Sunday,16:05,TB,20,CAR,7,Home,-13,27,29250,200709300car,786
2007093008,2007_04_SEA_SF,2007,4,2007-09-30,Sunday,16:05,SEA,23,SF,3,Home,-20,26,29251,200709300sfo,787
2007093009,2007_04_PIT_ARI,2007,4,2007-09-30,Sunday,16:15,PIT,14,ARI,21,Home,7,35,29252,200709300crd,788
2007093010,2007_04_DEN_IND,2007,4,2007-09-30,Sunday,16:15,DEN,20,IND,38,Home,18,58,29253,200709300clt,789
2007093011,2007_04_KC_SD,2007,4,2007-09-30,Sunday,16:15,KC,30,SD,16,Home,-14,46,29254,200709300sdg,790
2007093012,2007_04_PHI_NYG,2007,4,2007-09-30,Sunday,20:25,PHI,3,NYG,16,Home,13,19,29255,200709300nyg,791
2007100100,2007_04_NE_CIN,2007,4,2007-10-01,Monday,20:40,NE,34,CIN,13,Home,-21,47,29256,200710010cin,792
2007100700,2007_05_MIA_HOU,2007,5,2007-10-07,Sunday,13:00,MIA,19,HOU,22,Home,3,41,29257,200710070htx,793
2007100701,2007_05_JAX_KC,2007,5,2007-10-07,Sunday,13:00,JAX,17,KC,7,Home,-10,24,29258,200710070kan,794
2007100702,2007_05_CLE_NE,2007,5,2007-10-07,Sunday,13:00,CLE,17,NE,34,Home,17,51,29259,200710070nwe,796
2007100703,2007_05_CAR_NO,2007,5,2007-10-07,Sunday,13:00,CAR,16,NO,13,Home,-3,29,29260,200710070nor,797
2007100704,2007_05_NYJ_NYG,2007,5,2007-10-07,Sunday,13:00,NYJ,24,NYG,35,Home,11,59,29261,200710070nyg,795
2007100705,2007_05_SEA_PIT,2007,5,2007-10-07,Sunday,13:00,SEA,0,PIT,21,Home,21,21,29262,200710070pit,798
2007100706,2007_05_ARI_STL,2007,5,2007-10-07,Sunday,13:00,ARI,34,STL,31,Home,-3,65,29263,200710070ram,799
2007100707,2007_05_ATL_TEN,2007,5,2007-10-07,Sunday,13:00,ATL,13,TEN,20,Home,7,33,29264,200710070oti,800
2007100708,2007_05_DET_WAS,2007,5,2007-10-07,Sunday,13:00,DET,3,WAS,34,Home,31,37,29265,200710070was,801
2007100709,2007_05_TB_IND,2007,5,2007-10-07,Sunday,16:05,TB,14,IND,33,Home,19,47,29266,200710070clt,802
2007100710,2007_05_SD_DEN,2007,5,2007-10-07,Sunday,16:15,SD,41,DEN,3,Home,-38,44,29267,200710070den,803
2007100711,2007_05_BAL_SF,2007,5,2007-10-07,Sunday,16:15,BAL,9,SF,7,Home,-2,16,29268,200710070sfo,804
2007100712,2007_05_CHI_GB,2007,5,2007-10-07,Sunday,20:25,CHI,27,GB,20,Home,-7,47,29269,200710070gnb,805
2007100800,2007_05_DAL_BUF,2007,5,2007-10-08,Monday,20:40,DAL,25,BUF,24,Home,-1,49,29270,200710080buf,806
2007101400,2007_06_STL_BAL,2007,6,2007-10-14,Sunday,13:00,STL,3,BAL,22,Home,19,25,29271,200710140rav,807
2007101401,2007_06_MIN_CHI,2007,6,2007-10-14,Sunday,13:00,MIN,34,CHI,31,Home,-3,65,29272,200710140chi,808
2007101402,2007_06_MIA_CLE,2007,6,2007-10-14,Sunday,13:00,MIA,31,CLE,41,Home,10,72,29273,200710140cle,809
2007101403,2007_06_WAS_GB,2007,6,2007-10-14,Sunday,13:00,WAS,14,GB,17,Home,3,31,29274,200710140gnb,810
2007101404,2007_06_HOU_JAX,2007,6,2007-10-14,Sunday,13:00,HOU,17,JAX,37,Home,20,54,29275,200710140jax,811
2007101405,2007_06_CIN_KC,2007,6,2007-10-14,Sunday,13:00,CIN,20,KC,27,Home,7,47,29276,200710140kan,812
2007101406,2007_06_PHI_NYJ,2007,6,2007-10-14,Sunday,13:00,PHI,16,NYJ,9,Home,-7,25,29277,200710140nyj,813
2007101407,2007_06_TEN_TB,2007,6,2007-10-14,Sunday,13:00,TEN,10,TB,13,Home,3,23,29278,200710140tam,814
2007101408,2007_06_CAR_ARI,2007,6,2007-10-14,Sunday,16:05,CAR,25,ARI,10,Home,-15,35,29279,200710140crd,815
2007101409,2007_06_NE_DAL,2007,6,2007-10-14,Sunday,16:15,NE,48,DAL,27,Home,-21,75,29280,200710140dal,816
2007101410,2007_06_OAK_SD,2007,6,2007-10-14,Sunday,16:15,OAK,14,SD,28,Home,14,42,29281,200710140sdg,817
2007101411,2007_06_NO_SEA,2007,6,2007-10-14,Sunday,20:25,NO,28,SEA,17,Home,-11,45,29282,200710140sea,818
2007101500,2007_06_NYG_ATL,2007,6,2007-10-15,Monday,20:40,NYG,31,ATL,10,Home,-21,41,29283,200710150atl,819
2007102100,2007_07_BAL_BUF,2007,7,2007-10-21,Sunday,13:00,BAL,14,BUF,19,Home,5,33,29284,200710210buf,820
2007102101,2007_07_MIN_DAL,2007,7,2007-10-21,Sunday,16:15,MIN,14,DAL,24,Home,10,38,29285,200710210dal,821
2007102102,2007_07_TB_DET,2007,7,2007-10-21,Sunday,13:00,TB,16,DET,23,Home,7,39,29286,200710210det,822
2007102103,2007_07_TEN_HOU,2007,7,2007-10-21,Sunday,13:00,TEN,38,HOU,36,Home,-2,74,29287,200710210htx,823
2007102104,2007_07_NE_MIA,2007,7,2007-10-21,Sunday,13:00,NE,49,MIA,28,Home,-21,77,29288,200710210mia,824
2007102105,2007_07_SF_NYG,2007,7,2007-10-21,Sunday,13:00,SF,15,NYG,33,Home,18,48,29289,200710210nyg,825
2007102106,2007_07_ATL_NO,2007,7,2007-10-21,Sunday,13:00,ATL,16,NO,22,Home,6,38,29290,200710210nor,826
2007102107,2007_07_ARI_WAS,2007,7,2007-10-21,Sunday,13:00,ARI,19,WAS,21,Home,2,40,29291,200710210was,827
2007102108,2007_07_NYJ_CIN,2007,7,2007-10-21,Sunday,16:05,NYJ,31,CIN,38,Home,7,69,29292,200710210cin,828
2007102109,2007_07_KC_OAK,2007,7,2007-10-21,Sunday,16:05,KC,12,OAK,10,Home,-2,22,29293,200710210rai,829
2007102110,2007_07_CHI_PHI,2007,7,2007-10-21,Sunday,16:15,CHI,19,PHI,16,Home,-3,35,29294,200710210phi,830
2007102111,2007_07_STL_SEA,2007,7,2007-10-21,Sunday,16:15,STL,6,SEA,33,Home,27,39,29295,200710210sea,831
2007102112,2007_07_PIT_DEN,2007,7,2007-10-21,Sunday,20:25,PIT,28,DEN,31,Home,3,59,29296,200710210den,832
2007102200,2007_07_IND_JAX,2007,7,2007-10-22,Monday,20:40,IND,29,JAX,7,Home,-22,36,29297,200710220jax,833
2007102800,2007_08_IND_CAR,2007,8,2007-10-28,Sunday,13:00,IND,31,CAR,7,Home,-24,38,29298,200710280car,834
2007102801,2007_08_DET_CHI,2007,8,2007-10-28,Sunday,13:00,DET,16,CHI,7,Home,-9,23,29299,200710280chi,835
2007102802,2007_08_PIT_CIN,2007,8,2007-10-28,Sunday,13:00,PIT,24,CIN,13,Home,-11,37,29300,200710280cin,836
2007102803,2007_08_NYG_MIA,2007,8,2007-10-28,Sunday,13:00,NYG,13,MIA,10,Neutral,-3,23,29301,200710280mia,837
2007102804,2007_08_PHI_MIN,2007,8,2007-10-28,Sunday,13:00,PHI,23,MIN,16,Home,-7,39,29302,200710280min,838
2007102805,2007_08_CLE_STL,2007,8,2007-10-28,Sunday,13:00,CLE,27,STL,20,Home,-7,47,29303,200710280ram,839
2007102806,2007_08_OAK_TEN,2007,8,2007-10-28,Sunday,13:00,OAK,9,TEN,13,Home,4,22,29304,200710280oti,840
2007102807,2007_08_BUF_NYJ,2007,8,2007-10-28,Sunday,16:05,BUF,13,NYJ,3,Home,-10,16,29305,200710280nyj,841
2007102808,2007_08_HOU_SD,2007,8,2007-10-28,Sunday,16:05,HOU,10,SD,35,Home,25,45,29306,200710280sdg,842
2007102809,2007_08_JAX_TB,2007,8,2007-10-28,Sunday,16:05,JAX,24,TB,23,Home,-1,47,29307,200710280tam,843
2007102810,2007_08_WAS_NE,2007,8,2007-10-28,Sunday,16:15,WAS,7,NE,52,Home,45,59,29308,200710280nwe,844
2007102811,2007_08_NO_SF,2007,8,2007-10-28,Sunday,16:15,NO,31,SF,10,Home,-21,41,29309,200710280sfo,845
2007102900,2007_08_GB_DEN,2007,8,2007-10-29,Monday,20:40,GB,19,DEN,13,Home,-6,32,29310,200710290den,846
2007110400,2007_09_SF_ATL,2007,9,2007-11-04,Sunday,13:00,SF,16,ATL,20,Home,4,36,29311,200711040atl,847
2007110401,2007_09_CIN_BUF,2007,9,2007-11-04,Sunday,13:00,CIN,21,BUF,33,Home,12,54,29312,200711040buf,848
2007110402,2007_09_DEN_DET,2007,9,2007-11-04,Sunday,13:00,DEN,7,DET,44,Home,37,51,29313,200711040det,849
2007110403,2007_09_GB_KC,2007,9,2007-11-04,Sunday,13:00,GB,33,KC,22,Home,-11,55,29314,200711040kan,850
2007110404,2007_09_SD_MIN,2007,9,2007-11-04,Sunday,13:00,SD,17,MIN,35,Home,18,52,29315,200711040min,851
2007110405,2007_09_JAX_NO,2007,9,2007-11-04,Sunday,13:00,JAX,24,NO,41,Home,17,65,29316,200711040nor,853
2007110406,2007_09_WAS_NYJ,2007,9,2007-11-04,Sunday,13:00,WAS,23,NYJ,20,Home,-3,43,29317,200711040nyj,852
2007110407,2007_09_ARI_TB,2007,9,2007-11-04,Sunday,13:00,ARI,10,TB,17,Home,7,27,29318,200711040tam,854
2007110408,2007_09_CAR_TEN,2007,9,2007-11-04,Sunday,13:00,CAR,7,TEN,20,Home,13,27,29319,200711040oti,855
2007110409,2007_09_SEA_CLE,2007,9,2007-11-04,Sunday,16:05,SEA,30,CLE,33,Home,3,63,29320,200711040cle,856
2007110410,2007_09_NE_IND,2007,9,2007-11-04,Sunday,16:15,NE,24,IND,20,Home,-4,44,29321,200711040clt,857
2007110411,2007_09_HOU_OAK,2007,9,2007-11-04,Sunday,16:15,HOU,24,OAK,17,Home,-7,41,29322,200711040rai,858
2007110412,2007_09_DAL_PHI,2007,9,2007-11-04,Sunday,20:25,DAL,38,PHI,17,Home,-21,55,29323,200711040phi,859
2007110500,2007_09_BAL_PIT,2007,9,2007-11-05,Monday,20:40,BAL,7,PIT,38,Home,31,45,29324,200711050pit,860
2007111100,2007_10_ATL_CAR,2007,10,2007-11-11,Sunday,13:00,ATL,20,CAR,13,Home,-7,33,29325,200711110car,861
2007111101,2007_10_MIN_GB,2007,10,2007-11-11,Sunday,13:00,MIN,0,GB,34,Home,34,34,29326,200711110gnb,862
2007111102,2007_10_DEN_KC,2007,10,2007-11-11,Sunday,13:00,DEN,27,KC,11,Home,-16,38,29327,200711110kan,863
2007111103,2007_10_BUF_MIA,2007,10,2007-11-11,Sunday,13:00,BUF,13,MIA,10,Home,-3,23,29328,200711110mia,864
2007111104,2007_10_STL_NO,2007,10,2007-11-11,Sunday,13:00,STL,37,NO,29,Home,-8,66,29329,200711110nor,865
2007111105,2007_10_CLE_PIT,2007,10,2007-11-11,Sunday,13:00,CLE,28,PIT,31,Home,3,59,29330,200711110pit,866
2007111106,2007_10_JAX_TEN,2007,10,2007-11-11,Sunday,13:00,JAX,28,TEN,13,Home,-15,41,29331,200711110oti,867
2007111107,2007_10_PHI_WAS,2007,10,2007-11-11,Sunday,13:00,PHI,33,WAS,25,Home,-8,58,29332,200711110was,868
2007111108,2007_10_CIN_BAL,2007,10,2007-11-11,Sunday,16:05,CIN,21,BAL,7,Home,-14,28,29333,200711110rav,869
2007111109,2007_10_DET_ARI,2007,10,2007-11-11,Sunday,16:15,DET,21,ARI,31,Home,10,52,29334,200711110crd,870
2007111110,2007_10_DAL_NYG,2007,10,2007-11-11,Sunday,16:15,DAL,31,NYG,20,Home,-11,51,29335,200711110nyg,871
2007111111,2007_10_CHI_OAK,2007,10,2007-11-11,Sunday,16:15,CHI,17,OAK,6,Home,-11,23,29336,200711110rai,872
2007111112,2007_10_IND_SD,2007,10,2007-11-11,Sunday,20:15,IND,21,SD,23,Home,2,44,29337,200711110sdg,873
2007111200,2007_10_SF_SEA,2007,10,2007-11-12,Monday,20:40,SF,0,SEA,24,Home,24,24,29338,200711120sea,874
2007111800,2007_11_TB_ATL,2007,11,2007-11-18,Sunday,13:00,TB,31,ATL,7,Home,-24,38,29339,200711180atl,875
2007111801,2007_11_CLE_BAL,2007,11,2007-11-18,Sunday,13:00,CLE,33,BAL,30,Home,-3,63,29340,200711180rav,876
2007111802,2007_11_NE_BUF,2007,11,2007-11-18,Sunday,20:25,NE,56,BUF,10,Home,-46,66,29341,200711180buf,877
2007111803,2007_11_ARI_CIN,2007,11,2007-11-18,Sunday,13:00,ARI,35,CIN,27,Home,-8,62,29342,200711180cin,878
2007111804,2007_11_WAS_DAL,2007,11,2007-11-18,Sunday,16:15,WAS,23,DAL,28,Home,5,51,29343,200711180dal,879
2007111805,2007_11_CAR_GB,2007,11,2007-11-18,Sunday,13:00,CAR,17,GB,31,Home,14,48,29344,200711180gnb,880
2007111806,2007_11_NO_HOU,2007,11,2007-11-18,Sunday,13:00,NO,10,HOU,23,Home,13,33,29345,200711180htx,881
2007111807,2007_11_KC_IND,2007,11,2007-11-18,Sunday,13:00,KC,10,IND,13,Home,3,23,29346,200711180clt,882
2007111808,2007_11_SD_JAX,2007,11,2007-11-18,Sunday,13:00,SD,17,JAX,24,Home,7,41,29347,200711180jax,883
2007111809,2007_11_OAK_MIN,2007,11,2007-11-18,Sunday,13:00,OAK,22,MIN,29,Home,7,51,29348,200711180min,884
2007111810,2007_11_PIT_NYJ,2007,11,2007-11-18,Sunday,16:05,PIT,16,NYJ,19,Home,3,35,29349,200711180nyj,885
2007111811,2007_11_MIA_PHI,2007,11,2007-11-18,Sunday,13:00,MIA,7,PHI,17,Home,10,24,29350,200711180phi,886
2007111812,2007_11_NYG_DET,2007,11,2007-11-18,Sunday,13:00,NYG,16,DET,10,Home,-6,26,29351,200711180det,887
2007111813,2007_11_STL_SF,2007,11,2007-11-18,Sunday,16:15,STL,13,SF,9,Home,-4,22,29352,200711180sfo,888
2007111814,2007_11_CHI_SEA,2007,11,2007-11-18,Sunday,16:15,CHI,23,SEA,30,Home,7,53,29353,200711180sea,889
2007111900,2007_11_TEN_DEN,2007,11,2007-11-19,Monday,20:40,TEN,20,DEN,34,Home,14,54,29354,200711190den,890
2007112200,2007_12_GB_DET,2007,12,2007-11-22,Thursday,12:30,GB,37,DET,26,Home,-11,63,29355,200711220det,891
2007112201,2007_12_NYJ_DAL,2007,12,2007-11-22,Thursday,16:15,NYJ,3,DAL,34,Home,31,37,29356,200711220dal,892
2007112202,2007_12_IND_ATL,2007,12,2007-11-22,Thursday,20:15,IND,31,ATL,13,Home,-18,44,29357,200711220atl,893
2007112500,2007_12_NO_CAR,2007,12,2007-11-25,Sunday,13:00,NO,31,CAR,6,Home,-25,37,29358,200711250car,894
2007112501,2007_12_DEN_CHI,2007,12,2007-11-25,Sunday,16:15,DEN,34,CHI,37,Home,3,71,29359,200711250chi,895
2007112502,2007_12_TEN_CIN,2007,12,2007-11-25,Sunday,13:00,TEN,6,CIN,35,Home,29,41,29360,200711250cin,896
2007112503,2007_12_HOU_CLE,2007,12,2007-11-25,Sunday,13:00,HOU,17,CLE,27,Home,10,44,29361,200711250cle,897
2007112504,2007_12_BUF_JAX,2007,12,2007-11-25,Sunday,13:00,BUF,14,JAX,36,Home,22,50,29362,200711250jax,898
2007112505,2007_12_OAK_KC,2007,12,2007-11-25,Sunday,13:00,OAK,20,KC,17,Home,-3,37,29363,200711250kan,899
2007112506,2007_12_MIN_NYG,2007,12,2007-11-25,Sunday,13:00,MIN,41,NYG,17,Home,-24,58,29364,200711250nyg,900
2007112507,2007_12_SEA_STL,2007,12,2007-11-25,Sunday,13:00,SEA,24,STL,19,Home,-5,43,29365,200711250ram,901
2007112508,2007_12_WAS_TB,2007,12,2007-11-25,Sunday,13:00,WAS,13,TB,19,Home,6,32,29366,200711250tam,902
2007112509,2007_12_SF_ARI,2007,12,2007-11-25,Sunday,16:05,SF,37,ARI,31,Home,-6,68,29367,200711250crd,903
2007112510,2007_12_BAL_SD,2007,12,2007-11-25,Sunday,16:15,BAL,14,SD,32,Home,18,46,29368,200711250sdg,904
2007112511,2007_12_PHI_NE,2007,12,2007-11-25,Sunday,20:25,PHI,28,NE,31,Home,3,59,29369,200711250nwe,905
2007112600,2007_12_MIA_PIT,2007,12,2007-11-26,Monday,20:30,MIA,0,PIT,3,Home,3,3,29370,200711260pit,906
2007112900,2007_13_GB_DAL,2007,13,2007-11-29,Thursday,20:15,GB,27,DAL,37,Home,10,64,29371,200711290dal,907
2007120200,2007_13_SF_CAR,2007,13,2007-12-02,Sunday,13:00,SF,14,CAR,31,Home,17,45,29372,200712020car,908
2007120201,2007_13_JAX_IND,2007,13,2007-12-02,Sunday,13:00,JAX,25,IND,28,Home,3,53,29373,200712020clt,909
2007120202,2007_13_SD_KC,2007,13,2007-12-02,Sunday,13:00,SD,24,KC,10,Home,-14,34,29374,200712020kan,910
2007120203,2007_13_NYJ_MIA,2007,13,2007-12-02,Sunday,13:00,NYJ,40,MIA,13,Home,-27,53,29375,200712020mia,911
2007120204,2007_13_DET_MIN,2007,13,2007-12-02,Sunday,13:00,DET,10,MIN,42,Home,32,52,29376,200712020min,912
2007120205,2007_13_TB_NO,2007,13,2007-12-02,Sunday,16:15,TB,27,NO,23,Home,-4,50,29377,200712020nor,913
2007120206,2007_13_SEA_PHI,2007,13,2007-12-02,Sunday,13:00,SEA,28,PHI,24,Home,-4,52,29378,200712020phi,914
2007120207,2007_13_ATL_STL,2007,13,2007-12-02,Sunday,13:00,ATL,16,STL,28,Home,12,44,29379,200712020ram,915
2007120208,2007_13_HOU_TEN,2007,13,2007-12-02,Sunday,13:00,HOU,20,TEN,28,Home,8,48,29380,200712020oti,916
2007120209,2007_13_BUF_WAS,2007,13,2007-12-02,Sunday,13:00,BUF,17,WAS,16,Home,-1,33,29381,200712020was,917
2007120210,2007_13_CLE_ARI,2007,13,2007-12-02,Sunday,16:05,CLE,21,ARI,27,Home,6,48,29382,200712020crd,918
2007120211,2007_13_DEN_OAK,2007,13,2007-12-02,Sunday,16:05,DEN,20,OAK,34,Home,14,54,29383,200712020rai,919
2007120212,2007_13_NYG_CHI,2007,13,2007-12-02,Sunday,16:15,NYG,21,CHI,16,Home,-5,37,29384,200712020chi,920
2007120213,2007_13_CIN_PIT,2007,13,2007-12-02,Sunday,20:25,CIN,10,PIT,24,Home,14,34,29385,200712020pit,921
2007120300,2007_13_NE_BAL,2007,13,2007-12-03,Monday,20:40,NE,27,BAL,24,Home,-3,51,29386,200712030rav,922
2007120600,2007_14_CHI_WAS,2007,14,2007-12-06,Thursday,20:15,CHI,16,WAS,24,Home,8,40,29387,200712060was,923
2007120900,2007_14_MIA_BUF,2007,14,2007-12-09,Sunday,13:00,MIA,17,BUF,38,Home,21,55,29388,200712090buf,924
2007120901,2007_14_STL_CIN,2007,14,2007-12-09,Sunday,13:00,STL,10,CIN,19,Home,9,29,29389,200712090cin,925
2007120902,2007_14_DAL_DET,2007,14,2007-12-09,Sunday,13:00,DAL,28,DET,27,Home,-1,55,29390,200712090det,926
2007120903,2007_14_OAK_GB,2007,14,2007-12-09,Sunday,13:00,OAK,7,GB,38,Home,31,45,29391,200712090gnb,927
2007120904,2007_14_TB_HOU,2007,14,2007-12-09,Sunday,13:00,TB,14,HOU,28,Home,14,42,29392,200712090htx,928
2007120905,2007_14_CAR_JAX,2007,14,2007-12-09,Sunday,13:00,CAR,6,JAX,37,Home,31,43,29393,200712090jax,929
2007120906,2007_14_PIT_NE,2007,14,2007-12-09,Sunday,16:15,PIT,13,NE,34,Home,21,47,29394,200712090nwe,930
2007120907,2007_14_NYG_PHI,2007,14,2007-12-09,Sunday,13:00,NYG,16,PHI,13,Home,-3,29,29395,200712090phi,931
2007120908,2007_14_SD_TEN,2007,14,2007-12-09,Sunday,13:00,SD,23,TEN,17,Home,-6,40,29396,200712090oti,932
2007120909,2007_14_MIN_SF,2007,14,2007-12-09,Sunday,16:05,MIN,27,SF,7,Home,-20,34,29397,200712090sfo,933
2007120910,2007_14_ARI_SEA,2007,14,2007-12-09,Sunday,16:05,ARI,21,SEA,42,Home,21,63,29398,200712090sea,934
2007120911,2007_14_KC_DEN,2007,14,2007-12-09,Sunday,16:15,KC,7,DEN,41,Home,34,48,29400,200712090den,935
2007120912,2007_14_CLE_NYJ,2007,14,2007-12-09,Sunday,16:15,CLE,24,NYJ,18,Home,-6,42,29399,200712090nyj,936
2007120913,2007_14_IND_BAL,2007,14,2007-12-09,Sunday,20:25,IND,44,BAL,20,Home,-24,64,29401,200712090rav,937
2007121000,2007_14_NO_ATL,2007,14,2007-12-10,Monday,20:40,NO,34,ATL,14,Home,-20,48,29402,200712100atl,938
2007121300,2007_15_DEN_HOU,2007,15,2007-12-13,Thursday,20:15,DEN,13,HOU,31,Home,18,44,29403,200712130htx,939
2007121500,2007_15_CIN_SF,2007,15,2007-12-15,Saturday,20:15,CIN,13,SF,20,Home,7,33,29404,200712150sfo,940
2007121600,2007_15_SEA_CAR,2007,15,2007-12-16,Sunday,13:00,SEA,10,CAR,13,Home,3,23,29405,200712160car,941
2007121601,2007_15_BUF_CLE,2007,15,2007-12-16,Sunday,13:00,BUF,0,CLE,8,Home,8,8,29406,200712160cle,942
2007121602,2007_15_TEN_KC,2007,15,2007-12-16,Sunday,13:00,TEN,26,KC,17,Home,-9,43,29407,200712160kan,943
2007121603,2007_15_BAL_MIA,2007,15,2007-12-16,Sunday,13:00,BAL,16,MIA,22,Home,6,38,29408,200712160mia,944
2007121604,2007_15_NYJ_NE,2007,15,2007-12-16,Sunday,13:00,NYJ,10,NE,20,Home,10,30,29409,200712160nwe,945
2007121605,2007_15_ARI_NO,2007,15,2007-12-16,Sunday,13:00,ARI,24,NO,31,Home,7,55,29410,200712160nor,946
2007121606,2007_15_JAX_PIT,2007,15,2007-12-16,Sunday,13:00,JAX,29,PIT,22,Home,-7,51,29411,200712160pit,947
2007121607,2007_15_GB_STL,2007,15,2007-12-16,Sunday,13:00,GB,33,STL,14,Home,-19,47,29412,200712160ram,948
2007121608,2007_15_ATL_TB,2007,15,2007-12-16,Sunday,13:00,ATL,3,TB,37,Home,34,40,29413,200712160tam,949
2007121609,2007_15_IND_OAK,2007,15,2007-12-16,Sunday,16:05,IND,21,OAK,14,Home,-7,35,29414,200712160rai,950
2007121610,2007_15_PHI_DAL,2007,15,2007-12-16,Sunday,16:15,PHI,10,DAL,6,Home,-4,16,29415,200712160dal,951
2007121611,2007_15_DET_SD,2007,15,2007-12-16,Sunday,16:15,DET,14,SD,51,Home,37,65,29416,200712160sdg,952
2007121612,2007_15_WAS_NYG,2007,15,2007-12-16,Sunday,20:25,WAS,22,NYG,10,Home,-12,32,29417,200712160nyg,953
2007121701,2007_15_CHI_MIN,2007,15,2007-12-17,Monday,20:40,CHI,13,MIN,20,Home,7,33,29418,200712170min,954
2007122000,2007_16_PIT_STL,2007,16,2007-12-20,Thursday,20:15,PIT,41,STL,24,Home,-17,65,29419,200712200ram,955
2007122200,2007_16_DAL_CAR,2007,16,2007-12-22,Saturday,20:15,DAL,20,CAR,13,Home,-7,33,29420,200712220car,956
2007122300,2007_16_NYG_BUF,2007,16,2007-12-23,Sunday,13:00,NYG,38,BUF,21,Home,-17,59,29421,200712230buf,957
2007122301,2007_16_GB_CHI,2007,16,2007-12-23,Sunday,13:00,GB,7,CHI,35,Home,28,42,29422,200712230chi,958
2007122302,2007_16_CLE_CIN,2007,16,2007-12-23,Sunday,13:00,CLE,14,CIN,19,Home,5,33,29423,200712230cin,959
2007122303,2007_16_KC_DET,2007,16,2007-12-23,Sunday,13:00,KC,20,DET,25,Home,5,45,29424,200712230det,960
2007122304,2007_16_HOU_IND,2007,16,2007-12-23,Sunday,13:00,HOU,15,IND,38,Home,23,53,29425,200712230clt,961
2007122305,2007_16_OAK_JAX,2007,16,2007-12-23,Sunday,13:00,OAK,11,JAX,49,Home,38,60,29426,200712230jax,962
2007122306,2007_16_WAS_MIN,2007,16,2007-12-23,Sunday,20:15,WAS,32,MIN,21,Home,-11,53,29427,200712230min,963
2007122307,2007_16_MIA_NE,2007,16,2007-12-23,Sunday,16:15,MIA,7,NE,28,Home,21,35,29428,200712230nwe,964
2007122308,2007_16_PHI_NO,2007,16,2007-12-23,Sunday,13:00,PHI,38,NO,23,Home,-15,61,29429,200712230nor,965
2007122309,2007_16_ATL_ARI,2007,16,2007-12-23,Sunday,16:05,ATL,27,ARI,30,Home,3,57,29430,200712230crd,966
2007122310,2007_16_BAL_SEA,2007,16,2007-12-23,Sunday,16:15,BAL,6,SEA,27,Home,21,33,29431,200712230sea,967
2007122311,2007_16_NYJ_TEN,2007,16,2007-12-23,Sunday,16:15,NYJ,6,TEN,10,Home,4,16,29432,200712230oti,968
2007122312,2007_16_TB_SF,2007,16,2007-12-23,Sunday,16:05,TB,19,SF,21,Home,2,40,29433,200712230sfo,969
2007122400,2007_16_DEN_SD,2007,16,2007-12-24,Monday,20:00,DEN,3,SD,23,Home,20,26,29434,200712240sdg,970
2007122900,2007_17_NE_NYG,2007,17,2007-12-29,Saturday,20:15,NE,38,NYG,35,Home,-3,73,29435,200712290nyg,971
2007123000,2007_17_SEA_ATL,2007,17,2007-12-30,Sunday,13:00,SEA,41,ATL,44,Home,3,85,29436,200712300atl,972
2007123001,2007_17_PIT_BAL,2007,17,2007-12-30,Sunday,16:15,PIT,21,BAL,27,Home,6,48,29437,200712300rav,973
2007123002,2007_17_NO_CHI,2007,17,2007-12-30,Sunday,13:00,NO,25,CHI,33,Home,8,58,29438,200712300chi,974
2007123003,2007_17_SF_CLE,2007,17,2007-12-30,Sunday,13:00,SF,7,CLE,20,Home,13,27,29439,200712300cle,975
2007123004,2007_17_DET_GB,2007,17,2007-12-30,Sunday,13:00,DET,13,GB,34,Home,21,47,29440,200712300gnb,976
2007123005,2007_17_JAX_HOU,2007,17,2007-12-30,Sunday,13:00,JAX,28,HOU,42,Home,14,70,29441,200712300htx,977
2007123006,2007_17_TEN_IND,2007,17,2007-12-30,Sunday,20:25,TEN,16,IND,10,Home,-6,26,29442,200712300clt,978
2007123007,2007_17_CIN_MIA,2007,17,2007-12-30,Sunday,13:00,CIN,38,MIA,25,Home,-13,63,29443,200712300mia,979
2007123008,2007_17_BUF_PHI,2007,17,2007-12-30,Sunday,13:00,BUF,9,PHI,17,Home,8,26,29444,200712300phi,980
2007123009,2007_17_CAR_TB,2007,17,2007-12-30,Sunday,13:00,CAR,31,TB,23,Home,-8,54,29445,200712300tam,981
2007123010,2007_17_DAL_WAS,2007,17,2007-12-30,Sunday,16:15,DAL,6,WAS,27,Home,21,33,29446,200712300was,982
2007123011,2007_17_STL_ARI,2007,17,2007-12-30,Sunday,16:15,STL,19,ARI,48,Home,29,67,29447,200712300crd,983
2007123012,2007_17_MIN_DEN,2007,17,2007-12-30,Sunday,16:15,MIN,19,DEN,22,Home,3,41,29448,200712300den,984
2007123013,2007_17_SD_OAK,2007,17,2007-12-30,Sunday,16:15,SD,30,OAK,17,Home,-13,47,29449,200712300rai,985
2007123014,2007_17_KC_NYJ,2007,17,2007-12-30,Sunday,16:15,KC,10,NYJ,13,Home,3,23,29450,200712300nyj,986
2008010500,2007_18_WAS_SEA,2007,18,2008-01-05,Saturday,16:30,WAS,14,SEA,35,Home,21,49,29516,200801050sea,987
2008010501,2007_18_JAX_PIT,2007,18,2008-01-05,Saturday,20:15,JAX,31,PIT,29,Home,-2,60,29517,200801050pit,988
2008010600,2007_18_NYG_TB,2007,18,2008-01-06,Sunday,13:00,NYG,24,TB,14,Home,-10,38,29518,200801060tam,989
2008010601,2007_18_TEN_SD,2007,18,2008-01-06,Sunday,16:30,TEN,6,SD,17,Home,11,23,29519,200801060sdg,990
2008011200,2007_19_SEA_GB,2007,19,2008-01-12,Saturday,16:30,SEA,20,GB,42,Home,22,62,29520,200801120gnb,991
2008011201,2007_19_JAX_NE,2007,19,2008-01-12,Saturday,20:15,JAX,20,NE,31,Home,11,51,29521,200801120nwe,992
2008011300,2007_19_SD_IND,2007,19,2008-01-13,Sunday,13:00,SD,28,IND,24,Home,-4,52,29522,200801130clt,993
2008011301,2007_19_NYG_DAL,2007,19,2008-01-13,Sunday,16:30,NYG,21,DAL,17,Home,-4,38,29523,200801130dal,994
2008012000,2007_20_SD_NE,2007,20,2008-01-20,Sunday,15:00,SD,12,NE,21,Home,9,33,29524,200801200nwe,995
2008012001,2007_20_NYG_GB,2007,20,2008-01-20,Sunday,18:30,NYG,23,GB,20,Home,-3,43,29525,200801200gnb,996
2008020300,2007_21_NYG_NE,2007,21,2008-02-03,Sunday,18:30,NYG,17,NE,14,Neutral,-3,31,29526,200802030nwe,997
2008090400,2008_01_WAS_NYG,2008,1,2008-09-04,Thursday,19:00,WAS,7,NYG,16,Home,9,23,29528,200809040nyg,1063
2008090700,2008_01_DET_ATL,2008,1,2008-09-07,Sunday,13:00,DET,21,ATL,34,Home,13,55,29529,200809070atl,1069
2008090701,2008_01_CIN_BAL,2008,1,2008-09-07,Sunday,13:00,CIN,10,BAL,17,Home,7,27,29530,200809070rav,1064
2008090702,2008_01_SEA_BUF,2008,1,2008-09-07,Sunday,13:00,SEA,10,BUF,34,Home,24,44,29531,200809070buf,1070
2008090703,2008_01_NYJ_MIA,2008,1,2008-09-07,Sunday,13:00,NYJ,20,MIA,14,Home,-6,34,29532,200809070mia,1065
2008090704,2008_01_KC_NE,2008,1,2008-09-07,Sunday,13:00,KC,10,NE,17,Home,7,27,29533,200809070nwe,1066
2008090705,2008_01_TB_NO,2008,1,2008-09-07,Sunday,13:00,TB,20,NO,24,Home,4,44,29534,200809070nor,1071
2008090706,2008_01_STL_PHI,2008,1,2008-09-07,Sunday,13:00,STL,3,PHI,38,Home,35,41,29535,200809070phi,1072
2008090707,2008_01_HOU_PIT,2008,1,2008-09-07,Sunday,13:00,HOU,17,PIT,38,Home,21,55,29536,200809070pit,1067
2008090708,2008_01_JAX_TEN,2008,1,2008-09-07,Sunday,13:00,JAX,10,TEN,17,Home,7,27,29537,200809070oti,1068
2008090709,2008_01_DAL_CLE,2008,1,2008-09-07,Sunday,16:15,DAL,28,CLE,10,Home,-18,38,29538,200809070cle,1073
2008090710,2008_01_CAR_SD,2008,1,2008-09-07,Sunday,16:15,CAR,26,SD,24,Home,-2,50,29539,200809070sdg,1074
2008090711,2008_01_ARI_SF,2008,1,2008-09-07,Sunday,16:15,ARI,23,SF,13,Home,-10,36,29540,200809070sfo,1075
2008090712,2008_01_CHI_IND,2008,1,2008-09-07,Sunday,20:15,CHI,29,IND,13,Home,-16,42,29541,200809070clt,1076
2008090800,2008_01_MIN_GB,2008,1,2008-09-08,Monday,19:00,MIN,19,GB,24,Home,5,43,29542,200809080gnb,1077
2008090801,2008_01_DEN_OAK,2008,1,2008-09-08,Monday,22:15,DEN,41,OAK,14,Home,-27,55,29543,200809080rai,1078
2008091400,2008_02_CHI_CAR,2008,2,2008-09-14,Sunday,13:00,CHI,17,CAR,20,Home,3,37,29544,200809140car,1083
2008091401,2008_02_TEN_CIN,2008,2,2008-09-14,Sunday,13:00,TEN,24,CIN,7,Home,-17,31,29545,200809140cin,1079
2008091402,2008_02_GB_DET,2008,2,2008-09-14,Sunday,13:00,GB,48,DET,25,Home,-23,73,29546,200809140det,1084
2008091403,2008_02_BUF_JAX,2008,2,2008-09-14,Sunday,13:00,BUF,20,JAX,16,Home,-4,36,29547,200809140jax,1080
2008091404,2008_02_OAK_KC,2008,2,2008-09-14,Sunday,13:00,OAK,23,KC,8,Home,-15,31,29548,200809140kan,1081
2008091405,2008_02_IND_MIN,2008,2,2008-09-14,Sunday,13:00,IND,18,MIN,15,Home,-3,33,29549,200809140min,1082
2008091406,2008_02_NYG_STL,2008,2,2008-09-14,Sunday,13:00,NYG,41,STL,13,Home,-28,54,29550,200809140ram,1085
2008091407,2008_02_NO_WAS,2008,2,2008-09-14,Sunday,13:00,NO,24,WAS,29,Home,5,53,29551,200809140was,1086
2008091408,2008_02_SF_SEA,2008,2,2008-09-14,Sunday,16:05,SF,33,SEA,30,Home,-3,63,29552,200809140sea,1088
2008091409,2008_02_ATL_TB,2008,2,2008-09-14,Sunday,16:05,ATL,9,TB,24,Home,15,33,29553,200809140tam,1087
2008091410,2008_02_MIA_ARI,2008,2,2008-09-14,Sunday,16:15,MIA,10,ARI,31,Home,21,41,29554,200809140crd,1091
2008091411,2008_02_SD_DEN,2008,2,2008-09-14,Sunday,16:15,SD,38,DEN,39,Home,1,77,29555,200809140den,1090
2008091413,2008_02_NE_NYJ,2008,2,2008-09-14,Sunday,16:15,NE,19,NYJ,10,Home,-9,29,29557,200809140nyj,1089
2008091414,2008_02_PIT_CLE,2008,2,2008-09-14,Sunday,20:15,PIT,10,CLE,6,Home,-4,16,29558,200809140cle,1093
2008091500,2008_02_PHI_DAL,2008,2,2008-09-15,Monday,20:30,PHI,37,DAL,41,Home,4,78,29559,200809150dal,1094
2008092100,2008_03_KC_ATL,2008,3,2008-09-21,Sunday,13:00,KC,14,ATL,38,Home,24,52,29560,200809210atl,1095
2008092101,2008_03_OAK_BUF,2008,3,2008-09-21,Sunday,13:00,OAK,23,BUF,24,Home,1,47,29561,200809210buf,1096
2008092102,2008_03_TB_CHI,2008,3,2008-09-21,Sunday,13:00,TB,27,CHI,24,Home,-3,51,29562,200809210chi,1100
2008092103,2008_03_CAR_MIN,2008,3,2008-09-21,Sunday,13:00,CAR,10,MIN,20,Home,10,30,29563,200809210min,1102
2008092104,2008_03_MIA_NE,2008,3,2008-09-21,Sunday,13:00,MIA,38,NE,13,Home,-25,51,29564,200809210nwe,1098
2008092105,2008_03_CIN_NYG,2008,3,2008-09-21,Sunday,13:00,CIN,23,NYG,26,Home,3,49,29565,200809210nyg,1097
2008092106,2008_03_HOU_TEN,2008,3,2008-09-21,Sunday,13:00,HOU,12,TEN,31,Home,19,43,29566,200809210oti,1099
2008092107,2008_03_ARI_WAS,2008,3,2008-09-21,Sunday,13:00,ARI,17,WAS,24,Home,7,41,29567,200809210was,1101
2008092108,2008_03_NO_DEN,2008,3,2008-09-21,Sunday,16:05,NO,32,DEN,34,Home,2,66,29568,200809210den,1103
2008092109,2008_03_DET_SF,2008,3,2008-09-21,Sunday,16:05,DET,13,SF,31,Home,18,44,29569,200809210sfo,1104
2008092110,2008_03_STL_SEA,2008,3,2008-09-21,Sunday,16:05,STL,13,SEA,37,Home,24,50,29570,200809210sea,1105
2008092111,2008_03_CLE_BAL,2008,3,2008-09-21,Sunday,16:15,CLE,10,BAL,28,Home,18,38,29571,200809210rav,1108
2008092112,2008_03_JAX_IND,2008,3,2008-09-21,Sunday,16:15,JAX,23,IND,21,Home,-2,44,29572,200809210clt,1106
2008092113,2008_03_PIT_PHI,2008,3,2008-09-21,Sunday,16:15,PIT,6,PHI,15,Home,9,21,29573,200809210phi,1107
2008092114,2008_03_DAL_GB,2008,3,2008-09-21,Sunday,20:15,DAL,27,GB,16,Home,-11,43,29574,200809210gnb,1109
2008092200,2008_03_NYJ_SD,2008,3,2008-09-22,Monday,20:30,NYJ,29,SD,48,Home,19,77,29575,200809220sdg,1110
2008092800,2008_04_ATL_CAR,2008,4,2008-09-28,Sunday,13:00,ATL,9,CAR,24,Home,15,33,29576,200809280car,1114
2008092801,2008_04_CLE_CIN,2008,4,2008-09-28,Sunday,13:00,CLE,20,CIN,12,Home,-8,32,29577,200809280cin,1111
2008092802,2008_04_HOU_JAX,2008,4,2008-09-28,Sunday,13:00,HOU,27,JAX,30,Home,3,57,29578,200809280jax,1112
2008092803,2008_04_DEN_KC,2008,4,2008-09-28,Sunday,13:00,DEN,19,KC,33,Home,14,52,29579,200809280kan,1113
2008092804,2008_04_SF_NO,2008,4,2008-09-28,Sunday,13:00,SF,17,NO,31,Home,14,48,29580,200809280nor,1116
2008092805,2008_04_ARI_NYJ,2008,4,2008-09-28,Sunday,13:00,ARI,35,NYJ,56,Home,21,91,29581,200809280nyj,1115
2008092806,2008_04_GB_TB,2008,4,2008-09-28,Sunday,13:00,GB,21,TB,30,Home,9,51,29582,200809280tam,1117
2008092807,2008_04_MIN_TEN,2008,4,2008-09-28,Sunday,13:00,MIN,17,TEN,30,Home,13,47,29583,200809280oti,1118
2008092808,2008_04_SD_OAK,2008,4,2008-09-28,Sunday,16:05,SD,28,OAK,18,Home,-10,46,29584,200809280rai,1119
2008092809,2008_04_BUF_STL,2008,4,2008-09-28,Sunday,16:05,BUF,31,STL,14,Home,-17,45,29585,200809280ram,1120
2008092810,2008_04_WAS_DAL,2008,4,2008-09-28,Sunday,16:15,WAS,26,DAL,24,Home,-2,50,29586,200809280dal,1121
2008092811,2008_04_PHI_CHI,2008,4,2008-09-28,Sunday,20:15,PHI,20,CHI,24,Home,4,44,29587,200809280chi,1122
2008092900,2008_04_BAL_PIT,2008,4,2008-09-29,Monday,20:30,BAL,20,PIT,23,Home,3,43,29588,200809290pit,1123
2008100500,2008_05_TEN_BAL,2008,5,2008-10-05,Sunday,13:00,TEN,13,BAL,10,Home,-3,23,29589,200810050rav,1125
2008100501,2008_05_KC_CAR,2008,5,2008-10-05,Sunday,13:00,KC,0,CAR,34,Home,34,34,29590,200810050car,1126
2008100502,2008_05_CHI_DET,2008,5,2008-10-05,Sunday,13:00,CHI,34,DET,7,Home,-27,41,29591,200810050det,1129
2008100503,2008_05_ATL_GB,2008,5,2008-10-05,Sunday,13:00,ATL,27,GB,24,Home,-3,51,29592,200810050gnb,1130
2008100504,2008_05_IND_HOU,2008,5,2008-10-05,Sunday,13:00,IND,31,HOU,27,Home,-4,58,29593,200810050htx,1127
2008100505,2008_05_SD_MIA,2008,5,2008-10-05,Sunday,13:00,SD,10,MIA,17,Home,7,27,29594,200810050mia,1128
2008100506,2008_05_SEA_NYG,2008,5,2008-10-05,Sunday,13:00,SEA,6,NYG,44,Home,38,50,29595,200810050nyg,1131
2008100507,2008_05_WAS_PHI,2008,5,2008-10-05,Sunday,13:00,WAS,23,PHI,17,Home,-6,40,29596,200810050phi,1132
2008100508,2008_05_TB_DEN,2008,5,2008-10-05,Sunday,16:05,TB,13,DEN,16,Home,3,29,29597,200810050den,1133
2008100509,2008_05_BUF_ARI,2008,5,2008-10-05,Sunday,16:15,BUF,17,ARI,41,Home,24,58,29598,200810050crd,1124
2008100510,2008_05_CIN_DAL,2008,5,2008-10-05,Sunday,16:15,CIN,22,DAL,31,Home,9,53,29599,200810050dal,1134
2008100511,2008_05_NE_SF,2008,5,2008-10-05,Sunday,16:15,NE,30,SF,21,Home,-9,51,29600,200810050sfo,1135
2008100512,2008_05_PIT_JAX,2008,5,2008-10-05,Sunday,20:15,PIT,26,JAX,21,Home,-5,47,29601,200810050jax,1136
2008100600,2008_05_MIN_NO,2008,5,2008-10-06,Monday,20:30,MIN,30,NO,27,Home,-3,57,29602,200810060nor,1137
2008101200,2008_06_CHI_ATL,2008,6,2008-10-12,Sunday,13:00,CHI,20,ATL,22,Home,2,42,29603,200810120atl,1142
2008101201,2008_06_MIA_HOU,2008,6,2008-10-12,Sunday,13:00,MIA,28,HOU,29,Home,1,57,29604,200810120htx,1138
2008101202,2008_06_BAL_IND,2008,6,2008-10-12,Sunday,13:00,BAL,3,IND,31,Home,28,34,29605,200810120clt,1139
2008101203,2008_06_DET_MIN,2008,6,2008-10-12,Sunday,13:00,DET,10,MIN,12,Home,2,22,29606,200810120min,1143
2008101204,2008_06_OAK_NO,2008,6,2008-10-12,Sunday,13:00,OAK,3,NO,34,Home,31,37,29607,200810120nor,1141
2008101205,2008_06_CIN_NYJ,2008,6,2008-10-12,Sunday,13:00,CIN,14,NYJ,26,Home,12,40,29608,200810120nyj,1140
2008101206,2008_06_CAR_TB,2008,6,2008-10-12,Sunday,13:00,CAR,3,TB,27,Home,24,30,29609,200810120tam,1144
2008101207,2008_06_STL_WAS,2008,6,2008-10-12,Sunday,13:00,STL,19,WAS,17,Home,-2,36,29610,200810120was,1145
2008101208,2008_06_JAX_DEN,2008,6,2008-10-12,Sunday,16:05,JAX,24,DEN,17,Home,-7,41,29611,200810120den,1146
2008101209,2008_06_DAL_ARI,2008,6,2008-10-12,Sunday,16:15,DAL,24,ARI,30,Home,6,54,29612,200810120crd,1148
2008101210,2008_06_PHI_SF,2008,6,2008-10-12,Sunday,16:15,PHI,40,SF,26,Home,-14,66,29613,200810120sfo,1149
2008101211,2008_06_GB_SEA,2008,6,2008-10-12,Sunday,16:15,GB,27,SEA,17,Home,-10,44,29614,200810120sea,1147
2008101212,2008_06_NE_SD,2008,6,2008-10-12,Sunday,20:15,NE,10,SD,30,Home,20,40,29615,200810120sdg,1150
2008101300,2008_06_NYG_CLE,2008,6,2008-10-13,Monday,20:30,NYG,14,CLE,35,Home,21,49,29616,200810130cle,1151
2008101900,2008_07_SD_BUF,2008,7,2008-10-19,Sunday,13:00,SD,14,BUF,23,Home,9,37,29617,200810190buf,1152
2008101901,2008_07_NO_CAR,2008,7,2008-10-19,Sunday,13:00,NO,7,CAR,30,Home,23,37,29618,200810190car,1156
2008101902,2008_07_MIN_CHI,2008,7,2008-10-19,Sunday,13:00,MIN,41,CHI,48,Home,7,89,29619,200810190chi,1157
2008101903,2008_07_PIT_CIN,2008,7,2008-10-19,Sunday,13:00,PIT,38,CIN,10,Home,-28,48,29620,200810190cin,1153
2008101904,2008_07_TEN_KC,2008,7,2008-10-19,Sunday,13:00,TEN,34,KC,10,Home,-24,44,29621,200810190kan,1154
2008101905,2008_07_BAL_MIA,2008,7,2008-10-19,Sunday,13:00,BAL,27,MIA,13,Home,-14,40,29622,200810190mia,1155
2008101906,2008_07_SF_NYG,2008,7,2008-10-19,Sunday,13:00,SF,17,NYG,29,Home,12,46,29623,200810190nyg,1158
2008101907,2008_07_DAL_STL,2008,7,2008-10-19,Sunday,13:00,DAL,14,STL,34,Home,20,48,29624,200810190ram,1159
2008101908,2008_07_DET_HOU,2008,7,2008-10-19,Sunday,16:05,DET,21,HOU,28,Home,7,49,29625,200810190htx,1160
2008101909,2008_07_IND_GB,2008,7,2008-10-19,Sunday,16:15,IND,14,GB,34,Home,20,48,29626,200810190gnb,1162
2008101910,2008_07_NYJ_OAK,2008,7,2008-10-19,Sunday,16:15,NYJ,13,OAK,16,Home,3,29,29627,200810190rai,1163
2008101911,2008_07_CLE_WAS,2008,7,2008-10-19,Sunday,16:15,CLE,11,WAS,14,Home,3,25,29628,200810190was,1161
2008101912,2008_07_SEA_TB,2008,7,2008-10-19,Sunday,20:15,SEA,10,TB,20,Home,10,30,29629,200810190tam,1164
2008102000,2008_07_DEN_NE,2008,7,2008-10-20,Monday,20:30,DEN,7,NE,41,Home,34,48,29630,200810200nwe,1165
2008102600,2008_08_OAK_BAL,2008,8,2008-10-26,Sunday,13:00,OAK,10,BAL,29,Home,19,39,29631,200810260rav,1167
2008102601,2008_08_ARI_CAR,2008,8,2008-10-26,Sunday,13:00,ARI,23,CAR,27,Home,4,50,29632,200810260car,1170
2008102602,2008_08_TB_DAL,2008,8,2008-10-26,Sunday,13:00,TB,9,DAL,13,Home,4,22,29633,200810260dal,1171
2008102603,2008_08_WAS_DET,2008,8,2008-10-26,Sunday,13:00,WAS,25,DET,17,Home,-8,42,29634,200810260det,1172
2008102604,2008_08_BUF_MIA,2008,8,2008-10-26,Sunday,13:00,BUF,16,MIA,25,Home,9,41,29635,200810260mia,1168
2008102605,2008_08_STL_NE,2008,8,2008-10-26,Sunday,13:00,STL,16,NE,23,Home,7,39,29636,200810260nwe,1173
2008102606,2008_08_SD_NO,2008,8,2008-10-26,Sunday,13:00,SD,32,NO,37,Neutral,5,69,29637,200810260nor,1166
2008102607,2008_08_KC_NYJ,2008,8,2008-10-26,Sunday,13:00,KC,24,NYJ,28,Home,4,52,29638,200810260nyj,1169
2008102608,2008_08_ATL_PHI,2008,8,2008-10-26,Sunday,13:00,ATL,14,PHI,27,Home,13,41,29639,200810260phi,1174
2008102609,2008_08_CLE_JAX,2008,8,2008-10-26,Sunday,16:05,CLE,23,JAX,17,Home,-6,40,29640,200810260jax,1175
2008102610,2008_08_NYG_PIT,2008,8,2008-10-26,Sunday,16:15,NYG,21,PIT,14,Home,-7,35,29641,200810260pit,1176
2008102611,2008_08_SEA_SF,2008,8,2008-10-26,Sunday,16:15,SEA,34,SF,13,Home,-21,47,29642,200810260sfo,1177
2008102612,2008_08_CIN_HOU,2008,8,2008-10-26,Sunday,16:05,CIN,6,HOU,35,Home,29,41,29662,200810260htx,1178
2008102700,2008_08_IND_TEN,2008,8,2008-10-27,Monday,20:30,IND,21,TEN,31,Home,10,52,29643,200810270oti,1179
2008110200,2008_09_NYJ_BUF,2008,9,2008-11-02,Sunday,13:00,NYJ,26,BUF,17,Home,-9,43,29644,200811020buf,1180
2008110201,2008_09_DET_CHI,2008,9,2008-11-02,Sunday,13:00,DET,23,CHI,27,Home,4,50,29645,200811020chi,1184
2008110202,2008_09_JAX_CIN,2008,9,2008-11-02,Sunday,13:00,JAX,19,CIN,21,Home,2,40,29646,200811020cin,1181
2008110203,2008_09_BAL_CLE,2008,9,2008-11-02,Sunday,13:00,BAL,37,CLE,27,Home,-10,64,29647,200811020cle,1182
2008110204,2008_09_TB_KC,2008,9,2008-11-02,Sunday,13:00,TB,30,KC,27,Home,-3,57,29648,200811020kan,1185
2008110205,2008_09_HOU_MIN,2008,9,2008-11-02,Sunday,13:00,HOU,21,MIN,28,Home,7,49,29649,200811020min,1183
2008110206,2008_09_ARI_STL,2008,9,2008-11-02,Sunday,13:00,ARI,34,STL,13,Home,-21,47,29650,200811020ram,1186
2008110207,2008_09_GB_TEN,2008,9,2008-11-02,Sunday,13:00,GB,16,TEN,19,Home,3,35,29651,200811020oti,1187
2008110208,2008_09_MIA_DEN,2008,9,2008-11-02,Sunday,16:05,MIA,26,DEN,17,Home,-9,43,29652,200811020den,1188
2008110209,2008_09_DAL_NYG,2008,9,2008-11-02,Sunday,16:15,DAL,14,NYG,35,Home,21,49,29653,200811020nyg,1189
2008110210,2008_09_ATL_OAK,2008,9,2008-11-02,Sunday,16:15,ATL,24,OAK,0,Home,-24,24,29654,200811020rai,1191
2008110211,2008_09_PHI_SEA,2008,9,2008-11-02,Sunday,16:15,PHI,26,SEA,7,Home,-19,33,29655,200811020sea,1190
2008110212,2008_09_NE_IND,2008,9,2008-11-02,Sunday,20:15,NE,15,IND,18,Home,3,33,29656,200811020clt,1192
2008110300,2008_09_PIT_WAS,2008,9,2008-11-03,Monday,20:30,PIT,23,WAS,6,Home,-17,29,29657,200811030was,1193
2008110600,2008_10_DEN_CLE,2008,10,2008-11-06,Thursday,20:15,DEN,34,CLE,30,Home,-4,64,29658,200811060cle,1194
2008110900,2008_10_NO_ATL,2008,10,2008-11-09,Sunday,13:00,NO,20,ATL,34,Home,14,54,29659,200811090atl,1198
2008110901,2008_10_TEN_CHI,2008,10,2008-11-09,Sunday,13:00,TEN,21,CHI,14,Home,-7,35,29660,200811090chi,1195
2008110902,2008_10_JAX_DET,2008,10,2008-11-09,Sunday,13:00,JAX,38,DET,14,Home,-24,52,29661,200811090det,1196
2008110903,2008_10_BAL_HOU,2008,10,2008-11-09,Sunday,13:00,BAL,41,HOU,13,Home,-28,54,29556,200811090htx,1092
2008110904,2008_10_SEA_MIA,2008,10,2008-11-09,Sunday,13:00,SEA,19,MIA,21,Home,2,40,29663,200811090mia,1199
2008110905,2008_10_GB_MIN,2008,10,2008-11-09,Sunday,13:00,GB,27,MIN,28,Home,1,55,29664,200811090min,1200
2008110906,2008_10_BUF_NE,2008,10,2008-11-09,Sunday,13:00,BUF,10,NE,20,Home,10,30,29665,200811090nwe,1197
2008110907,2008_10_STL_NYJ,2008,10,2008-11-09,Sunday,13:00,STL,3,NYJ,47,Home,44,50,29666,200811090nyj,1201
2008110908,2008_10_CAR_OAK,2008,10,2008-11-09,Sunday,16:05,CAR,17,OAK,6,Home,-11,23,29667,200811090rai,1202
2008110909,2008_10_IND_PIT,2008,10,2008-11-09,Sunday,16:15,IND,24,PIT,20,Home,-4,44,29668,200811090pit,1203
2008110910,2008_10_KC_SD,2008,10,2008-11-09,Sunday,16:15,KC,19,SD,20,Home,1,39,29669,200811090sdg,1204
2008110911,2008_10_NYG_PHI,2008,10,2008-11-09,Sunday,20:15,NYG,36,PHI,31,Home,-5,67,29670,200811090phi,1205
2008111000,2008_10_SF_ARI,2008,10,2008-11-10,Monday,20:30,SF,24,ARI,29,Home,5,53,29671,200811100crd,1206
2008111300,2008_11_NYJ_NE,2008,11,2008-11-13,Thursday,20:15,NYJ,34,NE,31,Home,-3,65,29672,200811130nwe,1207
2008111600,2008_11_DEN_ATL,2008,11,2008-11-16,Sunday,13:00,DEN,24,ATL,20,Home,-4,44,29673,200811160atl,1208
2008111601,2008_11_DET_CAR,2008,11,2008-11-16,Sunday,13:00,DET,22,CAR,31,Home,9,53,29674,200811160car,1213
2008111602,2008_11_PHI_CIN,2008,11,2008-11-16,Sunday,13:00,PHI,13,CIN,13,Home,0,26,29675,200811160cin,1214
2008111603,2008_11_CHI_GB,2008,11,2008-11-16,Sunday,13:00,CHI,3,GB,37,Home,34,40,29676,200811160gnb,1215
2008111604,2008_11_HOU_IND,2008,11,2008-11-16,Sunday,13:00,HOU,27,IND,33,Home,6,60,29677,200811160clt,1209
2008111605,2008_11_TEN_JAX,2008,11,2008-11-16,Sunday,16:15,TEN,24,JAX,14,Home,-10,38,29678,200811160jax,1210
2008111606,2008_11_NO_KC,2008,11,2008-11-16,Sunday,13:00,NO,30,KC,20,Home,-10,50,29679,200811160kan,1216
2008111607,2008_11_OAK_MIA,2008,11,2008-11-16,Sunday,13:00,OAK,15,MIA,17,Home,2,32,29680,200811160mia,1211
2008111608,2008_11_BAL_NYG,2008,11,2008-11-16,Sunday,13:00,BAL,10,NYG,30,Home,20,40,29681,200811160nyg,1212
2008111609,2008_11_MIN_TB,2008,11,2008-11-16,Sunday,13:00,MIN,13,TB,19,Home,6,32,29682,200811160tam,1217
2008111610,2008_11_STL_SF,2008,11,2008-11-16,Sunday,16:05,STL,16,SF,35,Home,19,51,29683,200811160sfo,1218
2008111611,2008_11_ARI_SEA,2008,11,2008-11-16,Sunday,16:05,ARI,26,SEA,20,Home,-6,46,29684,200811160sea,1219
2008111612,2008_11_SD_PIT,2008,11,2008-11-16,Sunday,16:15,SD,10,PIT,11,Home,1,21,29685,200811160pit,1220
2008111613,2008_11_DAL_WAS,2008,11,2008-11-16,Sunday,20:15,DAL,14,WAS,10,Home,-4,24,29686,200811160was,1221
2008111700,2008_11_CLE_BUF,2008,11,2008-11-17,Monday,20:30,CLE,29,BUF,27,Home,-2,56,29687,200811170buf,1222
2008112000,2008_12_CIN_PIT,2008,12,2008-11-20,Thursday,20:15,CIN,10,PIT,27,Home,17,37,29688,200811200pit,1223
2008112300,2008_12_CAR_ATL,2008,12,2008-11-23,Sunday,16:15,CAR,28,ATL,45,Home,17,73,29689,200811230atl,1228
2008112301,2008_12_PHI_BAL,2008,12,2008-11-23,Sunday,13:00,PHI,7,BAL,36,Home,29,43,29690,200811230rav,1229
2008112302,2008_12_HOU_CLE,2008,12,2008-11-23,Sunday,13:00,HOU,16,CLE,6,Home,-10,22,29691,200811230cle,1224
2008112303,2008_12_SF_DAL,2008,12,2008-11-23,Sunday,13:00,SF,22,DAL,35,Home,13,57,29692,200811230dal,1230
2008112304,2008_12_TB_DET,2008,12,2008-11-23,Sunday,13:00,TB,38,DET,20,Home,-18,58,29693,200811230det,1231
2008112305,2008_12_MIN_JAX,2008,12,2008-11-23,Sunday,13:00,MIN,30,JAX,12,Home,-18,42,29694,200811230jax,1232
2008112306,2008_12_BUF_KC,2008,12,2008-11-23,Sunday,13:00,BUF,54,KC,31,Home,-23,85,29695,200811230kan,1225
2008112307,2008_12_NE_MIA,2008,12,2008-11-23,Sunday,13:00,NE,48,MIA,28,Home,-20,76,29696,200811230mia,1226
2008112308,2008_12_CHI_STL,2008,12,2008-11-23,Sunday,13:00,CHI,27,STL,3,Home,-24,30,29697,200811230ram,1233
2008112309,2008_12_NYJ_TEN,2008,12,2008-11-23,Sunday,13:00,NYJ,34,TEN,13,Home,-21,47,29698,200811230oti,1227
2008112310,2008_12_OAK_DEN,2008,12,2008-11-23,Sunday,16:05,OAK,31,DEN,10,Home,-21,41,29699,200811230den,1234
2008112311,2008_12_NYG_ARI,2008,12,2008-11-23,Sunday,16:15,NYG,37,ARI,29,Home,-8,66,29700,200811230crd,1235
2008112312,2008_12_WAS_SEA,2008,12,2008-11-23,Sunday,16:15,WAS,20,SEA,17,Home,-3,37,29701,200811230sea,1236
2008112313,2008_12_IND_SD,2008,12,2008-11-23,Sunday,20:15,IND,23,SD,20,Home,-3,43,29702,200811230sdg,1237
2008112400,2008_12_GB_NO,2008,12,2008-11-24,Monday,20:30,GB,29,NO,51,Home,22,80,29703,200811240nor,1238
2008112700,2008_13_TEN_DET,2008,13,2008-11-27,Thursday,12:30,TEN,47,DET,10,Home,-37,57,29704,200811270det,1239
2008112701,2008_13_SEA_DAL,2008,13,2008-11-27,Thursday,16:25,SEA,9,DAL,34,Home,25,43,29705,200811270dal,1240
2008112702,2008_13_ARI_PHI,2008,13,2008-11-27,Thursday,20:15,ARI,20,PHI,48,Home,28,68,29706,200811270phi,1241
2008113000,2008_13_SF_BUF,2008,13,2008-11-30,Sunday,13:00,SF,10,BUF,3,Home,-7,13,29707,200811300buf,1247
2008113001,2008_13_BAL_CIN,2008,13,2008-11-30,Sunday,13:00,BAL,34,CIN,3,Home,-31,37,29708,200811300cin,1244
2008113002,2008_13_IND_CLE,2008,13,2008-11-30,Sunday,13:00,IND,10,CLE,6,Home,-4,16,29709,200811300cle,1243
2008113003,2008_13_CAR_GB,2008,13,2008-11-30,Sunday,13:00,CAR,35,GB,31,Home,-4,66,29710,200811300gnb,1248
2008113004,2008_13_DEN_NYJ,2008,13,2008-11-30,Sunday,16:15,DEN,34,NYJ,17,Home,-17,51,29711,200811300nyj,1245
2008113005,2008_13_MIA_STL,2008,13,2008-11-30,Sunday,13:00,MIA,16,STL,12,Home,-4,28,29712,200811300ram,1246
2008113006,2008_13_NO_TB,2008,13,2008-11-30,Sunday,13:00,NO,20,TB,23,Home,3,43,29713,200811300tam,1249
2008113007,2008_13_NYG_WAS,2008,13,2008-11-30,Sunday,13:00,NYG,23,WAS,7,Home,-16,30,29714,200811300was,1250
2008113008,2008_13_ATL_SD,2008,13,2008-11-30,Sunday,16:05,ATL,22,SD,16,Home,-6,38,29715,200811300sdg,1251
2008113009,2008_13_PIT_NE,2008,13,2008-11-30,Sunday,16:15,PIT,33,NE,10,Home,-23,43,29716,200811300nwe,1242
2008113010,2008_13_KC_OAK,2008,13,2008-11-30,Sunday,16:15,KC,20,OAK,13,Home,-7,33,29717,200811300rai,1252
2008113011,2008_13_CHI_MIN,2008,13,2008-11-30,Sunday,20:15,CHI,14,MIN,34,Home,20,48,29718,200811300min,1253
2008120100,2008_13_JAX_HOU,2008,13,2008-12-01,Monday,20:30,JAX,17,HOU,30,Home,13,47,29719,200812010htx,1254
2008120400,2008_14_OAK_SD,2008,14,2008-12-04,Thursday,20:15,OAK,7,SD,34,Home,27,41,29720,200812040sdg,1255
2008120700,2008_14_WAS_BAL,2008,14,2008-12-07,Sunday,20:15,WAS,10,BAL,24,Home,14,34,29721,200812070rav,1261
2008120701,2008_14_JAX_CHI,2008,14,2008-12-07,Sunday,13:00,JAX,10,CHI,23,Home,13,33,29722,200812070chi,1257
2008120702,2008_14_MIN_DET,2008,14,2008-12-07,Sunday,13:00,MIN,20,DET,16,Home,-4,36,29723,200812070det,1262
2008120703,2008_14_HOU_GB,2008,14,2008-12-07,Sunday,13:00,HOU,24,GB,21,Home,-3,45,29724,200812070gnb,1258
2008120704,2008_14_CIN_IND,2008,14,2008-12-07,Sunday,13:00,CIN,3,IND,35,Home,32,38,29725,200812070clt,1259
2008120705,2008_14_ATL_NO,2008,14,2008-12-07,Sunday,13:00,ATL,25,NO,29,Home,4,54,29726,200812070nor,1264
2008120706,2008_14_PHI_NYG,2008,14,2008-12-07,Sunday,13:00,PHI,20,NYG,14,Home,-6,34,29727,200812070nyg,1263
2008120707,2008_14_CLE_TEN,2008,14,2008-12-07,Sunday,13:00,CLE,9,TEN,28,Home,19,37,29728,200812070oti,1260
2008120708,2008_14_MIA_BUF,2008,14,2008-12-07,Sunday,16:05,MIA,16,BUF,3,Neutral,-13,19,29729,200812070buf,1256
2008120709,2008_14_KC_DEN,2008,14,2008-12-07,Sunday,16:05,KC,17,DEN,24,Home,7,41,29730,200812070den,1265
2008120710,2008_14_NYJ_SF,2008,14,2008-12-07,Sunday,16:05,NYJ,14,SF,24,Home,10,38,29731,200812070sfo,1266
2008120711,2008_14_STL_ARI,2008,14,2008-12-07,Sunday,16:15,STL,10,ARI,34,Home,24,44,29732,200812070crd,1268
2008120712,2008_14_DAL_PIT,2008,14,2008-12-07,Sunday,16:15,DAL,13,PIT,20,Home,7,33,29733,200812070pit,1267
2008120713,2008_14_NE_SEA,2008,14,2008-12-07,Sunday,16:05,NE,24,SEA,21,Home,-3,45,29734,200812070sea,1269
2008120800,2008_14_TB_CAR,2008,14,2008-12-08,Monday,20:30,TB,23,CAR,38,Home,15,61,29735,200812080car,1270
2008121100,2008_15_NO_CHI,2008,15,2008-12-11,Thursday,20:15,NO,24,CHI,27,Home,3,51,29736,200812110chi,1271
2008121400,2008_15_TB_ATL,2008,15,2008-12-14,Sunday,13:00,TB,10,ATL,13,Home,3,23,29737,200812140atl,1277
2008121401,2008_15_PIT_BAL,2008,15,2008-12-14,Sunday,16:15,PIT,13,BAL,9,Home,-4,22,29738,200812140rav,1272
2008121402,2008_15_DEN_CAR,2008,15,2008-12-14,Sunday,16:15,DEN,10,CAR,30,Home,20,40,29739,200812140car,1273
2008121403,2008_15_WAS_CIN,2008,15,2008-12-14,Sunday,13:00,WAS,13,CIN,20,Home,7,33,29740,200812140cin,1278
2008121404,2008_15_TEN_HOU,2008,15,2008-12-14,Sunday,13:00,TEN,12,HOU,13,Home,1,25,29741,200812140htx,1274
2008121405,2008_15_DET_IND,2008,15,2008-12-14,Sunday,13:00,DET,21,IND,31,Home,10,52,29742,200812140clt,1279
2008121406,2008_15_GB_JAX,2008,15,2008-12-14,Sunday,13:00,GB,16,JAX,20,Home,4,36,29743,200812140jax,1280
2008121407,2008_15_SD_KC,2008,15,2008-12-14,Sunday,13:00,SD,22,KC,21,Home,-1,43,29744,200812140kan,1275
2008121408,2008_15_SF_MIA,2008,15,2008-12-14,Sunday,13:00,SF,9,MIA,14,Home,5,23,29745,200812140mia,1281
2008121409,2008_15_BUF_NYJ,2008,15,2008-12-14,Sunday,13:00,BUF,27,NYJ,31,Home,4,58,29746,200812140nyj,1276
2008121410,2008_15_SEA_STL,2008,15,2008-12-14,Sunday,13:00,SEA,23,STL,20,Home,-3,43,29747,200812140ram,1282
2008121411,2008_15_MIN_ARI,2008,15,2008-12-14,Sunday,16:05,MIN,35,ARI,14,Home,-21,49,29748,200812140crd,1283
2008121412,2008_15_NE_OAK,2008,15,2008-12-14,Sunday,16:15,NE,49,OAK,26,Home,-23,75,29749,200812140rai,1284
2008121413,2008_15_NYG_DAL,2008,15,2008-12-14,Sunday,20:15,NYG,8,DAL,20,Home,12,28,29750,200812140dal,1285
2008121500,2008_15_CLE_PHI,2008,15,2008-12-15,Monday,20:30,CLE,10,PHI,30,Home,20,40,29751,200812150phi,1286
2008121800,2008_16_IND_JAX,2008,16,2008-12-18,Thursday,20:15,IND,31,JAX,24,Home,-7,55,29752,200812180jax,1287
2008122000,2008_16_BAL_DAL,2008,16,2008-12-20,Saturday,20:15,BAL,33,DAL,24,Home,-9,57,29753,200812200dal,1288
2008122100,2008_16_CIN_CLE,2008,16,2008-12-21,Sunday,13:00,CIN,14,CLE,0,Home,-14,14,29754,200812210cle,1289
2008122101,2008_16_NO_DET,2008,16,2008-12-21,Sunday,13:00,NO,42,DET,7,Home,-35,49,29755,200812210det,1295
2008122102,2008_16_MIA_KC,2008,16,2008-12-21,Sunday,13:00,MIA,38,KC,31,Home,-7,69,29756,200812210kan,1291
2008122103,2008_16_ATL_MIN,2008,16,2008-12-21,Sunday,16:15,ATL,24,MIN,17,Home,-7,41,29757,200812210min,1296
2008122104,2008_16_ARI_NE,2008,16,2008-12-21,Sunday,13:00,ARI,7,NE,47,Home,40,54,29758,200812210nwe,1294
2008122105,2008_16_CAR_NYG,2008,16,2008-12-21,Sunday,20:15,CAR,28,NYG,34,Home,6,62,29759,200812210nyg,1297
2008122106,2008_16_SF_STL,2008,16,2008-12-21,Sunday,13:00,SF,17,STL,16,Home,-1,33,29760,200812210ram,1298
2008122107,2008_16_PIT_TEN,2008,16,2008-12-21,Sunday,13:00,PIT,14,TEN,31,Home,17,45,29761,200812210oti,1292
2008122108,2008_16_PHI_WAS,2008,16,2008-12-21,Sunday,16:15,PHI,3,WAS,10,Home,7,13,29762,200812210was,1293
2008122109,2008_16_BUF_DEN,2008,16,2008-12-21,Sunday,16:05,BUF,30,DEN,23,Home,-7,53,29763,200812210den,1290
2008122110,2008_16_HOU_OAK,2008,16,2008-12-21,Sunday,16:05,HOU,16,OAK,27,Home,11,43,29764,200812210rai,1300
2008122111,2008_16_NYJ_SEA,2008,16,2008-12-21,Sunday,16:05,NYJ,3,SEA,13,Home,10,16,29765,200812210sea,1299
2008122112,2008_16_SD_TB,2008,16,2008-12-21,Sunday,13:00,SD,41,TB,24,Home,-17,65,29766,200812210tam,1301
2008122200,2008_16_GB_CHI,2008,16,2008-12-22,Monday,20:30,GB,17,CHI,20,Home,3,37,29767,200812220chi,1302
2008122800,2008_17_STL_ATL,2008,17,2008-12-28,Sunday,13:00,STL,27,ATL,31,Home,4,58,29768,200812280atl,1313
2008122801,2008_17_JAX_BAL,2008,17,2008-12-28,Sunday,16:15,JAX,7,BAL,27,Home,20,34,29769,200812280rav,1306
2008122802,2008_17_NE_BUF,2008,17,2008-12-28,Sunday,13:00,NE,13,BUF,0,Home,-13,13,29770,200812280buf,1305
2008122803,2008_17_KC_CIN,2008,17,2008-12-28,Sunday,13:00,KC,6,CIN,16,Home,10,22,29771,200812280cin,1307
2008122804,2008_17_DET_GB,2008,17,2008-12-28,Sunday,13:00,DET,21,GB,31,Home,10,52,29772,200812280gnb,1314
2008122805,2008_17_CHI_HOU,2008,17,2008-12-28,Sunday,13:00,CHI,24,HOU,31,Home,7,55,29773,200812280htx,1312
2008122806,2008_17_TEN_IND,2008,17,2008-12-28,Sunday,13:00,TEN,0,IND,23,Home,23,23,29774,200812280clt,1304
2008122807,2008_17_NYG_MIN,2008,17,2008-12-28,Sunday,13:00,NYG,19,MIN,20,Home,1,39,29775,200812280min,1311
2008122808,2008_17_CAR_NO,2008,17,2008-12-28,Sunday,13:00,CAR,33,NO,31,Home,-2,64,29776,200812280nor,1315
2008122809,2008_17_MIA_NYJ,2008,17,2008-12-28,Sunday,16:15,MIA,24,NYJ,17,Home,-7,41,29777,200812280nyj,1308
2008122810,2008_17_DAL_PHI,2008,17,2008-12-28,Sunday,16:15,DAL,6,PHI,44,Home,38,50,29778,200812280phi,1310
2008122811,2008_17_CLE_PIT,2008,17,2008-12-28,Sunday,13:00,CLE,0,PIT,31,Home,31,31,29779,200812280pit,1303
2008122812,2008_17_OAK_TB,2008,17,2008-12-28,Sunday,13:00,OAK,31,TB,24,Home,-7,55,29780,200812280tam,1309
2008122813,2008_17_SEA_ARI,2008,17,2008-12-28,Sunday,16:15,SEA,21,ARI,34,Home,13,55,29781,200812280crd,1318
2008122814,2008_17_DEN_SD,2008,17,2008-12-28,Sunday,20:15,DEN,21,SD,52,Home,31,73,29782,200812280sdg,1316
2008122815,2008_17_WAS_SF,2008,17,2008-12-28,Sunday,16:15,WAS,24,SF,27,Home,3,51,29783,200812280sfo,1317
2009010300,2008_18_ATL_ARI,2008,18,2009-01-03,Saturday,16:30,ATL,24,ARI,30,Home,6,54,54455,200901030crd,1319
2009010301,2008_18_IND_SD,2008,18,2009-01-03,Saturday,20:00,IND,17,SD,23,Home,6,40,54456,200901030sdg,1320
2009010400,2008_18_BAL_MIA,2008,18,2009-01-04,Sunday,13:00,BAL,27,MIA,9,Home,-18,36,54457,200901040mia,1321
2009010401,2008_18_PHI_MIN,2008,18,2009-01-04,Sunday,16:30,PHI,26,MIN,14,Home,-12,40,54458,200901040min,1322
2009011000,2008_19_BAL_TEN,2008,19,2009-01-10,Saturday,16:30,BAL,13,TEN,10,Home,-3,23,54459,200901100oti,1323
2009011001,2008_19_ARI_CAR,2008,19,2009-01-10,Saturday,20:15,ARI,33,CAR,13,Home,-20,46,54460,200901100car,1324
2009011100,2008_19_SD_PIT,2008,19,2009-01-11,Sunday,16:45,SD,24,PIT,35,Home,11,59,54462,200901110pit,1326
2009011101,2008_19_PHI_NYG,2008,19,2009-01-11,Sunday,13:00,PHI,23,NYG,11,Home,-12,34,54461,200901110nyg,1325
2009011800,2008_20_PHI_ARI,2008,20,2009-01-18,Sunday,16:05,PHI,25,ARI,32,Home,7,57,54463,200901180crd,1327
2009011801,2008_20_BAL_PIT,2008,20,2009-01-18,Sunday,18:30,BAL,14,PIT,23,Home,9,37,54464,200901180pit,1328
2009020100,2008_21_PIT_ARI,2008,21,2009-02-01,Sunday,18:31,PIT,27,ARI,23,Neutral,-4,50,54465,200902010crd,1329
2009091000,2009_01_TEN_PIT,2009,1,2009-09-10,Thursday,20:30,TEN,10,PIT,13,Home,3,23,54467,200909100pit,1395
2009091300,2009_01_MIA_ATL,2009,1,2009-09-13,Sunday,13:00,MIA,7,ATL,19,Home,12,26,54468,200909130atl,1396
2009091301,2009_01_KC_BAL,2009,1,2009-09-13,Sunday,13:00,KC,24,BAL,38,Home,14,62,54469,200909130rav,1398
2009091302,2009_01_PHI_CAR,2009,1,2009-09-13,Sunday,13:00,PHI,38,CAR,10,Home,-28,48,54470,200909130car,1404
2009091303,2009_01_DEN_CIN,2009,1,2009-09-13,Sunday,13:00,DEN,12,CIN,7,Home,-5,19,54471,200909130cin,1403
2009091304,2009_01_MIN_CLE,2009,1,2009-09-13,Sunday,13:00,MIN,34,CLE,20,Home,-14,54,54472,200909130cle,1399
2009091305,2009_01_NYJ_HOU,2009,1,2009-09-13,Sunday,13:00,NYJ,24,HOU,7,Home,-17,31,54473,200909130htx,1397
2009091306,2009_01_JAX_IND,2009,1,2009-09-13,Sunday,13:00,JAX,12,IND,14,Home,2,26,54474,200909130clt,1400
2009091307,2009_01_DET_NO,2009,1,2009-09-13,Sunday,13:00,DET,27,NO,45,Home,18,72,54475,200909130nor,1402
2009091308,2009_01_DAL_TB,2009,1,2009-09-13,Sunday,13:00,DAL,34,TB,21,Home,-13,55,54476,200909130tam,1401
2009091309,2009_01_SF_ARI,2009,1,2009-09-13,Sunday,16:15,SF,20,ARI,16,Home,-4,36,54477,200909130crd,1405
2009091310,2009_01_WAS_NYG,2009,1,2009-09-13,Sunday,16:15,WAS,17,NYG,23,Home,6,40,54478,200909130nyg,1406
2009091311,2009_01_STL_SEA,2009,1,2009-09-13,Sunday,16:15,STL,0,SEA,28,Home,28,28,54479,200909130sea,1407
2009091312,2009_01_CHI_GB,2009,1,2009-09-13,Sunday,20:20,CHI,15,GB,21,Home,6,36,54480,200909130gnb,1408
2009091400,2009_01_BUF_NE,2009,1,2009-09-14,Monday,19:00,BUF,24,NE,25,Home,1,49,54481,200909140nwe,1409
2009091401,2009_01_SD_OAK,2009,1,2009-09-14,Monday,22:15,SD,24,OAK,20,Home,-4,44,54482,200909140rai,1410
2009092000,2009_02_CAR_ATL,2009,2,2009-09-20,Sunday,13:00,CAR,20,ATL,28,Home,8,48,54483,200909200atl,1411
2009092001,2009_02_MIN_DET,2009,2,2009-09-20,Sunday,13:00,MIN,27,DET,13,Home,-14,40,54484,200909200det,1412
2009092002,2009_02_CIN_GB,2009,2,2009-09-20,Sunday,13:00,CIN,31,GB,24,Home,-7,55,54485,200909200gnb,1413
2009092003,2009_02_ARI_JAX,2009,2,2009-09-20,Sunday,13:00,ARI,31,JAX,17,Home,-14,48,54486,200909200jax,1419
2009092004,2009_02_OAK_KC,2009,2,2009-09-20,Sunday,13:00,OAK,13,KC,10,Home,-3,23,54487,200909200kan,1415
2009092005,2009_02_NE_NYJ,2009,2,2009-09-20,Sunday,13:00,NE,9,NYJ,16,Home,7,25,54488,200909200nyj,1416
2009092006,2009_02_NO_PHI,2009,2,2009-09-20,Sunday,13:00,NO,48,PHI,22,Home,-26,70,54489,200909200phi,1417
2009092007,2009_02_HOU_TEN,2009,2,2009-09-20,Sunday,13:00,HOU,34,TEN,31,Home,-3,65,54490,200909200oti,1414
2009092008,2009_02_STL_WAS,2009,2,2009-09-20,Sunday,13:00,STL,7,WAS,9,Home,2,16,54491,200909200was,1418
2009092009,2009_02_TB_BUF,2009,2,2009-09-20,Sunday,16:05,TB,20,BUF,33,Home,13,53,54492,200909200buf,1421
2009092010,2009_02_SEA_SF,2009,2,2009-09-20,Sunday,16:05,SEA,10,SF,23,Home,13,33,54493,200909200sfo,1420
2009092011,2009_02_PIT_CHI,2009,2,2009-09-20,Sunday,16:15,PIT,14,CHI,17,Home,3,31,54494,200909200chi,1422
2009092012,2009_02_CLE_DEN,2009,2,2009-09-20,Sunday,16:15,CLE,6,DEN,27,Home,21,33,54495,200909200den,1424
2009092013,2009_02_BAL_SD,2009,2,2009-09-20,Sunday,16:15,BAL,31,SD,26,Home,-5,57,54496,200909200sdg,1423
2009092014,2009_02_NYG_DAL,2009,2,2009-09-20,Sunday,20:20,NYG,33,DAL,31,Home,-2,64,54497,200909200dal,1425
2009092100,2009_02_IND_MIA,2009,2,2009-09-21,Monday,20:30,IND,27,MIA,23,Home,-4,50,54498,200909210mia,1426
2009092700,2009_03_CLE_BAL,2009,3,2009-09-27,Sunday,13:00,CLE,3,BAL,34,Home,31,37,54504,200909270rav,1434
2009092701,2009_03_PIT_CIN,2009,3,2009-09-27,Sunday,16:15,PIT,20,CIN,23,Home,3,43,54505,200909270cin,1427
2009092702,2009_03_WAS_DET,2009,3,2009-09-27,Sunday,13:00,WAS,14,DET,19,Home,5,33,54506,200909270det,1428
2009092703,2009_03_JAX_HOU,2009,3,2009-09-27,Sunday,13:00,JAX,31,HOU,24,Home,-7,55,54507,200909270htx,1435
2009092704,2009_03_SF_MIN,2009,3,2009-09-27,Sunday,13:00,SF,24,MIN,27,Home,3,51,54508,200909270min,1431
2009092705,2009_03_ATL_NE,2009,3,2009-09-27,Sunday,13:00,ATL,10,NE,26,Home,16,36,54509,200909270nwe,1432
2009092706,2009_03_KC_PHI,2009,3,2009-09-27,Sunday,13:00,KC,14,PHI,34,Home,20,48,54510,200909270phi,1429
2009092707,2009_03_GB_STL,2009,3,2009-09-27,Sunday,13:00,GB,36,STL,17,Home,-19,53,54511,200909270ram,1430
2009092708,2009_03_NYG_TB,2009,3,2009-09-27,Sunday,13:00,NYG,24,TB,0,Home,-24,24,54512,200909270tam,1433
2009092709,2009_03_NO_BUF,2009,3,2009-09-27,Sunday,16:05,NO,27,BUF,7,Home,-20,34,54513,200909270buf,1438
2009092710,2009_03_CHI_SEA,2009,3,2009-09-27,Sunday,16:05,CHI,25,SEA,19,Home,-6,44,54514,200909270sea,1437
2009092711,2009_03_TEN_NYJ,2009,3,2009-09-27,Sunday,13:00,TEN,17,NYJ,24,Home,7,41,54499,200909270nyj,1436
2009092712,2009_03_DEN_OAK,2009,3,2009-09-27,Sunday,16:15,DEN,23,OAK,3,Home,-20,26,54500,200909270rai,1439
2009092713,2009_03_MIA_SD,2009,3,2009-09-27,Sunday,16:15,MIA,13,SD,23,Home,10,36,54501,200909270sdg,1440
2009092714,2009_03_IND_ARI,2009,3,2009-09-27,Sunday,20:20,IND,31,ARI,10,Home,-21,41,54502,200909270crd,1441
2009092800,2009_03_CAR_DAL,2009,3,2009-09-28,Monday,20:30,CAR,7,DAL,21,Home,14,28,54503,200909280dal,1442
2009100400,2009_04_DET_CHI,2009,4,2009-10-04,Sunday,13:00,DET,24,CHI,48,Home,24,72,54515,200910040chi,1443
2009100401,2009_04_CIN_CLE,2009,4,2009-10-04,Sunday,13:00,CIN,23,CLE,20,Home,-3,43,54516,200910040cle,1444
2009100402,2009_04_OAK_HOU,2009,4,2009-10-04,Sunday,13:00,OAK,6,HOU,29,Home,23,35,54517,200910040htx,1450
2009100403,2009_04_SEA_IND,2009,4,2009-10-04,Sunday,13:00,SEA,17,IND,34,Home,17,51,54518,200910040clt,1445
2009100404,2009_04_TEN_JAX,2009,4,2009-10-04,Sunday,13:00,TEN,17,JAX,37,Home,20,54,54519,200910040jax,1449
2009100405,2009_04_NYG_KC,2009,4,2009-10-04,Sunday,13:00,NYG,27,KC,16,Home,-11,43,54520,200910040kan,1446
2009100406,2009_04_BAL_NE,2009,4,2009-10-04,Sunday,13:00,BAL,21,NE,27,Home,6,48,54521,200910040nwe,1447
2009100407,2009_04_TB_WAS,2009,4,2009-10-04,Sunday,13:00,TB,13,WAS,16,Home,3,29,54522,200910040was,1448
2009100408,2009_04_BUF_MIA,2009,4,2009-10-04,Sunday,16:05,BUF,10,MIA,38,Home,28,48,54523,200910040mia,1452
2009100409,2009_04_NYJ_NO,2009,4,2009-10-04,Sunday,16:05,NYJ,10,NO,24,Home,14,34,54524,200910040nor,1451
2009100410,2009_04_DAL_DEN,2009,4,2009-10-04,Sunday,16:15,DAL,10,DEN,17,Home,7,27,54525,200910040den,1453
2009100411,2009_04_STL_SF,2009,4,2009-10-04,Sunday,16:15,STL,0,SF,35,Home,35,35,54526,200910040sfo,1454
2009100412,2009_04_SD_PIT,2009,4,2009-10-04,Sunday,20:20,SD,28,PIT,38,Home,10,66,54527,200910040pit,1455
2009100500,2009_04_GB_MIN,2009,4,2009-10-05,Monday,20:30,GB,23,MIN,30,Home,7,53,54528,200910050min,1456
2009101100,2009_05_CIN_BAL,2009,5,2009-10-11,Sunday,13:00,CIN,17,BAL,14,Home,-3,31,54529,200910110rav,1464
2009101101,2009_05_CLE_BUF,2009,5,2009-10-11,Sunday,13:00,CLE,6,BUF,3,Home,-3,9,54530,200910110buf,1457
2009101102,2009_05_WAS_CAR,2009,5,2009-10-11,Sunday,13:00,WAS,17,CAR,20,Home,3,37,54531,200910110car,1463
2009101103,2009_05_PIT_DET,2009,5,2009-10-11,Sunday,13:00,PIT,28,DET,20,Home,-8,48,54532,200910110det,1458
2009101104,2009_05_DAL_KC,2009,5,2009-10-11,Sunday,13:00,DAL,26,KC,20,Home,-6,46,54533,200910110kan,1459
2009101105,2009_05_OAK_NYG,2009,5,2009-10-11,Sunday,13:00,OAK,7,NYG,44,Home,37,51,54534,200910110nyg,1461
2009101106,2009_05_TB_PHI,2009,5,2009-10-11,Sunday,13:00,TB,14,PHI,33,Home,19,47,54535,200910110phi,1462
2009101107,2009_05_MIN_STL,2009,5,2009-10-11,Sunday,13:00,MIN,38,STL,10,Home,-28,48,54536,200910110ram,1460
2009101108,2009_05_ATL_SF,2009,5,2009-10-11,Sunday,16:05,ATL,45,SF,10,Home,-35,55,54537,200910110sfo,1465
2009101109,2009_05_HOU_ARI,2009,5,2009-10-11,Sunday,16:15,HOU,21,ARI,28,Home,7,49,54538,200910110crd,1467
2009101110,2009_05_NE_DEN,2009,5,2009-10-11,Sunday,16:15,NE,17,DEN,20,Home,3,37,54539,200910110den,1468
2009101111,2009_05_JAX_SEA,2009,5,2009-10-11,Sunday,16:15,JAX,0,SEA,41,Home,41,41,54540,200910110sea,1466
2009101112,2009_05_IND_TEN,2009,5,2009-10-11,Sunday,20:20,IND,31,TEN,9,Home,-22,40,54541,200910110oti,1469
2009101200,2009_05_NYJ_MIA,2009,5,2009-10-12,Monday,20:30,NYJ,27,MIA,31,Home,4,58,54542,200910120mia,1470
2009101800,2009_06_HOU_CIN,2009,6,2009-10-18,Sunday,13:00,HOU,28,CIN,17,Home,-11,45,54543,200910180cin,1471
2009101801,2009_06_DET_GB,2009,6,2009-10-18,Sunday,13:00,DET,0,GB,26,Home,26,26,54544,200910180gnb,1472
2009101802,2009_06_STL_JAX,2009,6,2009-10-18,Sunday,13:00,STL,20,JAX,23,Home,3,43,54545,200910180jax,1477
2009101803,2009_06_BAL_MIN,2009,6,2009-10-18,Sunday,13:00,BAL,31,MIN,33,Home,2,64,54546,200910180min,1473
2009101804,2009_06_NYG_NO,2009,6,2009-10-18,Sunday,13:00,NYG,27,NO,48,Home,21,75,54547,200910180nor,1474
2009101805,2009_06_CLE_PIT,2009,6,2009-10-18,Sunday,13:00,CLE,14,PIT,27,Home,13,41,54548,200910180pit,1478
2009101806,2009_06_CAR_TB,2009,6,2009-10-18,Sunday,13:00,CAR,28,TB,21,Home,-7,49,54549,200910180tam,1475
2009101807,2009_06_KC_WAS,2009,6,2009-10-18,Sunday,13:00,KC,14,WAS,6,Home,-8,20,54550,200910180was,1476
2009101808,2009_06_PHI_OAK,2009,6,2009-10-18,Sunday,16:05,PHI,9,OAK,13,Home,4,22,54551,200910180rai,1480
2009101809,2009_06_ARI_SEA,2009,6,2009-10-18,Sunday,16:05,ARI,27,SEA,3,Home,-24,30,54552,200910180sea,1479
2009101810,2009_06_TEN_NE,2009,6,2009-10-18,Sunday,16:15,TEN,0,NE,59,Home,59,59,54553,200910180nwe,1482
2009101811,2009_06_BUF_NYJ,2009,6,2009-10-18,Sunday,16:15,BUF,16,NYJ,13,Home,-3,29,54554,200910180nyj,1481
2009101812,2009_06_CHI_ATL,2009,6,2009-10-18,Sunday,20:20,CHI,14,ATL,21,Home,7,35,54555,200910180atl,1483
2009101900,2009_06_DEN_SD,2009,6,2009-10-19,Monday,20:30,DEN,34,SD,23,Home,-11,57,54556,200910190sdg,1484
2009102500,2009_07_CHI_CIN,2009,7,2009-10-25,Sunday,16:15,CHI,10,CIN,45,Home,35,55,54557,200910250cin,1485
2009102501,2009_07_GB_CLE,2009,7,2009-10-25,Sunday,13:00,GB,31,CLE,3,Home,-28,34,54558,200910250cle,1486
2009102502,2009_07_SF_HOU,2009,7,2009-10-25,Sunday,13:00,SF,21,HOU,24,Home,3,45,54559,200910250htx,1488
2009102503,2009_07_SD_KC,2009,7,2009-10-25,Sunday,13:00,SD,37,KC,7,Home,-30,44,54560,200910250kan,1487
2009102504,2009_07_MIN_PIT,2009,7,2009-10-25,Sunday,13:00,MIN,17,PIT,27,Home,10,44,54561,200910250pit,1490
2009102505,2009_07_IND_STL,2009,7,2009-10-25,Sunday,13:00,IND,42,STL,6,Home,-36,48,54562,200910250ram,1489
2009102506,2009_07_NE_TB,2009,7,2009-10-25,Sunday,13:00,NE,35,TB,7,Neutral,-28,42,54563,200910250tam,1491
2009102507,2009_07_BUF_CAR,2009,7,2009-10-25,Sunday,16:05,BUF,20,CAR,9,Home,-11,29,54564,200910250car,1492
2009102508,2009_07_NYJ_OAK,2009,7,2009-10-25,Sunday,16:05,NYJ,38,OAK,0,Home,-38,38,54565,200910250rai,1493
2009102509,2009_07_ATL_DAL,2009,7,2009-10-25,Sunday,16:15,ATL,21,DAL,37,Home,16,58,54566,200910250dal,1494
2009102510,2009_07_NO_MIA,2009,7,2009-10-25,Sunday,16:15,NO,46,MIA,34,Home,-12,80,54567,200910250mia,1495
2009102511,2009_07_ARI_NYG,2009,7,2009-10-25,Sunday,20:20,ARI,24,NYG,17,Home,-7,41,54568,200910250nyg,1496
2009102600,2009_07_PHI_WAS,2009,7,2009-10-26,Monday,20:30,PHI,27,WAS,17,Home,-10,44,54569,200910260was,1497
2009110100,2009_08_DEN_BAL,2009,8,2009-11-01,Sunday,13:00,DEN,7,BAL,30,Home,23,37,54570,200911010rav,1505
2009110101,2009_08_HOU_BUF,2009,8,2009-11-01,Sunday,13:00,HOU,31,BUF,10,Home,-21,41,54571,200911010buf,1498
2009110102,2009_08_CLE_CHI,2009,8,2009-11-01,Sunday,13:00,CLE,6,CHI,30,Home,24,36,54572,200911010chi,1499
2009110103,2009_08_SEA_DAL,2009,8,2009-11-01,Sunday,13:00,SEA,17,DAL,38,Home,21,55,54573,200911010dal,1500
2009110104,2009_08_STL_DET,2009,8,2009-11-01,Sunday,13:00,STL,17,DET,10,Home,-7,27,54574,200911010det,1501
2009110105,2009_08_MIN_GB,2009,8,2009-11-01,Sunday,16:15,MIN,38,GB,26,Home,-12,64,54575,200911010gnb,1502
2009110106,2009_08_SF_IND,2009,8,2009-11-01,Sunday,13:00,SF,14,IND,18,Home,4,32,54576,200911010clt,1503
2009110107,2009_08_MIA_NYJ,2009,8,2009-11-01,Sunday,13:00,MIA,30,NYJ,25,Home,-5,55,54577,200911010nyj,1504
2009110108,2009_08_OAK_SD,2009,8,2009-11-01,Sunday,16:05,OAK,16,SD,24,Home,8,40,54578,200911010sdg,1507
2009110109,2009_08_JAX_TEN,2009,8,2009-11-01,Sunday,16:05,JAX,13,TEN,30,Home,17,43,54579,200911010oti,1506
2009110110,2009_08_CAR_ARI,2009,8,2009-11-01,Sunday,16:15,CAR,34,ARI,21,Home,-13,55,54580,200911010crd,1509
2009110111,2009_08_NYG_PHI,2009,8,2009-11-01,Sunday,13:00,NYG,17,PHI,40,Home,23,57,54581,200911010phi,1508
2009110200,2009_08_ATL_NO,2009,8,2009-11-02,Monday,20:30,ATL,27,NO,35,Home,8,62,54582,200911020nor,1510
2009110800,2009_09_WAS_ATL,2009,9,2009-11-08,Sunday,13:00,WAS,17,ATL,31,Home,14,48,54583,200911080atl,1511
2009110801,2009_09_ARI_CHI,2009,9,2009-11-08,Sunday,13:00,ARI,41,CHI,21,Home,-20,62,54584,200911080chi,1512
2009110802,2009_09_BAL_CIN,2009,9,2009-11-08,Sunday,13:00,BAL,7,CIN,17,Home,10,24,54585,200911080cin,1513
2009110803,2009_09_HOU_IND,2009,9,2009-11-08,Sunday,13:00,HOU,17,IND,20,Home,3,37,54586,200911080clt,1514
2009110804,2009_09_KC_JAX,2009,9,2009-11-08,Sunday,13:00,KC,21,JAX,24,Home,3,45,54587,200911080jax,1517
2009110805,2009_09_MIA_NE,2009,9,2009-11-08,Sunday,13:00,MIA,17,NE,27,Home,10,44,54588,200911080nwe,1515
2009110806,2009_09_GB_TB,2009,9,2009-11-08,Sunday,13:00,GB,28,TB,38,Home,10,66,54589,200911080tam,1516
2009110807,2009_09_CAR_NO,2009,9,2009-11-08,Sunday,16:05,CAR,20,NO,30,Home,10,50,54590,200911080nor,1519
2009110808,2009_09_DET_SEA,2009,9,2009-11-08,Sunday,16:05,DET,20,SEA,32,Home,12,52,54591,200911080sea,1518
2009110809,2009_09_SD_NYG,2009,9,2009-11-08,Sunday,16:15,SD,21,NYG,20,Home,-1,41,54592,200911080nyg,1520
2009110810,2009_09_TEN_SF,2009,9,2009-11-08,Sunday,16:15,TEN,34,SF,27,Home,-7,61,54593,200911080sfo,1521
2009110811,2009_09_DAL_PHI,2009,9,2009-11-08,Sunday,20:20,DAL,20,PHI,16,Home,-4,36,54594,200911080phi,1522
2009110900,2009_09_PIT_DEN,2009,9,2009-11-09,Monday,20:30,PIT,28,DEN,10,Home,-18,38,54595,200911090den,1523
2009111200,2009_10_CHI_SF,2009,10,2009-11-12,Thursday,20:20,CHI,6,SF,10,Home,4,16,54596,200911120sfo,1524
2009111500,2009_10_ATL_CAR,2009,10,2009-11-15,Sunday,13:00,ATL,19,CAR,28,Home,9,47,54597,200911150car,1532
2009111501,2009_10_TB_MIA,2009,10,2009-11-15,Sunday,13:00,TB,23,MIA,25,Home,2,48,54598,200911150mia,1528
2009111502,2009_10_DET_MIN,2009,10,2009-11-15,Sunday,13:00,DET,10,MIN,27,Home,17,37,54599,200911150min,1529
2009111503,2009_10_JAX_NYJ,2009,10,2009-11-15,Sunday,13:00,JAX,24,NYJ,22,Home,-2,46,54600,200911150nyj,1530
2009111504,2009_10_CIN_PIT,2009,10,2009-11-15,Sunday,13:00,CIN,18,PIT,12,Home,-6,30,54601,200911150pit,1526
2009111505,2009_10_NO_STL,2009,10,2009-11-15,Sunday,13:00,NO,28,STL,23,Home,-5,51,54602,200911150ram,1527
2009111506,2009_10_BUF_TEN,2009,10,2009-11-15,Sunday,13:00,BUF,17,TEN,41,Home,24,58,54603,200911150oti,1525
2009111507,2009_10_DEN_WAS,2009,10,2009-11-15,Sunday,13:00,DEN,17,WAS,27,Home,10,44,54604,200911150was,1531
2009111508,2009_10_KC_OAK,2009,10,2009-11-15,Sunday,16:05,KC,16,OAK,10,Home,-6,26,54605,200911150rai,1533
2009111509,2009_10_SEA_ARI,2009,10,2009-11-15,Sunday,16:15,SEA,20,ARI,31,Home,11,51,54606,200911150crd,1534
2009111510,2009_10_DAL_GB,2009,10,2009-11-15,Sunday,16:15,DAL,7,GB,17,Home,10,24,54607,200911150gnb,1535
2009111511,2009_10_PHI_SD,2009,10,2009-11-15,Sunday,16:15,PHI,23,SD,31,Home,8,54,54608,200911150sdg,1536
2009111512,2009_10_NE_IND,2009,10,2009-11-15,Sunday,20:20,NE,34,IND,35,Home,1,69,54609,200911150clt,1537
2009111600,2009_10_BAL_CLE,2009,10,2009-11-16,Monday,20:30,BAL,16,CLE,0,Home,-16,16,54610,200911160cle,1538
2009111900,2009_11_MIA_CAR,2009,11,2009-11-19,Thursday,20:20,MIA,24,CAR,17,Home,-7,41,54611,200911190car,1539
2009112200,2009_11_IND_BAL,2009,11,2009-11-22,Sunday,13:00,IND,17,BAL,15,Home,-2,32,54612,200911220rav,1547
2009112201,2009_11_WAS_DAL,2009,11,2009-11-22,Sunday,13:00,WAS,6,DAL,7,Home,1,13,54613,200911220dal,1540
2009112202,2009_11_CLE_DET,2009,11,2009-11-22,Sunday,13:00,CLE,37,DET,38,Home,1,75,54614,200911220det,1541
2009112203,2009_11_SF_GB,2009,11,2009-11-22,Sunday,13:00,SF,24,GB,30,Home,6,54,54615,200911220gnb,1542
2009112204,2009_11_BUF_JAX,2009,11,2009-11-22,Sunday,13:00,BUF,15,JAX,18,Home,3,33,54616,200911220jax,1546
2009112205,2009_11_PIT_KC,2009,11,2009-11-22,Sunday,13:00,PIT,24,KC,27,Home,3,51,54617,200911220kan,1543
2009112206,2009_11_SEA_MIN,2009,11,2009-11-22,Sunday,13:00,SEA,9,MIN,35,Home,26,44,54618,200911220min,1548
2009112207,2009_11_ATL_NYG,2009,11,2009-11-22,Sunday,13:00,ATL,31,NYG,34,Home,3,65,54619,200911220nyg,1544
2009112208,2009_11_NO_TB,2009,11,2009-11-22,Sunday,13:00,NO,38,TB,7,Home,-31,45,54620,200911220tam,1545
2009112209,2009_11_ARI_STL,2009,11,2009-11-22,Sunday,16:05,ARI,21,STL,13,Home,-8,34,54621,200911220ram,1549
2009112210,2009_11_SD_DEN,2009,11,2009-11-22,Sunday,16:15,SD,32,DEN,3,Home,-29,35,54622,200911220den,1552
2009112211,2009_11_NYJ_NE,2009,11,2009-11-22,Sunday,16:15,NYJ,14,NE,31,Home,17,45,54623,200911220nwe,1550
2009112212,2009_11_CIN_OAK,2009,11,2009-11-22,Sunday,16:15,CIN,17,OAK,20,Home,3,37,54624,200911220rai,1551
2009112213,2009_11_PHI_CHI,2009,11,2009-11-22,Sunday,20:20,PHI,24,CHI,20,Home,-4,44,54625,200911220chi,1553
2009112300,2009_11_TEN_HOU,2009,11,2009-11-23,Monday,20:30,TEN,20,HOU,17,Home,-3,37,54626,200911230htx,1554
2009112600,2009_12_GB_DET,2009,12,2009-11-26,Thursday,12:30,GB,34,DET,12,Home,-22,46,54627,200911260det,1555
2009112601,2009_12_OAK_DAL,2009,12,2009-11-26,Thursday,16:15,OAK,7,DAL,24,Home,17,31,54628,200911260dal,1556
2009112602,2009_12_NYG_DEN,2009,12,2009-11-26,Thursday,20:20,NYG,6,DEN,26,Home,20,32,54629,200911260den,1557
2009112900,2009_12_TB_ATL,2009,12,2009-11-29,Sunday,13:00,TB,17,ATL,20,Home,3,37,54630,200911290atl,1558
2009112901,2009_12_MIA_BUF,2009,12,2009-11-29,Sunday,13:00,MIA,14,BUF,31,Home,17,45,54631,200911290buf,1559
2009112902,2009_12_CLE_CIN,2009,12,2009-11-29,Sunday,13:00,CLE,7,CIN,16,Home,9,23,54632,200911290cin,1560
2009112903,2009_12_IND_HOU,2009,12,2009-11-29,Sunday,13:00,IND,35,HOU,27,Home,-8,62,54633,200911290htx,1566
2009112904,2009_12_CHI_MIN,2009,12,2009-11-29,Sunday,16:15,CHI,10,MIN,36,Home,26,46,54634,200911290min,1563
2009112905,2009_12_CAR_NYJ,2009,12,2009-11-29,Sunday,13:00,CAR,6,NYJ,17,Home,11,23,54635,200911290nyj,1564
2009112906,2009_12_WAS_PHI,2009,12,2009-11-29,Sunday,13:00,WAS,24,PHI,27,Home,3,51,54636,200911290phi,1565
2009112907,2009_12_SEA_STL,2009,12,2009-11-29,Sunday,13:00,SEA,27,STL,17,Home,-10,44,54637,200911290ram,1562
2009112908,2009_12_ARI_TEN,2009,12,2009-11-29,Sunday,16:15,ARI,17,TEN,20,Home,3,37,54638,200911290oti,1561
2009112909,2009_12_KC_SD,2009,12,2009-11-29,Sunday,16:05,KC,14,SD,43,Home,29,57,54639,200911290sdg,1567
2009112910,2009_12_JAX_SF,2009,12,2009-11-29,Sunday,16:05,JAX,3,SF,20,Home,17,23,54640,200911290sfo,1568
2009112911,2009_12_PIT_BAL,2009,12,2009-11-29,Sunday,20:20,PIT,17,BAL,20,Home,3,37,54641,200911290rav,1569
2009113000,2009_12_NE_NO,2009,12,2009-11-30,Monday,20:30,NE,17,NO,38,Home,21,55,54642,200911300nor,1570
2009120300,2009_13_NYJ_BUF,2009,13,2009-12-03,Thursday,20:20,NYJ,19,BUF,13,Home,-6,32,54643,200912030buf,1571
2009120600,2009_13_PHI_ATL,2009,13,2009-12-06,Sunday,13:00,PHI,34,ATL,7,Home,-27,41,54644,200912060atl,1572
2009120601,2009_13_TB_CAR,2009,13,2009-12-06,Sunday,13:00,TB,6,CAR,16,Home,10,22,54645,200912060car,1578
2009120602,2009_13_STL_CHI,2009,13,2009-12-06,Sunday,13:00,STL,9,CHI,17,Home,8,26,54646,200912060chi,1573
2009120603,2009_13_DET_CIN,2009,13,2009-12-06,Sunday,13:00,DET,13,CIN,23,Home,10,36,54647,200912060cin,1574
2009120604,2009_13_TEN_IND,2009,13,2009-12-06,Sunday,13:00,TEN,17,IND,27,Home,10,44,54648,200912060clt,1575
2009120605,2009_13_HOU_JAX,2009,13,2009-12-06,Sunday,13:00,HOU,18,JAX,23,Home,5,41,54649,200912060jax,1579
2009120606,2009_13_DEN_KC,2009,13,2009-12-06,Sunday,13:00,DEN,44,KC,13,Home,-31,57,54650,200912060kan,1576
2009120607,2009_13_OAK_PIT,2009,13,2009-12-06,Sunday,13:00,OAK,27,PIT,24,Home,-3,51,54651,200912060pit,1580
2009120608,2009_13_NO_WAS,2009,13,2009-12-06,Sunday,13:00,NO,33,WAS,30,Home,-3,63,54652,200912060was,1577
2009120609,2009_13_SD_CLE,2009,13,2009-12-06,Sunday,16:05,SD,30,CLE,23,Home,-7,53,54653,200912060cle,1581
2009120610,2009_13_MIN_ARI,2009,13,2009-12-06,Sunday,20:20,MIN,17,ARI,30,Home,13,47,54654,200912060crd,1584
2009120611,2009_13_DAL_NYG,2009,13,2009-12-06,Sunday,16:15,DAL,24,NYG,31,Home,7,55,54655,200912060nyg,1583
2009120612,2009_13_SF_SEA,2009,13,2009-12-06,Sunday,16:15,SF,17,SEA,20,Home,3,37,54656,200912060sea,1582
2009120613,2009_13_NE_MIA,2009,13,2009-12-06,Sunday,13:00,NE,21,MIA,22,Home,1,43,54657,200912060mia,1585
2009120700,2009_13_BAL_GB,2009,13,2009-12-07,Monday,20:30,BAL,14,GB,27,Home,13,41,54658,200912070gnb,1586
2009121000,2009_14_PIT_CLE,2009,14,2009-12-10,Thursday,20:20,PIT,6,CLE,13,Home,7,19,54659,200912100cle,1587
2009121300,2009_14_NO_ATL,2009,14,2009-12-13,Sunday,13:00,NO,26,ATL,23,Home,-3,49,54660,200912130atl,1588
2009121301,2009_14_DET_BAL,2009,14,2009-12-13,Sunday,13:00,DET,3,BAL,48,Home,45,51,54661,200912130rav,1595
2009121302,2009_14_GB_CHI,2009,14,2009-12-13,Sunday,13:00,GB,21,CHI,14,Home,-7,35,54662,200912130chi,1589
2009121303,2009_14_SEA_HOU,2009,14,2009-12-13,Sunday,13:00,SEA,7,HOU,34,Home,27,41,54663,200912130htx,1596
2009121304,2009_14_DEN_IND,2009,14,2009-12-13,Sunday,13:00,DEN,16,IND,28,Home,12,44,54664,200912130clt,1591
2009121305,2009_14_MIA_JAX,2009,14,2009-12-13,Sunday,13:00,MIA,14,JAX,10,Home,-4,24,54665,200912130jax,1594
2009121306,2009_14_BUF_KC,2009,14,2009-12-13,Sunday,13:00,BUF,16,KC,10,Home,-6,26,54666,200912130kan,1592
2009121307,2009_14_CIN_MIN,2009,14,2009-12-13,Sunday,13:00,CIN,10,MIN,30,Home,20,40,54667,200912130min,1597
2009121308,2009_14_CAR_NE,2009,14,2009-12-13,Sunday,13:00,CAR,10,NE,20,Home,10,30,54668,200912130nwe,1598
2009121309,2009_14_NYJ_TB,2009,14,2009-12-13,Sunday,13:00,NYJ,26,TB,3,Home,-23,29,54669,200912130tam,1593
2009121310,2009_14_STL_TEN,2009,14,2009-12-13,Sunday,16:05,STL,7,TEN,47,Home,40,54,54670,200912130oti,1590
2009121311,2009_14_WAS_OAK,2009,14,2009-12-13,Sunday,16:05,WAS,34,OAK,13,Home,-21,47,54671,200912130rai,1599
2009121312,2009_14_SD_DAL,2009,14,2009-12-13,Sunday,16:15,SD,20,DAL,17,Home,-3,37,54672,200912130dal,1600
2009121313,2009_14_PHI_NYG,2009,14,2009-12-13,Sunday,20:20,PHI,45,NYG,38,Home,-7,83,54673,200912130nyg,1601
2009121400,2009_14_ARI_SF,2009,14,2009-12-14,Monday,20:30,ARI,9,SF,24,Home,15,33,54674,200912140sfo,1602
2009121700,2009_15_IND_JAX,2009,15,2009-12-17,Thursday,20:20,IND,35,JAX,31,Home,-4,66,54675,200912170jax,1603
2009121900,2009_15_DAL_NO,2009,15,2009-12-19,Saturday,20:20,DAL,24,NO,17,Home,-7,41,54676,200912190nor,1604
2009122000,2009_15_CHI_BAL,2009,15,2009-12-20,Sunday,16:15,CHI,7,BAL,31,Home,24,38,54677,200912200rav,1613
2009122001,2009_15_NE_BUF,2009,15,2009-12-20,Sunday,13:00,NE,17,BUF,10,Home,-7,27,54678,200912200buf,1605
2009122002,2009_15_ARI_DET,2009,15,2009-12-20,Sunday,13:00,ARI,31,DET,24,Home,-7,55,54679,200912200det,1606
2009122003,2009_15_CLE_KC,2009,15,2009-12-20,Sunday,13:00,CLE,41,KC,34,Home,-7,75,54680,200912200kan,1608
2009122004,2009_15_ATL_NYJ,2009,15,2009-12-20,Sunday,13:00,ATL,10,NYJ,7,Home,-3,17,54681,200912200nyj,1610
2009122005,2009_15_SF_PHI,2009,15,2009-12-20,Sunday,16:15,SF,13,PHI,27,Home,14,40,54682,200912200phi,1611
2009122006,2009_15_GB_PIT,2009,15,2009-12-20,Sunday,16:15,GB,36,PIT,37,Home,1,73,54683,200912200pit,1612
2009122007,2009_15_HOU_STL,2009,15,2009-12-20,Sunday,13:00,HOU,16,STL,13,Home,-3,29,54684,200912200ram,1609
2009122008,2009_15_MIA_TEN,2009,15,2009-12-20,Sunday,13:00,MIA,24,TEN,27,Home,3,51,54685,200912200oti,1607
2009122009,2009_15_OAK_DEN,2009,15,2009-12-20,Sunday,16:05,OAK,20,DEN,19,Home,-1,39,54686,200912200den,1615
2009122010,2009_15_CIN_SD,2009,15,2009-12-20,Sunday,16:05,CIN,24,SD,27,Home,3,51,54687,200912200sdg,1614
2009122011,2009_15_TB_SEA,2009,15,2009-12-20,Sunday,16:15,TB,24,SEA,7,Home,-17,31,54688,200912200sea,1616
2009122012,2009_15_MIN_CAR,2009,15,2009-12-20,Sunday,20:20,MIN,7,CAR,26,Home,19,33,54689,200912200car,1617
2009122100,2009_15_NYG_WAS,2009,15,2009-12-21,Monday,20:30,NYG,45,WAS,12,Home,-33,57,54690,200912210was,1618
2009122500,2009_16_SD_TEN,2009,16,2009-12-25,Friday,19:30,SD,42,TEN,17,Home,-25,59,54691,200912250oti,1619
2009122700,2009_16_BUF_ATL,2009,16,2009-12-27,Sunday,13:00,BUF,3,ATL,31,Home,28,34,54692,200912270atl,1620
2009122701,2009_16_KC_CIN,2009,16,2009-12-27,Sunday,13:00,KC,10,CIN,17,Home,7,27,54693,200912270cin,1621
2009122702,2009_16_OAK_CLE,2009,16,2009-12-27,Sunday,13:00,OAK,9,CLE,23,Home,14,32,54694,200912270cle,1622
2009122703,2009_16_SEA_GB,2009,16,2009-12-27,Sunday,13:00,SEA,10,GB,48,Home,38,58,54695,200912270gnb,1623
2009122704,2009_16_HOU_MIA,2009,16,2009-12-27,Sunday,13:00,HOU,27,MIA,20,Home,-7,47,54696,200912270mia,1625
2009122705,2009_16_CAR_NYG,2009,16,2009-12-27,Sunday,13:00,CAR,41,NYG,9,Home,-32,50,54697,200912270nyg,1628
2009122706,2009_16_JAX_NE,2009,16,2009-12-27,Sunday,13:00,JAX,7,NE,35,Home,28,42,54698,200912270nwe,1626
2009122707,2009_16_TB_NO,2009,16,2009-12-27,Sunday,13:00,TB,20,NO,17,Home,-3,37,54699,200912270nor,1627
2009122708,2009_16_DEN_PHI,2009,16,2009-12-27,Sunday,16:15,DEN,27,PHI,30,Home,3,57,54700,200912270phi,1629
2009122709,2009_16_BAL_PIT,2009,16,2009-12-27,Sunday,13:00,BAL,20,PIT,23,Home,3,43,54701,200912270pit,1624
2009122710,2009_16_STL_ARI,2009,16,2009-12-27,Sunday,16:05,STL,10,ARI,31,Home,21,41,54702,200912270crd,1630
2009122711,2009_16_DET_SF,2009,16,2009-12-27,Sunday,16:05,DET,6,SF,20,Home,14,26,54703,200912270sfo,1631
2009122712,2009_16_NYJ_IND,2009,16,2009-12-27,Sunday,16:15,NYJ,29,IND,15,Home,-14,44,54704,200912270clt,1632
2009122713,2009_16_DAL_WAS,2009,16,2009-12-27,Sunday,20:20,DAL,17,WAS,0,Home,-17,17,54705,200912270was,1633
2009122800,2009_16_MIN_CHI,2009,16,2009-12-28,Monday,20:30,MIN,30,CHI,36,Home,6,66,54706,200912280chi,1634
2010010300,2009_17_IND_BUF,2009,17,2010-01-03,Sunday,13:00,IND,9,BUF,30,Home,21,39,54707,201001030buf,1635
2010010301,2009_17_NO_CAR,2009,17,2010-01-03,Sunday,13:00,NO,10,CAR,23,Home,13,33,54708,201001030car,1640
2010010302,2009_17_JAX_CLE,2009,17,2010-01-03,Sunday,13:00,JAX,17,CLE,23,Home,6,40,54709,201001030cle,1636
2010010303,2009_17_PHI_DAL,2009,17,2010-01-03,Sunday,16:15,PHI,0,DAL,24,Home,24,24,54710,201001030dal,1637
2010010304,2009_17_CHI_DET,2009,17,2010-01-03,Sunday,13:00,CHI,37,DET,23,Home,-14,60,54711,201001030det,1638
2010010305,2009_17_NE_HOU,2009,17,2010-01-03,Sunday,13:00,NE,27,HOU,34,Home,7,61,54712,201001030htx,1641
2010010306,2009_17_PIT_MIA,2009,17,2010-01-03,Sunday,13:00,PIT,30,MIA,24,Home,-6,54,54713,201001030mia,1643
2010010307,2009_17_NYG_MIN,2009,17,2010-01-03,Sunday,13:00,NYG,7,MIN,44,Home,37,51,54714,201001030min,1644
2010010308,2009_17_CIN_NYJ,2009,17,2010-01-03,Sunday,20:20,CIN,0,NYJ,37,Home,37,37,54715,201001030nyj,1645
2010010309,2009_17_SF_STL,2009,17,2010-01-03,Sunday,13:00,SF,28,STL,6,Home,-22,34,54716,201001030ram,1642
2010010310,2009_17_ATL_TB,2009,17,2010-01-03,Sunday,13:00,ATL,20,TB,10,Home,-10,30,54717,201001030tam,1639
2010010311,2009_17_GB_ARI,2009,17,2010-01-03,Sunday,16:15,GB,33,ARI,7,Home,-26,40,54718,201001030crd,1646
2010010312,2009_17_KC_DEN,2009,17,2010-01-03,Sunday,16:15,KC,44,DEN,24,Home,-20,68,54719,201001030den,1650
2010010313,2009_17_BAL_OAK,2009,17,2010-01-03,Sunday,16:15,BAL,21,OAK,13,Home,-8,34,54720,201001030rai,1649
2010010314,2009_17_WAS_SD,2009,17,2010-01-03,Sunday,16:15,WAS,20,SD,23,Home,3,43,54721,201001030sdg,1647
2010010315,2009_17_TEN_SEA,2009,17,2010-01-03,Sunday,16:15,TEN,17,SEA,13,Home,-4,30,54722,201001030sea,1648
2010010900,2009_18_PHI_DAL,2009,18,2010-01-09,Saturday,20:00,PHI,14,DAL,34,Home,20,48,54804,201001090dal,1652
2010010901,2009_18_NYJ_CIN,2009,18,2010-01-09,Saturday,16:30,NYJ,24,CIN,14,Home,-10,38,54803,201001090cin,1651
2010011000,2009_18_GB_ARI,2009,18,2010-01-10,Sunday,16:30,GB,45,ARI,51,Home,6,96,54806,201001100crd,1654
2010011001,2009_18_BAL_NE,2009,18,2010-01-10,Sunday,13:00,BAL,33,NE,14,Home,-19,47,54805,201001100nwe,1653
2010011600,2009_19_BAL_IND,2009,19,2010-01-16,Saturday,20:15,BAL,3,IND,20,Home,17,23,54808,201001160clt,1656
2010011601,2009_19_ARI_NO,2009,19,2010-01-16,Saturday,16:30,ARI,14,NO,45,Home,31,59,54807,201001160nor,1655
2010011700,2009_19_DAL_MIN,2009,19,2010-01-17,Sunday,13:00,DAL,3,MIN,34,Home,31,37,54810,201001170min,1657
2010011701,2009_19_NYJ_SD,2009,19,2010-01-17,Sunday,16:40,NYJ,17,SD,14,Home,-3,31,54811,201001170sdg,1658
2010012400,2009_20_NYJ_IND,2009,20,2010-01-24,Sunday,15:05,NYJ,17,IND,30,Home,13,47,54812,201001240clt,1659
2010012401,2009_20_MIN_NO,2009,20,2010-01-24,Sunday,18:40,MIN,28,NO,31,Home,3,59,54813,201001240nor,1660
2010020700,2009_21_NO_IND,2009,21,2010-02-07,Sunday,18:32,NO,31,IND,17,Neutral,-14,48,54814,201002070clt,1661
2010090900,2010_01_MIN_NO,2010,1,2010-09-09,Thursday,20:30,MIN,9,NO,14,Home,5,23,54863,201009090nor,1727
2010091200,2010_01_CLE_TB,2010,1,2010-09-12,Sunday,13:00,CLE,14,TB,17,Home,3,31,54871,201009120tam,1728
2010091201,2010_01_MIA_BUF,2010,1,2010-09-12,Sunday,13:00,MIA,15,BUF,10,Home,-5,25,54864,201009120buf,1729
2010091202,2010_01_CIN_NE,2010,1,2010-09-12,Sunday,13:00,CIN,24,NE,38,Home,14,62,54868,201009120nwe,1730
2010091203,2010_01_IND_HOU,2010,1,2010-09-12,Sunday,13:00,IND,24,HOU,34,Home,10,58,54866,201009120htx,1731
2010091204,2010_01_DEN_JAX,2010,1,2010-09-12,Sunday,13:00,DEN,17,JAX,24,Home,7,41,54867,201009120jax,1732
2010091205,2010_01_OAK_TEN,2010,1,2010-09-12,Sunday,13:00,OAK,13,TEN,38,Home,25,51,54872,201009120oti,1734
2010091206,2010_01_CAR_NYG,2010,1,2010-09-12,Sunday,13:00,CAR,18,NYG,31,Home,13,49,54869,201009120nyg,1735
2010091207,2010_01_DET_CHI,2010,1,2010-09-12,Sunday,13:00,DET,14,CHI,19,Home,5,33,54865,201009120chi,1736
2010091208,2010_01_ARI_STL,2010,1,2010-09-12,Sunday,16:15,ARI,17,STL,13,Home,-4,30,54874,201009120ram,1737
2010091209,2010_01_ATL_PIT,2010,1,2010-09-12,Sunday,13:00,ATL,9,PIT,15,Home,6,24,54870,201009120pit,1733
2010091210,2010_01_GB_PHI,2010,1,2010-09-12,Sunday,16:15,GB,27,PHI,20,Home,-7,47,54873,201009120phi,1738
2010091211,2010_01_SF_SEA,2010,1,2010-09-12,Sunday,16:15,SF,6,SEA,31,Home,25,37,54875,201009120sea,1739
2010091212,2010_01_DAL_WAS,2010,1,2010-09-12,Sunday,20:20,DAL,7,WAS,13,Home,6,20,54876,201009120was,1740
2010091300,2010_01_BAL_NYJ,2010,1,2010-09-13,Monday,19:00,BAL,10,NYJ,9,Home,-1,19,54877,201009130nyj,1741
2010091301,2010_01_SD_KC,2010,1,2010-09-13,Monday,22:15,SD,14,KC,21,Home,7,35,54878,201009130kan,1742
2010091900,2010_02_HOU_WAS,2010,2,2010-09-19,Sunday,16:15,HOU,30,WAS,27,Home,-3,57,54892,201009190was,1754
2010091901,2010_02_BUF_GB,2010,2,2010-09-19,Sunday,13:00,BUF,7,GB,34,Home,27,41,54885,201009190gnb,1743
2010091902,2010_02_MIA_MIN,2010,2,2010-09-19,Sunday,13:00,MIA,14,MIN,10,Home,-4,24,54886,201009190min,1751
2010091903,2010_02_KC_CLE,2010,2,2010-09-19,Sunday,13:00,KC,16,CLE,14,Home,-2,30,54882,201009190cle,1750
2010091904,2010_02_PIT_TEN,2010,2,2010-09-19,Sunday,13:00,PIT,19,TEN,11,Home,-8,30,54887,201009190oti,1745
2010091905,2010_02_CHI_DAL,2010,2,2010-09-19,Sunday,13:00,CHI,27,DAL,20,Home,-7,47,54883,201009190dal,1746
2010091906,2010_02_PHI_DET,2010,2,2010-09-19,Sunday,13:00,PHI,35,DET,32,Home,-3,67,54884,201009190det,1747
2010091907,2010_02_ARI_ATL,2010,2,2010-09-19,Sunday,13:00,ARI,7,ATL,41,Home,34,48,54879,201009190atl,1749
2010091908,2010_02_TB_CAR,2010,2,2010-09-19,Sunday,13:00,TB,20,CAR,7,Home,-13,27,54880,201009190car,1748
2010091909,2010_02_SEA_DEN,2010,2,2010-09-19,Sunday,16:05,SEA,14,DEN,31,Home,17,45,54888,201009190den,1752
2010091910,2010_02_STL_OAK,2010,2,2010-09-19,Sunday,16:05,STL,14,OAK,16,Home,2,30,54889,201009190rai,1753
2010091911,2010_02_NE_NYJ,2010,2,2010-09-19,Sunday,16:15,NE,14,NYJ,28,Home,14,42,54890,201009190nyj,1756
2010091912,2010_02_BAL_CIN,2010,2,2010-09-19,Sunday,13:00,BAL,10,CIN,15,Home,5,25,54881,201009190cin,1744
2010091913,2010_02_JAX_SD,2010,2,2010-09-19,Sunday,16:15,JAX,13,SD,38,Home,25,51,54891,201009190sdg,1755
2010091914,2010_02_NYG_IND,2010,2,2010-09-19,Sunday,20:20,NYG,14,IND,38,Home,24,52,54893,201009190clt,1757
2010092000,2010_02_NO_SF,2010,2,2010-09-20,Monday,20:30,NO,25,SF,22,Home,-3,47,54894,201009200sfo,1758
2010092600,2010_03_TEN_NYG,2010,3,2010-09-26,Sunday,13:00,TEN,29,NYG,10,Home,-19,39,54902,201009260nyg,1759
2010092601,2010_03_CIN_CAR,2010,3,2010-09-26,Sunday,13:00,CIN,20,CAR,7,Home,-13,27,54896,201009260car,1760
2010092602,2010_03_PIT_TB,2010,3,2010-09-26,Sunday,13:00,PIT,38,TB,13,Home,-25,51,54903,201009260tam,1763
2010092603,2010_03_BUF_NE,2010,3,2010-09-26,Sunday,13:00,BUF,30,NE,38,Home,8,68,54900,201009260nwe,1764
2010092604,2010_03_CLE_BAL,2010,3,2010-09-26,Sunday,13:00,CLE,17,BAL,24,Home,7,41,54895,201009260rav,1765
2010092605,2010_03_DET_MIN,2010,3,2010-09-26,Sunday,13:00,DET,10,MIN,24,Home,14,34,54899,201009260min,1766
2010092606,2010_03_ATL_NO,2010,3,2010-09-26,Sunday,13:00,ATL,27,NO,24,Home,-3,51,54901,201009260nor,1767
2010092607,2010_03_WAS_STL,2010,3,2010-09-26,Sunday,16:05,WAS,16,STL,30,Home,14,46,54905,201009260ram,1768
2010092608,2010_03_DAL_HOU,2010,3,2010-09-26,Sunday,13:00,DAL,27,HOU,13,Home,-14,40,54897,201009260htx,1761
2010092609,2010_03_SF_KC,2010,3,2010-09-26,Sunday,13:00,SF,10,KC,31,Home,21,41,54898,201009260kan,1762
2010092610,2010_03_PHI_JAX,2010,3,2010-09-26,Sunday,16:05,PHI,28,JAX,3,Home,-25,31,54904,201009260jax,1769
2010092611,2010_03_IND_DEN,2010,3,2010-09-26,Sunday,16:15,IND,27,DEN,13,Home,-14,40,54907,201009260den,1770
2010092612,2010_03_OAK_ARI,2010,3,2010-09-26,Sunday,16:15,OAK,23,ARI,24,Home,1,47,54906,201009260crd,1771
2010092613,2010_03_SD_SEA,2010,3,2010-09-26,Sunday,16:15,SD,20,SEA,27,Home,7,47,54908,201009260sea,1772
2010092614,2010_03_NYJ_MIA,2010,3,2010-09-26,Sunday,20:20,NYJ,31,MIA,23,Home,-8,54,54909,201009260mia,1773
2010092700,2010_03_GB_CHI,2010,3,2010-09-27,Monday,20:30,GB,17,CHI,20,Home,3,37,54910,201009270chi,1774
2010100300,2010_04_NYJ_BUF,2010,4,2010-10-03,Sunday,13:00,NYJ,38,BUF,14,Home,-24,52,54912,201010030buf,1775
2010100301,2010_04_CIN_CLE,2010,4,2010-10-03,Sunday,13:00,CIN,20,CLE,23,Home,3,43,54913,201010030cle,1776
2010100302,2010_04_BAL_PIT,2010,4,2010-10-03,Sunday,13:00,BAL,17,PIT,14,Home,-3,31,54916,201010030pit,1777
2010100303,2010_04_DEN_TEN,2010,4,2010-10-03,Sunday,13:00,DEN,26,TEN,20,Home,-6,46,54918,201010030oti,1778
2010100304,2010_04_DET_GB,2010,4,2010-10-03,Sunday,13:00,DET,26,GB,28,Home,2,54,54914,201010030gnb,1779
2010100305,2010_04_SF_ATL,2010,4,2010-10-03,Sunday,13:00,SF,14,ATL,16,Home,2,30,54911,201010030atl,1780
2010100306,2010_04_CAR_NO,2010,4,2010-10-03,Sunday,13:00,CAR,14,NO,16,Home,2,30,54915,201010030nor,1781
2010100307,2010_04_SEA_STL,2010,4,2010-10-03,Sunday,13:00,SEA,3,STL,20,Home,17,23,54917,201010030ram,1782
2010100308,2010_04_IND_JAX,2010,4,2010-10-03,Sunday,16:05,IND,28,JAX,31,Home,3,59,54919,201010030jax,1783
2010100309,2010_04_HOU_OAK,2010,4,2010-10-03,Sunday,16:05,HOU,31,OAK,24,Home,-7,55,54920,201010030rai,1784
2010100310,2010_04_WAS_PHI,2010,4,2010-10-03,Sunday,16:15,WAS,17,PHI,12,Home,-5,29,54921,201010030phi,1785
2010100311,2010_04_ARI_SD,2010,4,2010-10-03,Sunday,16:15,ARI,10,SD,41,Home,31,51,54922,201010030sdg,1786
2010100312,2010_04_CHI_NYG,2010,4,2010-10-03,Sunday,20:20,CHI,3,NYG,17,Home,14,20,54923,201010030nyg,1787
2010100400,2010_04_NE_MIA,2010,4,2010-10-04,Monday,20:30,NE,41,MIA,14,Home,-27,55,54924,201010040mia,1788
2010101000,2010_05_JAX_BUF,2010,5,2010-10-10,Sunday,13:00,JAX,36,BUF,26,Home,-10,62,54926,201010100buf,1789
2010101001,2010_05_DEN_BAL,2010,5,2010-10-10,Sunday,13:00,DEN,17,BAL,31,Home,14,48,54925,201010100rav,1790
2010101002,2010_05_KC_IND,2010,5,2010-10-10,Sunday,13:00,KC,9,IND,19,Home,10,28,54931,201010100clt,1791
2010101003,2010_05_GB_WAS,2010,5,2010-10-10,Sunday,13:00,GB,13,WAS,16,Home,3,29,54933,201010100was,1792
2010101004,2010_05_STL_DET,2010,5,2010-10-10,Sunday,13:00,STL,6,DET,44,Home,38,50,54930,201010100det,1793
2010101005,2010_05_CHI_CAR,2010,5,2010-10-10,Sunday,13:00,CHI,23,CAR,6,Home,-17,29,54927,201010100car,1794
2010101006,2010_05_TB_CIN,2010,5,2010-10-10,Sunday,13:00,TB,24,CIN,21,Home,-3,45,54928,201010100cin,1795
2010101007,2010_05_ATL_CLE,2010,5,2010-10-10,Sunday,13:00,ATL,20,CLE,10,Home,-10,30,54929,201010100cle,1796
2010101008,2010_05_NYG_HOU,2010,5,2010-10-10,Sunday,13:00,NYG,34,HOU,10,Home,-24,44,54932,201010100htx,1797
2010101009,2010_05_NO_ARI,2010,5,2010-10-10,Sunday,16:05,NO,20,ARI,30,Home,10,50,54934,201010100crd,1798
2010101010,2010_05_TEN_DAL,2010,5,2010-10-10,Sunday,16:15,TEN,34,DAL,27,Home,-7,61,54935,201010100dal,1799
2010101011,2010_05_SD_OAK,2010,5,2010-10-10,Sunday,16:15,SD,27,OAK,35,Home,8,62,54936,201010100rai,1800
2010101012,2010_05_PHI_SF,2010,5,2010-10-10,Sunday,20:20,PHI,27,SF,24,Home,-3,51,54937,201010100sfo,1801
2010101100,2010_05_MIN_NYJ,2010,5,2010-10-11,Monday,21:15,MIN,20,NYJ,29,Home,9,49,54938,201010110nyj,1802
2010101700,2010_06_MIA_GB,2010,6,2010-10-17,Sunday,13:00,MIA,23,GB,20,Home,-3,43,54940,201010170gnb,1803
2010101701,2010_06_SD_STL,2010,6,2010-10-17,Sunday,13:00,SD,17,STL,20,Home,3,37,54946,201010170ram,1804
2010101702,2010_06_BAL_NE,2010,6,2010-10-17,Sunday,13:00,BAL,20,NE,23,Home,3,43,54942,201010170nwe,1805
2010101703,2010_06_CLE_PIT,2010,6,2010-10-17,Sunday,13:00,CLE,10,PIT,28,Home,18,38,54945,201010170pit,1806
2010101704,2010_06_KC_HOU,2010,6,2010-10-17,Sunday,13:00,KC,31,HOU,35,Home,4,66,54941,201010170htx,1807
2010101705,2010_06_DET_NYG,2010,6,2010-10-17,Sunday,13:00,DET,20,NYG,28,Home,8,48,54943,201010170nyg,1808
2010101706,2010_06_ATL_PHI,2010,6,2010-10-17,Sunday,13:00,ATL,17,PHI,31,Home,14,48,54944,201010170phi,1809
2010101707,2010_06_SEA_CHI,2010,6,2010-10-17,Sunday,13:00,SEA,23,CHI,20,Home,-3,43,54939,201010170chi,1810
2010101708,2010_06_NO_TB,2010,6,2010-10-17,Sunday,13:00,NO,31,TB,6,Home,-25,37,54947,201010170tam,1811
2010101709,2010_06_NYJ_DEN,2010,6,2010-10-17,Sunday,16:05,NYJ,24,DEN,20,Home,-4,44,54948,201010170den,1812
2010101710,2010_06_OAK_SF,2010,6,2010-10-17,Sunday,16:05,OAK,9,SF,17,Home,8,26,54949,201010170sfo,1813
2010101711,2010_06_DAL_MIN,2010,6,2010-10-17,Sunday,16:15,DAL,21,MIN,24,Home,3,45,54950,201010170min,1814
2010101712,2010_06_IND_WAS,2010,6,2010-10-17,Sunday,20:20,IND,27,WAS,24,Home,-3,51,54951,201010170was,1815
2010101800,2010_06_TEN_JAX,2010,6,2010-10-18,Monday,20:30,TEN,30,JAX,3,Home,-27,33,54952,201010180jax,1816
2010102400,2010_07_CIN_ATL,2010,7,2010-10-24,Sunday,13:00,CIN,32,ATL,39,Home,7,71,54953,201010240atl,1817
2010102401,2010_07_PIT_MIA,2010,7,2010-10-24,Sunday,13:00,PIT,23,MIA,22,Home,-1,45,54818,201010240mia,1818
2010102402,2010_07_BUF_BAL,2010,7,2010-10-24,Sunday,13:00,BUF,34,BAL,37,Home,3,71,54954,201010240rav,1819
2010102403,2010_07_JAX_KC,2010,7,2010-10-24,Sunday,13:00,JAX,20,KC,42,Home,22,62,54817,201010240kan,1820
2010102404,2010_07_CLE_NO,2010,7,2010-10-24,Sunday,13:00,CLE,30,NO,17,Home,-13,47,54819,201010240nor,1821
2010102405,2010_07_WAS_CHI,2010,7,2010-10-24,Sunday,13:00,WAS,17,CHI,14,Home,-3,31,54816,201010240chi,1822
2010102406,2010_07_SF_CAR,2010,7,2010-10-24,Sunday,13:00,SF,20,CAR,23,Home,3,43,54955,201010240car,1823
2010102407,2010_07_STL_TB,2010,7,2010-10-24,Sunday,13:00,STL,17,TB,18,Home,1,35,54820,201010240tam,1824
2010102408,2010_07_PHI_TEN,2010,7,2010-10-24,Sunday,13:00,PHI,19,TEN,37,Home,18,56,54821,201010240oti,1825
2010102409,2010_07_ARI_SEA,2010,7,2010-10-24,Sunday,16:05,ARI,10,SEA,22,Home,12,32,54822,201010240sea,1826
2010102410,2010_07_NE_SD,2010,7,2010-10-24,Sunday,16:15,NE,23,SD,20,Home,-3,43,54823,201010240sdg,1827
2010102411,2010_07_OAK_DEN,2010,7,2010-10-24,Sunday,16:15,OAK,59,DEN,14,Home,-45,73,54824,201010240den,1828
2010102412,2010_07_MIN_GB,2010,7,2010-10-24,Sunday,20:20,MIN,24,GB,28,Home,4,52,54825,201010240gnb,1829
2010102500,2010_07_NYG_DAL,2010,7,2010-10-25,Monday,20:30,NYG,41,DAL,35,Home,-6,76,54826,201010250dal,1830
2010103100,2010_08_DEN_SF,2010,8,2010-10-31,Sunday,13:00,DEN,16,SF,24,Neutral,8,40,54833,201010310sfo,1831
2010103101,2010_08_JAX_DAL,2010,8,2010-10-31,Sunday,13:00,JAX,35,DAL,17,Home,-18,52,54828,201010310dal,1832
2010103102,2010_08_MIA_CIN,2010,8,2010-10-31,Sunday,13:00,MIA,22,CIN,14,Home,-8,36,54827,201010310cin,1833
2010103103,2010_08_BUF_KC,2010,8,2010-10-31,Sunday,13:00,BUF,10,KC,13,Home,3,23,54830,201010310kan,1834
2010103104,2010_08_WAS_DET,2010,8,2010-10-31,Sunday,13:00,WAS,25,DET,37,Home,12,62,54829,201010310det,1835
2010103105,2010_08_CAR_STL,2010,8,2010-10-31,Sunday,13:00,CAR,10,STL,20,Home,10,30,54832,201010310ram,1836
2010103106,2010_08_GB_NYJ,2010,8,2010-10-31,Sunday,13:00,GB,9,NYJ,0,Home,-9,9,54831,201010310nyj,1837
2010103107,2010_08_TEN_SD,2010,8,2010-10-31,Sunday,16:05,TEN,25,SD,33,Home,8,58,54834,201010310sdg,1838
2010103108,2010_08_MIN_NE,2010,8,2010-10-31,Sunday,16:15,MIN,18,NE,28,Home,10,46,54835,201010310nwe,1839
2010103109,2010_08_TB_ARI,2010,8,2010-10-31,Sunday,16:15,TB,38,ARI,35,Home,-3,73,54837,201010310crd,1840
2010103110,2010_08_SEA_OAK,2010,8,2010-10-31,Sunday,16:15,SEA,3,OAK,33,Home,30,36,54836,201010310rai,1841
2010103111,2010_08_PIT_NO,2010,8,2010-10-31,Sunday,20:20,PIT,10,NO,20,Home,10,30,54838,201010310nor,1842
2010110100,2010_08_HOU_IND,2010,8,2010-11-01,Monday,20:30,HOU,17,IND,30,Home,13,47,54839,201011010clt,1843
2010110700,2010_09_NYJ_DET,2010,9,2010-11-07,Sunday,13:00,NYJ,23,DET,20,Home,-3,43,54845,201011070det,1844
2010110701,2010_09_MIA_BAL,2010,9,2010-11-07,Sunday,13:00,MIA,10,BAL,26,Home,16,36,54841,201011070rav,1845
2010110702,2010_09_NE_CLE,2010,9,2010-11-07,Sunday,13:00,NE,14,CLE,34,Home,20,48,54844,201011070cle,1846
2010110703,2010_09_SD_HOU,2010,9,2010-11-07,Sunday,13:00,SD,29,HOU,23,Home,-6,52,54846,201011070htx,1847
2010110704,2010_09_CHI_BUF,2010,9,2010-11-07,Sunday,13:00,CHI,22,BUF,19,Home,-3,41,54842,201011070buf,1848
2010110705,2010_09_ARI_MIN,2010,9,2010-11-07,Sunday,13:00,ARI,24,MIN,27,Home,3,51,54847,201011070min,1849
2010110706,2010_09_TB_ATL,2010,9,2010-11-07,Sunday,13:00,TB,21,ATL,27,Home,6,48,54840,201011070atl,1850
2010110707,2010_09_NO_CAR,2010,9,2010-11-07,Sunday,13:00,NO,34,CAR,3,Home,-31,37,54843,201011070car,1851
2010110708,2010_09_NYG_SEA,2010,9,2010-11-07,Sunday,16:05,NYG,41,SEA,7,Home,-34,48,54848,201011070sea,1852
2010110709,2010_09_IND_PHI,2010,9,2010-11-07,Sunday,16:15,IND,24,PHI,26,Home,2,50,54849,201011070phi,1853
2010110710,2010_09_KC_OAK,2010,9,2010-11-07,Sunday,16:15,KC,20,OAK,23,Home,3,43,54850,201011070rai,1854
2010110711,2010_09_DAL_GB,2010,9,2010-11-07,Sunday,20:20,DAL,7,GB,45,Home,38,52,54851,201011070gnb,1855
2010110800,2010_09_PIT_CIN,2010,9,2010-11-08,Monday,20:30,PIT,27,CIN,21,Home,-6,48,54852,201011080cin,1856
2010111100,2010_10_BAL_ATL,2010,10,2010-11-11,Thursday,20:20,BAL,21,ATL,26,Home,5,47,54853,201011110atl,1857
2010111400,2010_10_TEN_MIA,2010,10,2010-11-14,Sunday,13:00,TEN,17,MIA,29,Home,12,46,54859,201011140mia,1858
2010111401,2010_10_NYJ_CLE,2010,10,2010-11-14,Sunday,13:00,NYJ,26,CLE,20,Home,-6,46,54856,201011140cle,1859
2010111402,2010_10_CIN_IND,2010,10,2010-11-14,Sunday,13:00,CIN,17,IND,23,Home,6,40,54857,201011140clt,1860
2010111403,2010_10_HOU_JAX,2010,10,2010-11-14,Sunday,13:00,HOU,24,JAX,31,Home,7,55,54858,201011140jax,1861
2010111404,2010_10_MIN_CHI,2010,10,2010-11-14,Sunday,13:00,MIN,13,CHI,27,Home,14,40,54855,201011140chi,1862
2010111405,2010_10_CAR_TB,2010,10,2010-11-14,Sunday,13:00,CAR,16,TB,31,Home,15,47,54860,201011140tam,1863
2010111406,2010_10_DET_BUF,2010,10,2010-11-14,Sunday,13:00,DET,12,BUF,14,Home,2,26,54854,201011140buf,1864
2010111407,2010_10_KC_DEN,2010,10,2010-11-14,Sunday,16:05,KC,29,DEN,49,Home,20,78,54861,201011140den,1865
2010111408,2010_10_DAL_NYG,2010,10,2010-11-14,Sunday,16:15,DAL,33,NYG,20,Home,-13,53,54862,201011140nyg,1866
2010111409,2010_10_SEA_ARI,2010,10,2010-11-14,Sunday,16:15,SEA,36,ARI,18,Home,-18,54,54956,201011140crd,1867
2010111410,2010_10_STL_SF,2010,10,2010-11-14,Sunday,16:15,STL,20,SF,23,Home,3,43,54957,201011140sfo,1868
2010111411,2010_10_NE_PIT,2010,10,2010-11-14,Sunday,20:20,NE,39,PIT,26,Home,-13,65,54958,201011140pit,1869
2010111500,2010_10_PHI_WAS,2010,10,2010-11-15,Monday,20:30,PHI,59,WAS,28,Home,-31,87,54959,201011150was,1870
2010111800,2010_11_CHI_MIA,2010,11,2010-11-18,Thursday,20:20,CHI,16,MIA,0,Home,-16,16,54960,201011180mia,1871
2010112100,2010_11_BAL_CAR,2010,11,2010-11-21,Sunday,13:00,BAL,37,CAR,13,Home,-24,50,54961,201011210car,1872
2010112101,2010_11_HOU_NYJ,2010,11,2010-11-21,Sunday,13:00,HOU,27,NYJ,30,Home,3,57,54967,201011210nyj,1873
2010112102,2010_11_BUF_CIN,2010,11,2010-11-21,Sunday,13:00,BUF,49,CIN,31,Home,-18,80,54962,201011210cin,1876
2010112103,2010_11_OAK_PIT,2010,11,2010-11-21,Sunday,13:00,OAK,3,PIT,35,Home,32,38,54968,201011210pit,1877
2010112104,2010_11_CLE_JAX,2010,11,2010-11-21,Sunday,13:00,CLE,20,JAX,24,Home,4,44,54964,201011210jax,1878
2010112105,2010_11_DET_DAL,2010,11,2010-11-21,Sunday,13:00,DET,19,DAL,35,Home,16,54,54963,201011210dal,1879
2010112106,2010_11_GB_MIN,2010,11,2010-11-21,Sunday,13:00,GB,31,MIN,3,Home,-28,34,54966,201011210min,1880
2010112107,2010_11_SEA_NO,2010,11,2010-11-21,Sunday,16:05,SEA,19,NO,34,Home,15,53,54970,201011210nor,1881
2010112108,2010_11_WAS_TEN,2010,11,2010-11-21,Sunday,13:00,WAS,19,TEN,16,Home,-3,35,54969,201011210oti,1875
2010112109,2010_11_ARI_KC,2010,11,2010-11-21,Sunday,13:00,ARI,13,KC,31,Home,18,44,54965,201011210kan,1874
2010112110,2010_11_ATL_STL,2010,11,2010-11-21,Sunday,16:05,ATL,34,STL,17,Home,-17,51,54971,201011210ram,1882
2010112111,2010_11_TB_SF,2010,11,2010-11-21,Sunday,16:05,TB,21,SF,0,Home,-21,21,54972,201011210sfo,1883
2010112112,2010_11_IND_NE,2010,11,2010-11-21,Sunday,16:15,IND,28,NE,31,Home,3,59,54973,201011210nwe,1884
2010112113,2010_11_NYG_PHI,2010,11,2010-11-21,Sunday,20:20,NYG,17,PHI,27,Home,10,44,54974,201011210phi,1885
2010112200,2010_11_DEN_SD,2010,11,2010-11-22,Monday,20:30,DEN,14,SD,35,Home,21,49,54975,201011220sdg,1886
2010112500,2010_12_NE_DET,2010,12,2010-11-25,Thursday,12:30,NE,45,DET,24,Home,-21,69,54976,201011250det,1887
2010112501,2010_12_NO_DAL,2010,12,2010-11-25,Thursday,16:15,NO,30,DAL,27,Home,-3,57,54977,201011250dal,1888
2010112502,2010_12_CIN_NYJ,2010,12,2010-11-25,Thursday,20:20,CIN,10,NYJ,26,Home,16,36,54978,201011250nyj,1889
2010112800,2010_12_JAX_NYG,2010,12,2010-11-28,Sunday,13:00,JAX,20,NYG,24,Home,4,44,54985,201011280nyg,1890
2010112801,2010_12_PIT_BUF,2010,12,2010-11-28,Sunday,13:00,PIT,19,BUF,16,Home,-3,35,54981,201011280buf,1891
2010112802,2010_12_TEN_HOU,2010,12,2010-11-28,Sunday,13:00,TEN,0,HOU,20,Home,20,20,54984,201011280htx,1892
2010112803,2010_12_MIN_WAS,2010,12,2010-11-28,Sunday,13:00,MIN,17,WAS,13,Home,-4,30,54986,201011280was,1893
2010112804,2010_12_PHI_CHI,2010,12,2010-11-28,Sunday,16:15,PHI,26,CHI,31,Home,5,57,54982,201011280chi,1894
2010112805,2010_12_GB_ATL,2010,12,2010-11-28,Sunday,13:00,GB,17,ATL,20,Home,3,37,54979,201011280atl,1895
2010112806,2010_12_TB_BAL,2010,12,2010-11-28,Sunday,16:15,TB,10,BAL,17,Home,7,27,54980,201011280rav,1896
2010112807,2010_12_CAR_CLE,2010,12,2010-11-28,Sunday,13:00,CAR,23,CLE,24,Home,1,47,54983,201011280cle,1897
2010112808,2010_12_KC_SEA,2010,12,2010-11-28,Sunday,16:05,KC,42,SEA,24,Home,-18,66,54987,201011280sea,1898
2010112809,2010_12_MIA_OAK,2010,12,2010-11-28,Sunday,16:05,MIA,33,OAK,17,Home,-16,50,54988,201011280rai,1899
2010112810,2010_12_STL_DEN,2010,12,2010-11-28,Sunday,16:15,STL,36,DEN,33,Home,-3,69,54989,201011280den,1900
2010112811,2010_12_SD_IND,2010,12,2010-11-28,Sunday,20:20,SD,36,IND,14,Home,-22,50,54990,201011280clt,1901
2010112900,2010_12_SF_ARI,2010,12,2010-11-29,Monday,20:30,SF,27,ARI,6,Home,-21,33,54991,201011290crd,1902
2010120200,2010_13_HOU_PHI,2010,13,2010-12-02,Thursday,20:20,HOU,24,PHI,34,Home,10,58,54992,201012020phi,1903
2010120500,2010_13_BUF_MIN,2010,13,2010-12-05,Sunday,13:00,BUF,14,MIN,38,Home,24,52,54998,201012050min,1904
2010120501,2010_13_CLE_MIA,2010,13,2010-12-05,Sunday,13:00,CLE,13,MIA,10,Home,-3,23,54997,201012050mia,1905
2010120502,2010_13_JAX_TEN,2010,13,2010-12-05,Sunday,13:00,JAX,17,TEN,6,Home,-11,23,55001,201012050oti,1906
2010120503,2010_13_DEN_KC,2010,13,2010-12-05,Sunday,13:00,DEN,6,KC,10,Home,4,16,54996,201012050kan,1907
2010120504,2010_13_WAS_NYG,2010,13,2010-12-05,Sunday,13:00,WAS,7,NYG,31,Home,24,38,54999,201012050nyg,1908
2010120505,2010_13_CHI_DET,2010,13,2010-12-05,Sunday,13:00,CHI,24,DET,20,Home,-4,44,54994,201012050det,1909
2010120506,2010_13_SF_GB,2010,13,2010-12-05,Sunday,13:00,SF,16,GB,34,Home,18,50,54995,201012050gnb,1910
2010120507,2010_13_ATL_TB,2010,13,2010-12-05,Sunday,16:15,ATL,28,TB,24,Home,-4,52,55000,201012050tam,1911
2010120508,2010_13_NO_CIN,2010,13,2010-12-05,Sunday,13:00,NO,34,CIN,30,Home,-4,64,54993,201012050cin,1912
2010120509,2010_13_OAK_SD,2010,13,2010-12-05,Sunday,16:05,OAK,28,SD,13,Home,-15,41,55002,201012050sdg,1913
2010120510,2010_13_DAL_IND,2010,13,2010-12-05,Sunday,16:15,DAL,38,IND,35,Home,-3,73,55004,201012050clt,1914
2010120511,2010_13_STL_ARI,2010,13,2010-12-05,Sunday,16:15,STL,19,ARI,6,Home,-13,25,55003,201012050crd,1915
2010120512,2010_13_CAR_SEA,2010,13,2010-12-05,Sunday,16:15,CAR,14,SEA,31,Home,17,45,55005,201012050sea,1916
2010120513,2010_13_PIT_BAL,2010,13,2010-12-05,Sunday,20:20,PIT,13,BAL,10,Home,-3,23,55006,201012050rav,1917
2010120600,2010_13_NYJ_NE,2010,13,2010-12-06,Monday,20:30,NYJ,3,NE,45,Home,42,48,55007,201012060nwe,1918
2010120900,2010_14_IND_TEN,2010,14,2010-12-09,Thursday,20:20,IND,30,TEN,28,Home,-2,58,55008,201012090oti,1919
2010121200,2010_14_NE_CHI,2010,14,2010-12-12,Sunday,16:15,NE,36,CHI,7,Home,-29,43,55009,201012120chi,1920
2010121201,2010_14_CLE_BUF,2010,14,2010-12-12,Sunday,13:00,CLE,6,BUF,13,Home,7,19,55010,201012120buf,1921
2010121202,2010_14_CIN_PIT,2010,14,2010-12-12,Sunday,13:00,CIN,7,PIT,23,Home,16,30,55011,201012120pit,1922
2010121203,2010_14_OAK_JAX,2010,14,2010-12-12,Sunday,13:00,OAK,31,JAX,38,Home,7,69,55012,201012120jax,1923
2010121204,2010_14_TB_WAS,2010,14,2010-12-12,Sunday,13:00,TB,17,WAS,16,Home,-1,33,55013,201012120was,1924
2010121205,2010_14_GB_DET,2010,14,2010-12-12,Sunday,13:00,GB,3,DET,7,Home,4,10,55014,201012120det,1925
2010121207,2010_14_ATL_CAR,2010,14,2010-12-12,Sunday,13:00,ATL,31,CAR,10,Home,-21,41,55016,201012120car,1927
2010121208,2010_14_STL_NO,2010,14,2010-12-12,Sunday,16:05,STL,13,NO,31,Home,18,44,55017,201012120nor,1928
2010121209,2010_14_SEA_SF,2010,14,2010-12-12,Sunday,16:05,SEA,21,SF,40,Home,19,61,55018,201012120sfo,1929
2010121210,2010_14_MIA_NYJ,2010,14,2010-12-12,Sunday,16:15,MIA,10,NYJ,6,Home,-4,16,55020,201012120nyj,1930
2010121211,2010_14_DEN_ARI,2010,14,2010-12-12,Sunday,16:15,DEN,13,ARI,43,Home,30,56,55019,201012120crd,1931
2010121212,2010_14_KC_SD,2010,14,2010-12-12,Sunday,16:15,KC,0,SD,31,Home,31,31,55021,201012120sdg,1932
2010121213,2010_14_PHI_DAL,2010,14,2010-12-12,Sunday,20:20,PHI,30,DAL,27,Home,-3,57,55022,201012120dal,1933
2010121300,2010_14_BAL_HOU,2010,14,2010-12-13,Monday,20:30,BAL,34,HOU,28,Home,-6,62,55023,201012130htx,1934
2010121301,2010_14_NYG_MIN,2010,14,2010-12-13,Monday,19:20,NYG,21,MIN,3,Neutral,-18,24,55015,201012130min,1926
2010121600,2010_15_SF_SD,2010,15,2010-12-16,Thursday,20:20,SF,7,SD,34,Home,27,41,55024,201012160sdg,1935
2010121900,2010_15_KC_STL,2010,15,2010-12-19,Sunday,13:00,KC,27,STL,13,Home,-14,40,55032,201012190ram,1936
2010121901,2010_15_BUF_MIA,2010,15,2010-12-19,Sunday,13:00,BUF,17,MIA,14,Home,-3,31,55030,201012190mia,1937
2010121902,2010_15_CLE_CIN,2010,15,2010-12-19,Sunday,13:00,CLE,17,CIN,19,Home,2,36,55027,201012190cin,1938
2010121903,2010_15_JAX_IND,2010,15,2010-12-19,Sunday,13:00,JAX,24,IND,34,Home,10,58,55029,201012190clt,1939
2010121904,2010_15_HOU_TEN,2010,15,2010-12-19,Sunday,13:00,HOU,17,TEN,31,Home,14,48,55034,201012190oti,1940
2010121905,2010_15_WAS_DAL,2010,15,2010-12-19,Sunday,13:00,WAS,30,DAL,33,Home,3,63,55028,201012190dal,1941
2010121906,2010_15_PHI_NYG,2010,15,2010-12-19,Sunday,13:00,PHI,38,NYG,31,Home,-7,69,55031,201012190nyg,1942
2010121907,2010_15_ARI_CAR,2010,15,2010-12-19,Sunday,13:00,ARI,12,CAR,19,Home,7,31,55026,201012190car,1943
2010121908,2010_15_DET_TB,2010,15,2010-12-19,Sunday,13:00,DET,23,TB,20,Home,-3,43,55033,201012190tam,1944
2010121909,2010_15_NO_BAL,2010,15,2010-12-19,Sunday,13:00,NO,24,BAL,30,Home,6,54,55025,201012190rav,1945
2010121910,2010_15_ATL_SEA,2010,15,2010-12-19,Sunday,16:05,ATL,34,SEA,18,Home,-16,52,55035,201012190sea,1946
2010121911,2010_15_NYJ_PIT,2010,15,2010-12-19,Sunday,16:15,NYJ,22,PIT,17,Home,-5,39,55037,201012190pit,1947
2010121912,2010_15_DEN_OAK,2010,15,2010-12-19,Sunday,16:15,DEN,23,OAK,39,Home,16,62,55036,201012190rai,1948
2010121913,2010_15_GB_NE,2010,15,2010-12-19,Sunday,20:20,GB,27,NE,31,Home,4,58,55038,201012190nwe,1949
2010122000,2010_15_CHI_MIN,2010,15,2010-12-20,Monday,20:30,CHI,40,MIN,14,Home,-26,54,55039,201012200min,1950
2010122300,2010_16_CAR_PIT,2010,16,2010-12-23,Thursday,20:20,CAR,3,PIT,27,Home,24,30,55040,201012230pit,1951
2010122500,2010_16_DAL_ARI,2010,16,2010-12-25,Saturday,19:30,DAL,26,ARI,27,Home,1,53,55041,201012250crd,1952
2010122600,2010_16_NYJ_CHI,2010,16,2010-12-26,Sunday,13:00,NYJ,34,CHI,38,Home,4,72,55043,201012260chi,1953
2010122601,2010_16_NE_BUF,2010,16,2010-12-26,Sunday,13:00,NE,34,BUF,3,Home,-31,37,55042,201012260buf,1954
2010122602,2010_16_BAL_CLE,2010,16,2010-12-26,Sunday,13:00,BAL,20,CLE,10,Home,-10,30,55044,201012260cle,1955
2010122603,2010_16_TEN_KC,2010,16,2010-12-26,Sunday,13:00,TEN,14,KC,34,Home,20,48,55046,201012260kan,1956
2010122605,2010_16_SEA_TB,2010,16,2010-12-26,Sunday,16:15,SEA,15,TB,38,Home,23,53,55050,201012260tam,1958
2010122606,2010_16_SF_STL,2010,16,2010-12-26,Sunday,13:00,SF,17,STL,25,Home,8,42,55049,201012260ram,1959
2010122607,2010_16_DET_MIA,2010,16,2010-12-26,Sunday,13:00,DET,34,MIA,27,Home,-7,61,55047,201012260mia,1960
2010122608,2010_16_WAS_JAX,2010,16,2010-12-26,Sunday,13:00,WAS,20,JAX,17,Home,-3,37,55045,201012260jax,1961
2010122609,2010_16_HOU_DEN,2010,16,2010-12-26,Sunday,16:05,HOU,23,DEN,24,Home,1,47,55051,201012260den,1962
2010122610,2010_16_IND_OAK,2010,16,2010-12-26,Sunday,16:05,IND,31,OAK,26,Home,-5,57,55052,201012260rai,1963
2010122611,2010_16_NYG_GB,2010,16,2010-12-26,Sunday,16:15,NYG,17,GB,45,Home,28,62,55053,201012260gnb,1964
2010122612,2010_16_SD_CIN,2010,16,2010-12-26,Sunday,16:05,SD,20,CIN,34,Home,14,54,55054,201012260cin,1965
2010122700,2010_16_NO_ATL,2010,16,2010-12-27,Monday,20:30,NO,17,ATL,14,Home,-3,31,55055,201012270atl,1966
2010122800,2010_16_MIN_PHI,2010,16,2010-12-28,Tuesday,20:00,MIN,24,PHI,14,Home,-10,38,55048,201012280phi,1957
2011010200,2010_17_MIA_NE,2010,17,2011-01-02,Sunday,13:00,MIA,7,NE,38,Home,31,45,55064,201101020nwe,1967
2011010201,2010_17_BUF_NYJ,2010,17,2011-01-02,Sunday,13:00,BUF,7,NYJ,38,Home,31,45,55066,201101020nyj,1968
2011010202,2010_17_CIN_BAL,2010,17,2011-01-02,Sunday,13:00,CIN,7,BAL,13,Home,6,20,55057,201101020rav,1969
2011010203,2010_17_PIT_CLE,2010,17,2011-01-02,Sunday,13:00,PIT,41,CLE,9,Home,-32,50,55058,201101020cle,1970
2011010204,2010_17_JAX_HOU,2010,17,2011-01-02,Sunday,16:15,JAX,17,HOU,34,Home,17,51,55061,201101020htx,1971
2011010205,2010_17_TEN_IND,2010,17,2011-01-02,Sunday,16:15,TEN,20,IND,23,Home,3,43,55062,201101020clt,1972
2011010206,2010_17_OAK_KC,2010,17,2011-01-02,Sunday,13:00,OAK,31,KC,10,Home,-21,41,55063,201101020kan,1973
2011010207,2010_17_DAL_PHI,2010,17,2011-01-02,Sunday,16:15,DAL,14,PHI,13,Home,-1,27,55067,201101020phi,1974
2011010208,2010_17_NYG_WAS,2010,17,2011-01-02,Sunday,16:15,NYG,17,WAS,14,Home,-3,31,55068,201101020was,1975
2011010209,2010_17_MIN_DET,2010,17,2011-01-02,Sunday,13:00,MIN,13,DET,20,Home,7,33,55059,201101020det,1976
2011010210,2010_17_CHI_GB,2010,17,2011-01-02,Sunday,16:15,CHI,3,GB,10,Home,7,13,55060,201101020gnb,1977
2011010211,2010_17_CAR_ATL,2010,17,2011-01-02,Sunday,13:00,CAR,10,ATL,31,Home,21,41,55056,201101020atl,1978
2011010212,2010_17_TB_NO,2010,17,2011-01-02,Sunday,13:00,TB,23,NO,13,Home,-10,36,55065,201101020nor,1979
2011010213,2010_17_SD_DEN,2010,17,2011-01-02,Sunday,16:15,SD,33,DEN,28,Home,-5,61,55069,201101020den,1980
2011010214,2010_17_ARI_SF,2010,17,2011-01-02,Sunday,16:15,ARI,7,SF,38,Home,31,45,55070,201101020sfo,1981
2011010215,2010_17_STL_SEA,2010,17,2011-01-02,Sunday,20:20,STL,6,SEA,16,Home,10,22,55071,201101020sea,1982
2011010800,2010_18_NYJ_IND,2010,18,2011-01-08,Saturday,20:00,NYJ,17,IND,16,Home,-1,33,55152,201101080clt,1984
2011010801,2010_18_NO_SEA,2010,18,2011-01-08,Saturday,16:30,NO,36,SEA,41,Home,5,77,55151,201101080sea,1983
2011010900,2010_18_BAL_KC,2010,18,2011-01-09,Sunday,13:00,BAL,30,KC,7,Home,-23,37,55153,201101090kan,1985
2011010901,2010_18_GB_PHI,2010,18,2011-01-09,Sunday,16:30,GB,21,PHI,16,Home,-5,37,55154,201101090phi,1986
2011011500,2010_19_BAL_PIT,2010,19,2011-01-15,Saturday,16:30,BAL,24,PIT,31,Home,7,55,55156,201101150pit,1987
2011011501,2010_19_GB_ATL,2010,19,2011-01-15,Saturday,20:00,GB,48,ATL,21,Home,-27,69,55157,201101150atl,1988
2011011600,2010_19_NYJ_NE,2010,19,2011-01-16,Sunday,16:30,NYJ,28,NE,21,Home,-7,49,55159,201101160nwe,1990
2011011601,2010_19_SEA_CHI,2010,19,2011-01-16,Sunday,13:00,SEA,24,CHI,35,Home,11,59,55158,201101160chi,1989
2011012300,2010_20_NYJ_PIT,2010,20,2011-01-23,Sunday,18:30,NYJ,19,PIT,24,Home,5,43,55161,201101230pit,1992
2011012301,2010_20_GB_CHI,2010,20,2011-01-23,Sunday,15:00,GB,21,CHI,14,Home,-7,35,55160,201101230chi,1991
2011020600,2010_21_PIT_GB,2010,21,2011-02-06,Sunday,18:30,PIT,25,GB,31,Neutral,6,56,55162,201102060gnb,1993
2011090800,2011_01_NO_GB,2011,1,2011-09-08,Thursday,20:30,NO,34,GB,42,Home,8,76,55164,201109080gnb,2058
2011091100,2011_01_PIT_BAL,2011,1,2011-09-11,Sunday,13:00,PIT,7,BAL,35,Home,28,42,55165,201109110rav,2069
2011091101,2011_01_CIN_CLE,2011,1,2011-09-11,Sunday,13:00,CIN,27,CLE,17,Home,-10,44,55167,201109110cle,2061
2011091102,2011_01_IND_HOU,2011,1,2011-09-11,Sunday,13:00,IND,7,HOU,34,Home,27,41,55168,201109110htx,2071
2011091103,2011_01_TEN_JAX,2011,1,2011-09-11,Sunday,13:00,TEN,14,JAX,16,Home,2,30,55169,201109110jax,2066
2011091104,2011_01_BUF_KC,2011,1,2011-09-11,Sunday,13:00,BUF,41,KC,7,Home,-34,48,55170,201109110kan,2065
2011091105,2011_01_ATL_CHI,2011,1,2011-09-11,Sunday,13:00,ATL,12,CHI,30,Home,18,42,55166,201109110chi,2060
2011091106,2011_01_DET_TB,2011,1,2011-09-11,Sunday,13:00,DET,27,TB,20,Home,-7,47,55172,201109110tam,2062
2011091107,2011_01_PHI_STL,2011,1,2011-09-11,Sunday,13:00,PHI,31,STL,13,Home,-18,44,55171,201109110ram,2068
2011091108,2011_01_NYG_WAS,2011,1,2011-09-11,Sunday,16:25,NYG,14,WAS,28,Home,14,42,55176,201109110was,2070
2011091109,2011_01_CAR_ARI,2011,1,2011-09-11,Sunday,16:15,CAR,21,ARI,28,Home,7,49,55173,201109110crd,2063
2011091110,2011_01_SEA_SF,2011,1,2011-09-11,Sunday,16:25,SEA,17,SF,33,Home,16,50,55175,201109110sfo,2059
2011091111,2011_01_MIN_SD,2011,1,2011-09-11,Sunday,16:15,MIN,17,SD,24,Home,7,41,55174,201109110sdg,2064
2011091112,2011_01_DAL_NYJ,2011,1,2011-09-11,Sunday,20:20,DAL,24,NYJ,27,Home,3,51,55177,201109110nyj,2067
2011091200,2011_01_NE_MIA,2011,1,2011-09-12,Monday,19:00,NE,38,MIA,24,Home,-14,62,55178,201109120mia,2073
2011091201,2011_01_OAK_DEN,2011,1,2011-09-12,Monday,22:15,OAK,23,DEN,20,Home,-3,43,55179,201109120den,2072
2011091800,2011_02_KC_DET,2011,2,2011-09-18,Sunday,13:00,KC,3,DET,48,Home,45,51,55182,201109180det,2081
2011091801,2011_02_OAK_BUF,2011,2,2011-09-18,Sunday,13:00,OAK,35,BUF,38,Home,3,73,55180,201109180buf,2075
2011091802,2011_02_BAL_TEN,2011,2,2011-09-18,Sunday,13:00,BAL,13,TEN,26,Home,13,39,55188,201109180oti,2087
2011091803,2011_02_JAX_NYJ,2011,2,2011-09-18,Sunday,13:00,JAX,3,NYJ,32,Home,29,35,55186,201109180nyj,2080
2011091804,2011_02_CLE_IND,2011,2,2011-09-18,Sunday,13:00,CLE,27,IND,19,Home,-8,46,55183,201109180clt,2077
2011091805,2011_02_ARI_WAS,2011,2,2011-09-18,Sunday,13:00,ARI,21,WAS,22,Home,1,43,55189,201109180was,2084
2011091806,2011_02_TB_MIN,2011,2,2011-09-18,Sunday,13:00,TB,24,MIN,20,Home,-4,44,55184,201109180min,2088
2011091807,2011_02_GB_CAR,2011,2,2011-09-18,Sunday,13:00,GB,30,CAR,23,Home,-7,53,55181,201109180car,2082
2011091808,2011_02_CHI_NO,2011,2,2011-09-18,Sunday,13:00,CHI,13,NO,30,Home,17,43,55185,201109180nor,2085
2011091809,2011_02_SEA_PIT,2011,2,2011-09-18,Sunday,13:00,SEA,0,PIT,24,Home,24,24,55187,201109180pit,2086
2011091810,2011_02_DAL_SF,2011,2,2011-09-18,Sunday,16:05,DAL,27,SF,24,Home,-3,51,55190,201109180sfo,2074
2011091811,2011_02_SD_NE,2011,2,2011-09-18,Sunday,16:15,SD,21,NE,35,Home,14,56,55193,201109180nwe,2083
2011091812,2011_02_CIN_DEN,2011,2,2011-09-18,Sunday,16:15,CIN,22,DEN,24,Home,2,46,55191,201109180den,2076
2011091813,2011_02_HOU_MIA,2011,2,2011-09-18,Sunday,16:15,HOU,23,MIA,13,Home,-10,36,55192,201109180mia,2078
2011091814,2011_02_PHI_ATL,2011,2,2011-09-18,Sunday,20:20,PHI,31,ATL,35,Home,4,66,55194,201109180atl,2079
2011091900,2011_02_STL_NYG,2011,2,2011-09-19,Monday,20:30,STL,16,NYG,28,Home,12,44,55195,201109190nyg,2089
2011092500,2011_03_JAX_CAR,2011,3,2011-09-25,Sunday,13:00,JAX,10,CAR,16,Home,6,26,55197,201109250car,2098
2011092501,2011_03_HOU_NO,2011,3,2011-09-25,Sunday,13:00,HOU,33,NO,40,Home,7,73,55201,201109250nor,2101
2011092502,2011_03_NE_BUF,2011,3,2011-09-25,Sunday,13:00,NE,31,BUF,34,Home,3,65,55196,201109250buf,2092
2011092503,2011_03_MIA_CLE,2011,3,2011-09-25,Sunday,13:00,MIA,16,CLE,17,Home,1,33,55199,201109250cle,2093
2011092504,2011_03_DEN_TEN,2011,3,2011-09-25,Sunday,13:00,DEN,14,TEN,17,Home,3,31,55203,201109250oti,2103
2011092505,2011_03_NYG_PHI,2011,3,2011-09-25,Sunday,13:00,NYG,29,PHI,16,Home,-13,45,55202,201109250phi,2097
2011092506,2011_03_DET_MIN,2011,3,2011-09-25,Sunday,13:00,DET,26,MIN,23,Home,-3,49,55200,201109250min,2104
2011092507,2011_03_SF_CIN,2011,3,2011-09-25,Sunday,13:00,SF,13,CIN,8,Home,-5,21,55198,201109250cin,2091
2011092508,2011_03_NYJ_OAK,2011,3,2011-09-25,Sunday,16:05,NYJ,24,OAK,34,Home,10,58,55204,201109250rai,2099
2011092509,2011_03_KC_SD,2011,3,2011-09-25,Sunday,16:05,KC,17,SD,20,Home,3,37,55206,201109250sdg,2095
2011092510,2011_03_BAL_STL,2011,3,2011-09-25,Sunday,16:05,BAL,37,STL,7,Home,-30,44,55205,201109250ram,2100
2011092511,2011_03_GB_CHI,2011,3,2011-09-25,Sunday,16:15,GB,27,CHI,17,Home,-10,44,55207,201109250chi,2090
2011092512,2011_03_ARI_SEA,2011,3,2011-09-25,Sunday,16:15,ARI,10,SEA,13,Home,3,23,55208,201109250sea,2102
2011092513,2011_03_ATL_TB,2011,3,2011-09-25,Sunday,16:15,ATL,13,TB,16,Home,3,29,55209,201109250tam,2094
2011092514,2011_03_PIT_IND,2011,3,2011-09-25,Sunday,20:20,PIT,23,IND,20,Home,-3,43,55210,201109250clt,2096
2011092600,2011_03_WAS_DAL,2011,3,2011-09-26,Monday,20:30,WAS,16,DAL,18,Home,2,34,55211,201109260dal,2105
2011100200,2011_04_BUF_CIN,2011,4,2011-10-02,Sunday,13:00,BUF,20,CIN,23,Home,3,43,55213,201110020cin,2107
2011100201,2011_04_TEN_CLE,2011,4,2011-10-02,Sunday,13:00,TEN,31,CLE,13,Home,-18,44,55214,201110020cle,2108
2011100202,2011_04_PIT_HOU,2011,4,2011-10-02,Sunday,13:00,PIT,10,HOU,17,Home,7,27,55216,201110020htx,2120
2011100203,2011_04_DET_DAL,2011,4,2011-10-02,Sunday,13:00,DET,34,DAL,30,Home,-4,64,55215,201110020dal,2112
2011100204,2011_04_SF_PHI,2011,4,2011-10-02,Sunday,13:00,SF,24,PHI,23,Home,-1,47,55219,201110020phi,2113
2011100205,2011_04_CAR_CHI,2011,4,2011-10-02,Sunday,13:00,CAR,29,CHI,34,Home,5,63,55212,201110020chi,2106
2011100206,2011_04_WAS_STL,2011,4,2011-10-02,Sunday,13:00,WAS,17,STL,10,Home,-7,27,55220,201110020ram,2117
2011100207,2011_04_NO_JAX,2011,4,2011-10-02,Sunday,13:00,NO,23,JAX,10,Home,-13,33,55217,201110020jax,2114
2011100208,2011_04_MIN_KC,2011,4,2011-10-02,Sunday,13:00,MIN,17,KC,22,Home,5,39,55218,201110020kan,2111
2011100209,2011_04_NYG_ARI,2011,4,2011-10-02,Sunday,16:05,NYG,31,ARI,27,Home,-4,58,55221,201110020crd,2109
2011100210,2011_04_ATL_SEA,2011,4,2011-10-02,Sunday,16:05,ATL,30,SEA,28,Home,-2,58,55222,201110020sea,2119
2011100211,2011_04_DEN_GB,2011,4,2011-10-02,Sunday,16:15,DEN,23,GB,49,Home,26,72,55223,201110020gnb,2115
2011100212,2011_04_NE_OAK,2011,4,2011-10-02,Sunday,16:15,NE,31,OAK,19,Home,-12,50,55224,201110020rai,2116
2011100213,2011_04_MIA_SD,2011,4,2011-10-02,Sunday,16:15,MIA,16,SD,26,Home,10,42,55225,201110020sdg,2110
2011100214,2011_04_NYJ_BAL,2011,4,2011-10-02,Sunday,20:20,NYJ,17,BAL,34,Home,17,51,55226,201110020rav,2118
2011100300,2011_04_IND_TB,2011,4,2011-10-03,Monday,20:30,IND,17,TB,24,Home,7,41,55227,201110030tam,2121
2011100900,2011_05_TEN_PIT,2011,5,2011-10-09,Sunday,13:00,TEN,17,PIT,38,Home,21,55,55235,201110090pit,2131
2011100901,2011_05_OAK_HOU,2011,5,2011-10-09,Sunday,13:00,OAK,25,HOU,20,Home,-5,45,55230,201110090htx,2132
2011100902,2011_05_KC_IND,2011,5,2011-10-09,Sunday,13:00,KC,28,IND,24,Home,-4,52,55231,201110090clt,2125
2011100903,2011_05_CIN_JAX,2011,5,2011-10-09,Sunday,13:00,CIN,30,JAX,20,Home,-10,50,55232,201110090jax,2128
2011100904,2011_05_SEA_NYG,2011,5,2011-10-09,Sunday,13:00,SEA,36,NYG,25,Home,-11,61,55234,201110090nyg,2127
2011100905,2011_05_ARI_MIN,2011,5,2011-10-09,Sunday,13:00,ARI,10,MIN,34,Home,24,44,55233,201110090min,2133
2011100906,2011_05_NO_CAR,2011,5,2011-10-09,Sunday,13:00,NO,30,CAR,27,Home,-3,57,55229,201110090car,2129
2011100907,2011_05_PHI_BUF,2011,5,2011-10-09,Sunday,13:00,PHI,24,BUF,31,Home,7,55,55228,201110090buf,2123
2011100908,2011_05_TB_SF,2011,5,2011-10-09,Sunday,16:05,TB,3,SF,48,Home,45,51,55236,201110090sfo,2122
2011100909,2011_05_NYJ_NE,2011,5,2011-10-09,Sunday,16:15,NYJ,21,NE,30,Home,9,51,55238,201110090nwe,2130
2011100910,2011_05_SD_DEN,2011,5,2011-10-09,Sunday,16:15,SD,29,DEN,24,Home,-5,53,55237,201110090den,2124
2011100911,2011_05_GB_ATL,2011,5,2011-10-09,Sunday,20:20,GB,25,ATL,14,Home,-11,39,55239,201110090atl,2126
2011101000,2011_05_CHI_DET,2011,5,2011-10-10,Monday,20:30,CHI,13,DET,24,Home,11,37,55240,201110100det,2134
2011101600,2011_06_BUF_NYG,2011,6,2011-10-16,Sunday,13:00,BUF,24,NYG,27,Home,3,51,55245,201110160nyg,2139
2011101601,2011_06_IND_CIN,2011,6,2011-10-16,Sunday,13:00,IND,17,CIN,27,Home,10,44,55242,201110160cin,2136
2011101602,2011_06_JAX_PIT,2011,6,2011-10-16,Sunday,13:00,JAX,13,PIT,17,Home,4,30,55246,201110160pit,2146
2011101603,2011_06_PHI_WAS,2011,6,2011-10-16,Sunday,13:00,PHI,20,WAS,13,Home,-7,33,55247,201110160was,2145
2011101604,2011_06_SF_DET,2011,6,2011-10-16,Sunday,13:00,SF,25,DET,19,Home,-6,44,55243,201110160det,2140
2011101605,2011_06_STL_GB,2011,6,2011-10-16,Sunday,13:00,STL,3,GB,24,Home,21,27,55244,201110160gnb,2141
2011101606,2011_06_CAR_ATL,2011,6,2011-10-16,Sunday,13:00,CAR,17,ATL,31,Home,14,48,55241,201110160atl,2138
2011101607,2011_06_CLE_OAK,2011,6,2011-10-16,Sunday,16:05,CLE,17,OAK,24,Home,7,41,55249,201110160rai,2143
2011101608,2011_06_HOU_BAL,2011,6,2011-10-16,Sunday,16:05,HOU,14,BAL,29,Home,15,43,55248,201110160rav,2144
2011101609,2011_06_NO_TB,2011,6,2011-10-16,Sunday,16:15,NO,20,TB,26,Home,6,46,55251,201110160tam,2137
2011101610,2011_06_DAL_NE,2011,6,2011-10-16,Sunday,16:15,DAL,16,NE,20,Home,4,36,55250,201110160nwe,2142
2011101611,2011_06_MIN_CHI,2011,6,2011-10-16,Sunday,20:20,MIN,10,CHI,39,Home,29,49,55252,201110160chi,2135
2011101700,2011_06_MIA_NYJ,2011,6,2011-10-17,Monday,20:30,MIA,6,NYJ,24,Home,18,30,55253,201110170nyj,2147
2011102300,2011_07_DEN_MIA,2011,7,2011-10-23,Sunday,13:00,DEN,18,MIA,15,Home,-3,33,55257,201110230mia,2152
2011102301,2011_07_SD_NYJ,2011,7,2011-10-23,Sunday,13:00,SD,21,NYJ,27,Home,6,48,55258,201110230nyj,2153
2011102302,2011_07_HOU_TEN,2011,7,2011-10-23,Sunday,13:00,HOU,41,TEN,7,Home,-34,48,55260,201110230oti,2158
2011102303,2011_07_ATL_DET,2011,7,2011-10-23,Sunday,13:00,ATL,23,DET,16,Home,-7,39,55256,201110230det,2154
2011102304,2011_07_WAS_CAR,2011,7,2011-10-23,Sunday,13:00,WAS,20,CAR,33,Home,13,53,55254,201110230car,2155
2011102305,2011_07_CHI_TB,2011,7,2011-10-23,Sunday,13:00,CHI,24,TB,18,Neutral,-6,42,55259,201110230tam,2149
2011102306,2011_07_SEA_CLE,2011,7,2011-10-23,Sunday,13:00,SEA,3,CLE,6,Home,3,9,55255,201110230cle,2148
2011102307,2011_07_PIT_ARI,2011,7,2011-10-23,Sunday,16:05,PIT,32,ARI,20,Home,-12,52,55261,201110230crd,2150
2011102308,2011_07_KC_OAK,2011,7,2011-10-23,Sunday,16:05,KC,28,OAK,0,Home,-28,28,55262,201110230rai,2156
2011102309,2011_07_GB_MIN,2011,7,2011-10-23,Sunday,16:15,GB,33,MIN,27,Home,-6,60,55264,201110230min,2159
2011102310,2011_07_STL_DAL,2011,7,2011-10-23,Sunday,16:15,STL,7,DAL,34,Home,27,41,55263,201110230dal,2151
2011102311,2011_07_IND_NO,2011,7,2011-10-23,Sunday,20:20,IND,7,NO,62,Home,55,69,55265,201110230nor,2157
2011102400,2011_07_BAL_JAX,2011,7,2011-10-24,Monday,20:30,BAL,7,JAX,12,Home,5,19,55266,201110240jax,2160
2011103000,2011_08_MIA_NYG,2011,8,2011-10-30,Sunday,13:00,MIA,17,NYG,20,Home,3,37,55270,201110300nyg,2165
2011103001,2011_08_JAX_HOU,2011,8,2011-10-30,Sunday,13:00,JAX,14,HOU,24,Home,10,38,55269,201110300htx,2171
2011103002,2011_08_IND_TEN,2011,8,2011-10-30,Sunday,13:00,IND,10,TEN,27,Home,17,37,55272,201110300oti,2172
2011103003,2011_08_MIN_CAR,2011,8,2011-10-30,Sunday,13:00,MIN,24,CAR,21,Home,-3,45,55268,201110300car,2166
2011103004,2011_08_NO_STL,2011,8,2011-10-30,Sunday,13:00,NO,21,STL,31,Home,10,52,55271,201110300ram,2167
2011103005,2011_08_ARI_BAL,2011,8,2011-10-30,Sunday,13:00,ARI,27,BAL,30,Home,3,57,55267,201110300rav,2168
2011103006,2011_08_DET_DEN,2011,8,2011-10-30,Sunday,16:05,DET,45,DEN,10,Home,-35,55,55274,201110300den,2163
2011103007,2011_08_WAS_BUF,2011,8,2011-10-30,Sunday,16:05,WAS,0,BUF,23,Home,23,23,55273,201110300buf,2162
2011103008,2011_08_NE_PIT,2011,8,2011-10-30,Sunday,16:15,NE,17,PIT,25,Home,8,42,55275,201110300pit,2170
2011103009,2011_08_CLE_SF,2011,8,2011-10-30,Sunday,16:15,CLE,10,SF,20,Home,10,30,55276,201110300sfo,2161
2011103010,2011_08_CIN_SEA,2011,8,2011-10-30,Sunday,16:15,CIN,34,SEA,12,Home,-22,46,55277,201110300sea,2169
2011103011,2011_08_DAL_PHI,2011,8,2011-10-30,Sunday,20:20,DAL,7,PHI,34,Home,27,41,55278,201110300phi,2164
2011103100,2011_08_SD_KC,2011,8,2011-10-31,Monday,20:30,SD,20,KC,23,Home,3,43,55279,201110310kan,2173
2011110600,2011_09_NYJ_BUF,2011,9,2011-11-06,Sunday,13:00,NYJ,27,BUF,11,Home,-16,38,55280,201111060buf,2174
2011110601,2011_09_CLE_HOU,2011,9,2011-11-06,Sunday,13:00,CLE,12,HOU,30,Home,18,42,55282,201111060htx,2185
2011110602,2011_09_MIA_KC,2011,9,2011-11-06,Sunday,13:00,MIA,31,KC,3,Home,-28,34,55284,201111060kan,2177
2011110603,2011_09_SEA_DAL,2011,9,2011-11-06,Sunday,13:00,SEA,13,DAL,23,Home,10,36,55281,201111060dal,2179
2011110604,2011_09_SF_WAS,2011,9,2011-11-06,Sunday,13:00,SF,19,WAS,11,Home,-8,30,55286,201111060was,2182
2011110605,2011_09_TB_NO,2011,9,2011-11-06,Sunday,13:00,TB,16,NO,27,Home,11,43,55285,201111060nor,2183
2011110606,2011_09_ATL_IND,2011,9,2011-11-06,Sunday,13:00,ATL,31,IND,7,Home,-24,38,55283,201111060clt,2178
2011110607,2011_09_DEN_OAK,2011,9,2011-11-06,Sunday,16:05,DEN,38,OAK,24,Home,-14,62,55287,201111060rai,2181
2011110608,2011_09_CIN_TEN,2011,9,2011-11-06,Sunday,16:05,CIN,24,TEN,17,Home,-7,41,55288,201111060oti,2186
2011110609,2011_09_NYG_NE,2011,9,2011-11-06,Sunday,16:15,NYG,24,NE,20,Home,-4,44,55290,201111060nwe,2180
2011110610,2011_09_GB_SD,2011,9,2011-11-06,Sunday,16:15,GB,45,SD,38,Home,-7,83,55291,201111060sdg,2176
2011110611,2011_09_STL_ARI,2011,9,2011-11-06,Sunday,16:15,STL,13,ARI,19,Home,6,32,55289,201111060crd,2175
2011110612,2011_09_BAL_PIT,2011,9,2011-11-06,Sunday,20:20,BAL,23,PIT,20,Home,-3,43,55292,201111060pit,2184
2011110700,2011_09_CHI_PHI,2011,9,2011-11-07,Monday,20:30,CHI,30,PHI,24,Home,-6,54,55293,201111070phi,2187
2011111000,2011_10_OAK_SD,2011,10,2011-11-10,Thursday,20:20,OAK,24,SD,17,Home,-7,41,55294,201111100sdg,2188
2011111300,2011_10_BUF_DAL,2011,10,2011-11-13,Sunday,13:00,BUF,7,DAL,44,Home,37,51,55300,201111130dal,2196
2011111301,2011_10_TEN_CAR,2011,10,2011-11-13,Sunday,13:00,TEN,30,CAR,3,Home,-27,33,55296,201111130car,2201
2011111302,2011_10_HOU_TB,2011,10,2011-11-13,Sunday,13:00,HOU,37,TB,9,Home,-28,46,55305,201111130tam,2193
2011111303,2011_10_PIT_CIN,2011,10,2011-11-13,Sunday,13:00,PIT,24,CIN,17,Home,-7,41,55298,201111130cin,2191
2011111304,2011_10_JAX_IND,2011,10,2011-11-13,Sunday,13:00,JAX,17,IND,3,Home,-14,20,55301,201111130clt,2195
2011111305,2011_10_DEN_KC,2011,10,2011-11-13,Sunday,13:00,DEN,17,KC,10,Home,-7,27,55302,201111130kan,2194
2011111306,2011_10_ARI_PHI,2011,10,2011-11-13,Sunday,13:00,ARI,21,PHI,17,Home,-4,38,55304,201111130phi,2198
2011111307,2011_10_DET_CHI,2011,10,2011-11-13,Sunday,16:15,DET,13,CHI,37,Home,24,50,55297,201111130chi,2190
2011111308,2011_10_NO_ATL,2011,10,2011-11-13,Sunday,13:00,NO,26,ATL,23,Home,-3,49,55295,201111130atl,2199
2011111309,2011_10_WAS_MIA,2011,10,2011-11-13,Sunday,13:00,WAS,9,MIA,20,Home,11,29,55303,201111130mia,2197
2011111310,2011_10_STL_CLE,2011,10,2011-11-13,Sunday,13:00,STL,13,CLE,12,Home,-1,25,55299,201111130cle,2192
2011111311,2011_10_BAL_SEA,2011,10,2011-11-13,Sunday,16:05,BAL,17,SEA,22,Home,5,39,55306,201111130sea,2202
2011111312,2011_10_NYG_SF,2011,10,2011-11-13,Sunday,16:15,NYG,20,SF,27,Home,7,47,55307,201111130sfo,2189
2011111313,2011_10_NE_NYJ,2011,10,2011-11-13,Sunday,20:20,NE,37,NYJ,16,Home,-21,53,55308,201111130nyj,2200
2011111400,2011_10_MIN_GB,2011,10,2011-11-14,Monday,20:30,MIN,7,GB,45,Home,38,52,55309,201111140gnb,2203
2011111700,2011_11_NYJ_DEN,2011,11,2011-11-17,Thursday,20:20,NYJ,13,DEN,17,Home,4,30,55310,201111170den,2204
2011112000,2011_11_OAK_MIN,2011,11,2011-11-20,Sunday,13:00,OAK,27,MIN,21,Home,-6,48,55317,201111200min,2216
2011112001,2011_11_TEN_ATL,2011,11,2011-11-20,Sunday,16:15,TEN,17,ATL,23,Home,6,40,55311,201111200atl,2209
2011112002,2011_11_BUF_MIA,2011,11,2011-11-20,Sunday,13:00,BUF,8,MIA,35,Home,27,43,55316,201111200mia,2208
2011112003,2011_11_JAX_CLE,2011,11,2011-11-20,Sunday,13:00,JAX,10,CLE,14,Home,4,24,55313,201111200cle,2207
2011112004,2011_11_CIN_BAL,2011,11,2011-11-20,Sunday,13:00,CIN,24,BAL,31,Home,7,55,55312,201111200rav,2214
2011112005,2011_11_DAL_WAS,2011,11,2011-11-20,Sunday,13:00,DAL,27,WAS,24,Home,-3,51,55318,201111200was,2215
2011112006,2011_11_CAR_DET,2011,11,2011-11-20,Sunday,13:00,CAR,35,DET,49,Home,14,84,55314,201111200det,2211
2011112007,2011_11_TB_GB,2011,11,2011-11-20,Sunday,13:00,TB,26,GB,35,Home,9,61,55315,201111200gnb,2212
2011112008,2011_11_ARI_SF,2011,11,2011-11-20,Sunday,16:05,ARI,7,SF,23,Home,16,30,55320,201111200sfo,2205
2011112009,2011_11_SEA_STL,2011,11,2011-11-20,Sunday,16:05,SEA,24,STL,7,Home,-17,31,55319,201111200ram,2213
2011112010,2011_11_SD_CHI,2011,11,2011-11-20,Sunday,16:15,SD,20,CHI,31,Home,11,51,55321,201111200chi,2206
2011112011,2011_11_PHI_NYG,2011,11,2011-11-20,Sunday,20:20,PHI,17,NYG,10,Home,-7,27,55322,201111200nyg,2210
2011112100,2011_11_KC_NE,2011,11,2011-11-21,Monday,20:30,KC,3,NE,34,Home,31,37,55323,201111210nwe,2217
2011112400,2011_12_GB_DET,2011,12,2011-11-24,Thursday,12:30,GB,27,DET,15,Home,-12,42,55324,201111240det,2219
2011112401,2011_12_MIA_DAL,2011,12,2011-11-24,Thursday,16:15,MIA,19,DAL,20,Home,1,39,55325,201111240dal,2218
2011112402,2011_12_SF_BAL,2011,12,2011-11-24,Thursday,20:20,SF,6,BAL,16,Home,10,22,55326,201111240rav,2220
2011112700,2011_12_BUF_NYJ,2011,12,2011-11-27,Sunday,13:00,BUF,24,NYJ,28,Home,4,52,55331,201111270nyj,2228
2011112701,2011_12_CLE_CIN,2011,12,2011-11-27,Sunday,13:00,CLE,20,CIN,23,Home,3,43,55328,201111270cin,2221
2011112702,2011_12_HOU_JAX,2011,12,2011-11-27,Sunday,13:00,HOU,20,JAX,13,Home,-7,33,55330,201111270jax,2227
2011112703,2011_12_MIN_ATL,2011,12,2011-11-27,Sunday,13:00,MIN,14,ATL,24,Home,10,38,55327,201111270atl,2226
2011112704,2011_12_ARI_STL,2011,12,2011-11-27,Sunday,13:00,ARI,23,STL,20,Home,-3,43,55332,201111270ram,2230
2011112705,2011_12_CAR_IND,2011,12,2011-11-27,Sunday,13:00,CAR,27,IND,19,Home,-8,46,55329,201111270clt,2224
2011112706,2011_12_TB_TEN,2011,12,2011-11-27,Sunday,13:00,TB,17,TEN,23,Home,6,40,55333,201111270oti,2232
2011112707,2011_12_WAS_SEA,2011,12,2011-11-27,Sunday,16:05,WAS,23,SEA,17,Home,-6,40,55335,201111270sea,2231
2011112708,2011_12_CHI_OAK,2011,12,2011-11-27,Sunday,16:05,CHI,20,OAK,25,Home,5,45,55334,201111270rai,2229
2011112709,2011_12_NE_PHI,2011,12,2011-11-27,Sunday,16:15,NE,38,PHI,20,Home,-18,58,55336,201111270phi,2225
2011112710,2011_12_DEN_SD,2011,12,2011-11-27,Sunday,16:15,DEN,16,SD,13,Home,-3,29,55337,201111270sdg,2222
2011112711,2011_12_PIT_KC,2011,12,2011-11-27,Sunday,20:20,PIT,13,KC,9,Home,-4,22,55338,201111270kan,2223
2011112800,2011_12_NYG_NO,2011,12,2011-11-28,Monday,20:30,NYG,24,NO,49,Home,25,73,55339,201111280nor,2233
2011120100,2011_13_PHI_SEA,2011,13,2011-12-01,Thursday,20:20,PHI,14,SEA,31,Home,17,45,55340,201112010sea,2234
2011120400,2011_13_NYJ_WAS,2011,13,2011-12-04,Sunday,13:00,NYJ,34,WAS,19,Home,-15,53,55349,201112040was,2244
2011120401,2011_13_KC_CHI,2011,13,2011-12-04,Sunday,13:00,KC,10,CHI,3,Home,-7,13,55342,201112040chi,2236
2011120402,2011_13_TEN_BUF,2011,13,2011-12-04,Sunday,13:00,TEN,23,BUF,17,Home,-6,40,55341,201112040buf,2237
2011120403,2011_13_OAK_MIA,2011,13,2011-12-04,Sunday,13:00,OAK,14,MIA,34,Home,20,48,55345,201112040mia,2241
2011120404,2011_13_BAL_CLE,2011,13,2011-12-04,Sunday,16:05,BAL,24,CLE,10,Home,-14,34,55343,201112040cle,2238
2011120405,2011_13_CIN_PIT,2011,13,2011-12-04,Sunday,13:00,CIN,7,PIT,35,Home,28,42,55347,201112040pit,2246
2011120406,2011_13_DET_NO,2011,13,2011-12-04,Sunday,20:20,DET,17,NO,31,Home,14,48,55346,201112040nor,2245
2011120407,2011_13_CAR_TB,2011,13,2011-12-04,Sunday,13:00,CAR,38,TB,19,Home,-19,57,55348,201112040tam,2239
2011120408,2011_13_ATL_HOU,2011,13,2011-12-04,Sunday,13:00,ATL,10,HOU,17,Home,7,27,55344,201112040htx,2247
2011120409,2011_13_DEN_MIN,2011,13,2011-12-04,Sunday,13:00,DEN,35,MIN,32,Home,-3,67,55350,201112040min,2248
2011120410,2011_13_GB_NYG,2011,13,2011-12-04,Sunday,16:15,GB,38,NYG,35,Home,-3,73,55352,201112040nyg,2242
2011120411,2011_13_DAL_ARI,2011,13,2011-12-04,Sunday,16:15,DAL,13,ARI,19,Home,6,32,55351,201112040crd,2240
2011120412,2011_13_STL_SF,2011,13,2011-12-04,Sunday,16:15,STL,0,SF,26,Home,26,26,55353,201112040sfo,2235
2011120413,2011_13_IND_NE,2011,13,2011-12-04,Sunday,13:00,IND,24,NE,31,Home,7,55,55354,201112040nwe,2243
2011120500,2011_13_SD_JAX,2011,13,2011-12-05,Monday,20:30,SD,38,JAX,14,Home,-24,52,55355,201112050jax,2249
2011120800,2011_14_CLE_PIT,2011,14,2011-12-08,Thursday,20:20,CLE,3,PIT,14,Home,11,17,55356,201112080pit,2250
2011121100,2011_14_NE_WAS,2011,14,2011-12-11,Sunday,13:00,NE,34,WAS,27,Home,-7,61,55366,201112110was,2263
2011121101,2011_14_OAK_GB,2011,14,2011-12-11,Sunday,16:15,OAK,16,GB,46,Home,30,62,55361,201112110gnb,2260
2011121102,2011_14_KC_NYJ,2011,14,2011-12-11,Sunday,13:00,KC,10,NYJ,37,Home,27,47,55364,201112110nyj,2258
2011121103,2011_14_HOU_CIN,2011,14,2011-12-11,Sunday,13:00,HOU,20,CIN,19,Home,-1,39,55359,201112110cin,2251
2011121104,2011_14_IND_BAL,2011,14,2011-12-11,Sunday,13:00,IND,10,BAL,24,Home,14,34,55357,201112110rav,2262
2011121105,2011_14_MIN_DET,2011,14,2011-12-11,Sunday,13:00,MIN,28,DET,34,Home,6,62,55360,201112110det,2259
2011121106,2011_14_ATL_CAR,2011,14,2011-12-11,Sunday,13:00,ATL,31,CAR,23,Home,-8,54,55358,201112110car,2261
2011121107,2011_14_PHI_MIA,2011,14,2011-12-11,Sunday,13:00,PHI,26,MIA,10,Home,-16,36,55363,201112110mia,2256
2011121108,2011_14_TB_JAX,2011,14,2011-12-11,Sunday,13:00,TB,14,JAX,41,Home,27,55,55362,201112110jax,2257
2011121109,2011_14_NO_TEN,2011,14,2011-12-11,Sunday,13:00,NO,22,TEN,17,Home,-5,39,55365,201112110oti,2264
2011121110,2011_14_SF_ARI,2011,14,2011-12-11,Sunday,16:05,SF,19,ARI,21,Home,2,40,55367,201112110crd,2253
2011121111,2011_14_CHI_DEN,2011,14,2011-12-11,Sunday,16:05,CHI,10,DEN,13,Home,3,23,55368,201112110den,2252
2011121112,2011_14_BUF_SD,2011,14,2011-12-11,Sunday,16:15,BUF,10,SD,37,Home,27,47,55369,201112110sdg,2254
2011121113,2011_14_NYG_DAL,2011,14,2011-12-11,Sunday,20:20,NYG,37,DAL,34,Home,-3,71,55370,201112110dal,2255
2011121200,2011_14_STL_SEA,2011,14,2011-12-12,Monday,20:30,STL,13,SEA,30,Home,17,43,55371,201112120sea,2265
2011121500,2011_15_JAX_ATL,2011,15,2011-12-15,Thursday,20:20,JAX,14,ATL,41,Home,27,55,55372,201112150atl,2266
2011121700,2011_15_DAL_TB,2011,15,2011-12-17,Saturday,20:20,DAL,31,TB,15,Home,-16,46,55373,201112170tam,2267
2011121800,2011_15_CIN_STL,2011,15,2011-12-18,Sunday,13:00,CIN,20,STL,13,Home,-7,33,55381,201112180ram,2278
2011121801,2011_15_MIA_BUF,2011,15,2011-12-18,Sunday,13:00,MIA,30,BUF,23,Home,-7,53,55374,201112180buf,2269
2011121802,2011_15_TEN_IND,2011,15,2011-12-18,Sunday,13:00,TEN,13,IND,27,Home,14,40,55377,201112180clt,2274
2011121803,2011_15_WAS_NYG,2011,15,2011-12-18,Sunday,13:00,WAS,23,NYG,10,Home,-13,33,55380,201112180nyg,2276
2011121804,2011_15_SEA_CHI,2011,15,2011-12-18,Sunday,13:00,SEA,38,CHI,14,Home,-24,52,55375,201112180chi,2268
2011121805,2011_15_NO_MIN,2011,15,2011-12-18,Sunday,13:00,NO,42,MIN,20,Home,-22,62,55379,201112180min,2280
2011121806,2011_15_CAR_HOU,2011,15,2011-12-18,Sunday,13:00,CAR,28,HOU,13,Home,-15,41,55376,201112180htx,2279
2011121807,2011_15_GB_KC,2011,15,2011-12-18,Sunday,13:00,GB,14,KC,19,Home,5,33,55378,201112180kan,2273
2011121808,2011_15_DET_OAK,2011,15,2011-12-18,Sunday,16:05,DET,28,OAK,27,Home,-1,55,55382,201112180rai,2277
2011121809,2011_15_NYJ_PHI,2011,15,2011-12-18,Sunday,16:15,NYJ,19,PHI,45,Home,26,64,55385,201112180phi,2275
2011121810,2011_15_CLE_ARI,2011,15,2011-12-18,Sunday,16:15,CLE,17,ARI,20,Home,3,37,55383,201112180crd,2271
2011121811,2011_15_NE_DEN,2011,15,2011-12-18,Sunday,16:15,NE,41,DEN,23,Home,-18,64,55384,201112180den,2270
2011121812,2011_15_BAL_SD,2011,15,2011-12-18,Sunday,20:20,BAL,14,SD,34,Home,20,48,55386,201112180sdg,2272
2011121900,2011_15_PIT_SF,2011,15,2011-12-19,Monday,20:30,PIT,3,SF,20,Home,17,23,55387,201112190sfo,2281
2011122200,2011_16_HOU_IND,2011,16,2011-12-22,Thursday,20:20,HOU,16,IND,19,Home,3,35,55388,201112220clt,2282
2011122400,2011_16_DEN_BUF,2011,16,2011-12-24,Saturday,13:00,DEN,14,BUF,40,Home,26,54,55390,201112240buf,2284
2011122401,2011_16_MIA_NE,2011,16,2011-12-24,Saturday,13:00,MIA,24,NE,27,Home,3,51,55394,201112240nwe,2290
2011122402,2011_16_CLE_BAL,2011,16,2011-12-24,Saturday,13:00,CLE,14,BAL,20,Home,6,34,55389,201112240rav,2291
2011122403,2011_16_JAX_TEN,2011,16,2011-12-24,Saturday,13:00,JAX,17,TEN,23,Home,6,40,55397,201112240oti,2295
2011122404,2011_16_OAK_KC,2011,16,2011-12-24,Saturday,13:00,OAK,16,KC,13,Home,-3,29,55393,201112240kan,2285
2011122405,2011_16_NYG_NYJ,2011,16,2011-12-24,Saturday,13:00,NYG,29,NYJ,14,Home,-15,43,55395,201112240nyj,2287
2011122406,2011_16_MIN_WAS,2011,16,2011-12-24,Saturday,13:00,MIN,33,WAS,26,Home,-7,59,55398,201112240was,2292
2011122407,2011_16_TB_CAR,2011,16,2011-12-24,Saturday,13:00,TB,16,CAR,48,Home,32,64,55391,201112240car,2289
2011122408,2011_16_ARI_CIN,2011,16,2011-12-24,Saturday,13:00,ARI,16,CIN,23,Home,7,39,55392,201112240cin,2283
2011122409,2011_16_STL_PIT,2011,16,2011-12-24,Saturday,13:00,STL,0,PIT,27,Home,27,27,55396,201112240pit,2294
2011122410,2011_16_SD_DET,2011,16,2011-12-24,Saturday,16:05,SD,10,DET,38,Home,28,48,55399,201112240det,2288
2011122411,2011_16_PHI_DAL,2011,16,2011-12-24,Saturday,16:15,PHI,20,DAL,7,Home,-13,27,55400,201112240dal,2286
2011122412,2011_16_SF_SEA,2011,16,2011-12-24,Saturday,16:15,SF,19,SEA,17,Home,-2,36,55401,201112240sea,2293
2011122500,2011_16_CHI_GB,2011,16,2011-12-25,Sunday,20:20,CHI,21,GB,35,Home,14,56,55402,201112250gnb,2296
2011122600,2011_16_ATL_NO,2011,16,2011-12-26,Monday,20:30,ATL,16,NO,45,Home,29,61,55403,201112260nor,2297
2012010100,2011_17_NYJ_MIA,2011,17,2012-01-01,Sunday,13:00,NYJ,17,MIA,19,Home,2,36,55410,201201010mia,2302
2012010101,2011_17_BUF_NE,2011,17,2012-01-01,Sunday,13:00,BUF,21,NE,49,Home,28,70,55412,201201010nwe,2308
2012010102,2011_17_BAL_CIN,2011,17,2012-01-01,Sunday,16:15,BAL,24,CIN,16,Home,-8,40,55405,201201010cin,2298
2012010103,2011_17_PIT_CLE,2011,17,2012-01-01,Sunday,16:15,PIT,13,CLE,9,Home,-4,22,55406,201201010cle,2300
2012010104,2011_17_TEN_HOU,2011,17,2012-01-01,Sunday,13:00,TEN,23,HOU,22,Home,-1,45,55408,201201010htx,2312
2012010105,2011_17_IND_JAX,2011,17,2012-01-01,Sunday,13:00,IND,13,JAX,19,Home,6,32,55409,201201010jax,2306
2012010106,2011_17_DAL_NYG,2011,17,2012-01-01,Sunday,20:20,DAL,14,NYG,31,Home,17,45,55414,201201010nyg,2305
2012010107,2011_17_WAS_PHI,2011,17,2012-01-01,Sunday,13:00,WAS,10,PHI,34,Home,24,44,55415,201201010phi,2303
2012010108,2011_17_DET_GB,2011,17,2012-01-01,Sunday,13:00,DET,41,GB,45,Home,4,86,55407,201201010gnb,2307
2012010109,2011_17_CHI_MIN,2011,17,2012-01-01,Sunday,13:00,CHI,17,MIN,13,Home,-4,30,55411,201201010min,2313
2012010110,2011_17_TB_ATL,2011,17,2012-01-01,Sunday,16:15,TB,24,ATL,45,Home,21,69,55404,201201010atl,2304
2012010111,2011_17_CAR_NO,2011,17,2012-01-01,Sunday,13:00,CAR,17,NO,45,Home,28,62,55413,201201010nor,2311
2012010112,2011_17_SF_STL,2011,17,2012-01-01,Sunday,13:00,SF,34,STL,27,Home,-7,61,55416,201201010ram,2310
2012010113,2011_17_KC_DEN,2011,17,2012-01-01,Sunday,16:15,KC,7,DEN,3,Home,-4,10,55418,201201010den,2299
2012010114,2011_17_SD_OAK,2011,17,2012-01-01,Sunday,16:15,SD,38,OAK,26,Home,-12,64,55419,201201010rai,2309
2012010115,2011_17_SEA_ARI,2011,17,2012-01-01,Sunday,16:15,SEA,20,ARI,23,Home,3,43,55417,201201010crd,2301
2012010700,2011_18_CIN_HOU,2011,18,2012-01-07,Saturday,16:30,CIN,10,HOU,31,Home,21,41,55490,201201070htx,2314
2012010701,2011_18_DET_NO,2011,18,2012-01-07,Saturday,20:00,DET,28,NO,45,Home,17,73,55491,201201070nor,2315
2012010800,2011_18_PIT_DEN,2011,18,2012-01-08,Sunday,16:30,PIT,23,DEN,29,Home,6,52,55493,201201080den,2317
2012010801,2011_18_ATL_NYG,2011,18,2012-01-08,Sunday,13:00,ATL,2,NYG,24,Home,22,26,55492,201201080nyg,2316
2012011400,2011_19_DEN_NE,2011,19,2012-01-14,Saturday,20:00,DEN,10,NE,45,Home,35,55,55495,201201140nwe,2319
2012011401,2011_19_NO_SF,2011,19,2012-01-14,Saturday,16:30,NO,32,SF,36,Home,4,68,55494,201201140sfo,2318
2012011500,2011_19_HOU_BAL,2011,19,2012-01-15,Sunday,13:00,HOU,13,BAL,20,Home,7,33,55496,201201150rav,2320
2012011501,2011_19_NYG_GB,2011,19,2012-01-15,Sunday,16:30,NYG,37,GB,20,Home,-17,57,55497,201201150gnb,2321
2012012200,2011_20_BAL_NE,2011,20,2012-01-22,Sunday,15:00,BAL,20,NE,23,Home,3,43,55498,201201220nwe,2322
2012012201,2011_20_NYG_SF,2011,20,2012-01-22,Sunday,18:30,NYG,20,SF,17,Home,-3,37,55501,201201220sfo,2323
2012020500,2011_21_NYG_NE,2011,21,2012-02-05,Sunday,18:30,NYG,21,NE,17,Neutral,-4,38,55502,201202050nwe,2324
2012090500,2012_01_DAL_NYG,2012,1,2012-09-05,Wednesday,20:30,DAL,24,NYG,17,Home,-7,41,55504,201209050nyg,2390
2012090900,2012_01_IND_CHI,2012,1,2012-09-09,Sunday,13:00,IND,21,CHI,41,Home,20,62,55505,201209090chi,2394
2012090901,2012_01_JAX_MIN,2012,1,2012-09-09,Sunday,13:00,JAX,23,MIN,26,Home,3,49,55510,201209090min,2395
2012090902,2012_01_BUF_NYJ,2012,1,2012-09-09,Sunday,13:00,BUF,28,NYJ,48,Home,20,76,55512,201209090nyj,2392
2012090903,2012_01_MIA_HOU,2012,1,2012-09-09,Sunday,13:00,MIA,10,HOU,30,Home,20,40,55508,201209090htx,2396
2012090904,2012_01_NE_TEN,2012,1,2012-09-09,Sunday,13:00,NE,34,TEN,13,Home,-21,47,55513,201209090oti,2397
2012090905,2012_01_STL_DET,2012,1,2012-09-09,Sunday,13:00,STL,23,DET,27,Home,4,50,55507,201209090det,2402
2012090906,2012_01_WAS_NO,2012,1,2012-09-09,Sunday,13:00,WAS,40,NO,32,Home,-8,72,55511,201209090nor,2403
2012090907,2012_01_PHI_CLE,2012,1,2012-09-09,Sunday,13:00,PHI,17,CLE,16,Home,-1,33,55506,201209090cle,2398
2012090908,2012_01_ATL_KC,2012,1,2012-09-09,Sunday,13:00,ATL,40,KC,24,Home,-16,64,55509,201209090kan,2391
2012090909,2012_01_SF_GB,2012,1,2012-09-09,Sunday,16:25,SF,30,GB,22,Home,-8,52,55515,201209090gnb,2401
2012090910,2012_01_SEA_ARI,2012,1,2012-09-09,Sunday,16:25,SEA,16,ARI,20,Home,4,36,55514,201209090crd,2400
2012090911,2012_01_CAR_TB,2012,1,2012-09-09,Sunday,16:25,CAR,10,TB,16,Home,6,26,55516,201209090tam,2393
2012090912,2012_01_PIT_DEN,2012,1,2012-09-09,Sunday,20:20,PIT,19,DEN,31,Home,12,50,55517,201209090den,2399
2012091000,2012_01_CIN_BAL,2012,1,2012-09-10,Monday,19:00,CIN,13,BAL,44,Home,31,57,55518,201209100rav,2404
2012091001,2012_01_SD_OAK,2012,1,2012-09-10,Monday,22:15,SD,22,OAK,14,Home,-8,36,55519,201209100rai,2405
2012091300,2012_02_CHI_GB,2012,2,2012-09-13,Thursday,20:20,CHI,10,GB,23,Home,13,33,55520,201209130gnb,2406
2012091600,2012_02_TB_NYG,2012,2,2012-09-16,Sunday,13:00,TB,34,NYG,41,Home,7,75,55527,201209160nyg,2418
2012091601,2012_02_NO_CAR,2012,2,2012-09-16,Sunday,13:00,NO,27,CAR,35,Home,8,62,55522,201209160car,2415
2012091602,2012_02_ARI_NE,2012,2,2012-09-16,Sunday,13:00,ARI,20,NE,18,Home,-2,38,55526,201209160nwe,2407
2012091603,2012_02_MIN_IND,2012,2,2012-09-16,Sunday,13:00,MIN,20,IND,23,Home,3,43,55524,201209160clt,2414
2012091604,2012_02_BAL_PHI,2012,2,2012-09-16,Sunday,13:00,BAL,23,PHI,24,Home,1,47,55528,201209160phi,2408
2012091605,2012_02_KC_BUF,2012,2,2012-09-16,Sunday,13:00,KC,17,BUF,35,Home,18,52,55521,201209160buf,2413
2012091606,2012_02_CLE_CIN,2012,2,2012-09-16,Sunday,13:00,CLE,27,CIN,34,Home,7,61,55523,201209160cin,2409
2012091607,2012_02_HOU_JAX,2012,2,2012-09-16,Sunday,13:00,HOU,27,JAX,7,Home,-20,34,55525,201209160jax,2412
2012091608,2012_02_DAL_SEA,2012,2,2012-09-16,Sunday,16:05,DAL,7,SEA,27,Home,20,34,55530,201209160sea,2410
2012091609,2012_02_WAS_STL,2012,2,2012-09-16,Sunday,16:05,WAS,28,STL,31,Home,3,59,55529,201209160ram,2420
2012091610,2012_02_NYJ_PIT,2012,2,2012-09-16,Sunday,16:25,NYJ,10,PIT,27,Home,17,37,55532,201209160pit,2416
2012091611,2012_02_TEN_SD,2012,2,2012-09-16,Sunday,16:25,TEN,10,SD,38,Home,28,48,55533,201209160sdg,2419
2012091612,2012_02_OAK_MIA,2012,2,2012-09-16,Sunday,13:00,OAK,13,MIA,35,Home,22,48,55531,201209160mia,2417
2012091613,2012_02_DET_SF,2012,2,2012-09-16,Sunday,20:20,DET,19,SF,27,Home,8,46,55534,201209160sfo,2411
2012091700,2012_02_DEN_ATL,2012,2,2012-09-17,Monday,20:30,DEN,21,ATL,27,Home,6,48,55535,201209170atl,2421
2012092000,2012_03_NYG_CAR,2012,3,2012-09-20,Thursday,20:20,NYG,36,CAR,7,Home,-29,43,55536,201209200car,2422
2012092300,2012_03_TB_DAL,2012,3,2012-09-23,Sunday,13:00,TB,10,DAL,16,Home,6,26,55539,201209230dal,2436
2012092301,2012_03_STL_CHI,2012,3,2012-09-23,Sunday,13:00,STL,6,CHI,23,Home,17,29,55537,201209230chi,2435
2012092302,2012_03_SF_MIN,2012,3,2012-09-23,Sunday,13:00,SF,13,MIN,24,Home,11,37,55542,201209230min,2434
2012092303,2012_03_DET_TEN,2012,3,2012-09-23,Sunday,13:00,DET,41,TEN,44,Home,3,85,55544,201209230oti,2426
2012092304,2012_03_CIN_WAS,2012,3,2012-09-23,Sunday,13:00,CIN,38,WAS,31,Home,-7,69,55545,201209230was,2425
2012092305,2012_03_KC_NO,2012,3,2012-09-23,Sunday,13:00,KC,27,NO,24,Home,-3,51,55543,201209230nor,2429
2012092306,2012_03_NYJ_MIA,2012,3,2012-09-23,Sunday,13:00,NYJ,23,MIA,20,Home,-3,43,55541,201209230mia,2431
2012092307,2012_03_BUF_CLE,2012,3,2012-09-23,Sunday,13:00,BUF,24,CLE,14,Home,-10,38,55538,201209230cle,2424
2012092308,2012_03_JAX_IND,2012,3,2012-09-23,Sunday,13:00,JAX,22,IND,17,Home,-5,39,55540,201209230clt,2428
2012092309,2012_03_PHI_ARI,2012,3,2012-09-23,Sunday,16:05,PHI,6,ARI,27,Home,21,33,55546,201209230crd,2432
2012092310,2012_03_ATL_SD,2012,3,2012-09-23,Sunday,16:05,ATL,27,SD,3,Home,-24,30,55547,201209230sdg,2423
2012092311,2012_03_HOU_DEN,2012,3,2012-09-23,Sunday,16:25,HOU,31,DEN,25,Home,-6,56,55548,201209230den,2427
2012092312,2012_03_PIT_OAK,2012,3,2012-09-23,Sunday,16:25,PIT,31,OAK,34,Home,3,65,55549,201209230rai,2433
2012092313,2012_03_NE_BAL,2012,3,2012-09-23,Sunday,20:20,NE,30,BAL,31,Home,1,61,55550,201209230rav,2430
2012092400,2012_03_GB_SEA,2012,3,2012-09-24,Monday,20:30,GB,12,SEA,14,Home,2,26,55551,201209240sea,2437
2012092700,2012_04_CLE_BAL,2012,4,2012-09-27,Thursday,20:20,CLE,16,BAL,23,Home,7,39,55552,201209270rav,2438
2012093000,2012_04_NE_BUF,2012,4,2012-09-30,Sunday,13:00,NE,52,BUF,28,Home,-24,80,55554,201209300buf,2443
2012093001,2012_04_TEN_HOU,2012,4,2012-09-30,Sunday,13:00,TEN,14,HOU,38,Home,24,52,55556,201209300htx,2450
2012093002,2012_04_SD_KC,2012,4,2012-09-30,Sunday,13:00,SD,37,KC,20,Home,-17,57,55558,201209300kan,2447
2012093003,2012_04_MIN_DET,2012,4,2012-09-30,Sunday,13:00,MIN,20,DET,13,Home,-7,33,55555,201209300det,2442
2012093004,2012_04_CAR_ATL,2012,4,2012-09-30,Sunday,13:00,CAR,28,ATL,30,Home,2,58,55553,201209300atl,2439
2012093005,2012_04_SEA_STL,2012,4,2012-09-30,Sunday,13:00,SEA,13,STL,19,Home,6,32,55560,201209300ram,2448
2012093006,2012_04_SF_NYJ,2012,4,2012-09-30,Sunday,13:00,SF,34,NYJ,0,Home,-34,34,55559,201209300nyj,2449
2012093007,2012_04_MIA_ARI,2012,4,2012-09-30,Sunday,16:05,MIA,21,ARI,24,Home,3,45,55562,201209300crd,2441
2012093008,2012_04_OAK_DEN,2012,4,2012-09-30,Sunday,16:05,OAK,6,DEN,37,Home,31,43,55563,201209300den,2446
2012093009,2012_04_CIN_JAX,2012,4,2012-09-30,Sunday,16:05,CIN,27,JAX,10,Home,-17,37,55557,201209300jax,2440
2012093010,2012_04_NO_GB,2012,4,2012-09-30,Sunday,16:25,NO,27,GB,28,Home,1,55,55564,201209300gnb,2444
2012093011,2012_04_WAS_TB,2012,4,2012-09-30,Sunday,16:25,WAS,24,TB,22,Home,-2,46,55561,201209300tam,2451
2012093012,2012_04_NYG_PHI,2012,4,2012-09-30,Sunday,20:20,NYG,17,PHI,19,Home,2,36,55565,201209300phi,2445
2012100100,2012_04_CHI_DAL,2012,4,2012-10-01,Monday,20:30,CHI,34,DAL,18,Home,-16,52,55566,201210010dal,2452
2012100400,2012_05_ARI_STL,2012,5,2012-10-04,Thursday,20:20,ARI,3,STL,17,Home,14,20,55567,201210040ram,2453
2012100700,2012_05_ATL_WAS,2012,5,2012-10-07,Sunday,13:00,ATL,24,WAS,17,Home,-7,41,55574,201210070was,2454
2012100701,2012_05_PHI_PIT,2012,5,2012-10-07,Sunday,13:00,PHI,14,PIT,16,Home,2,30,55573,201210070pit,2462
2012100702,2012_05_GB_IND,2012,5,2012-10-07,Sunday,13:00,GB,27,IND,30,Home,3,57,55569,201210070clt,2460
2012100703,2012_05_CLE_NYG,2012,5,2012-10-07,Sunday,13:00,CLE,27,NYG,41,Home,14,68,55572,201210070nyg,2458
2012100704,2012_05_TEN_MIN,2012,5,2012-10-07,Sunday,16:15,TEN,7,MIN,30,Home,23,37,55571,201210070min,2465
2012100705,2012_05_MIA_CIN,2012,5,2012-10-07,Sunday,13:00,MIA,17,CIN,13,Home,-4,30,55568,201210070cin,2461
2012100706,2012_05_BAL_KC,2012,5,2012-10-07,Sunday,13:00,BAL,9,KC,6,Home,-3,15,55570,201210070kan,2455
2012100707,2012_05_SEA_CAR,2012,5,2012-10-07,Sunday,16:05,SEA,16,CAR,12,Home,-4,28,55575,201210070car,2464
2012100708,2012_05_CHI_JAX,2012,5,2012-10-07,Sunday,16:05,CHI,41,JAX,3,Home,-38,44,55576,201210070jax,2457
2012100709,2012_05_DEN_NE,2012,5,2012-10-07,Sunday,16:25,DEN,21,NE,31,Home,10,52,55577,201210070nwe,2459
2012100710,2012_05_BUF_SF,2012,5,2012-10-07,Sunday,16:25,BUF,3,SF,45,Home,42,48,55578,201210070sfo,2456
2012100711,2012_05_SD_NO,2012,5,2012-10-07,Sunday,20:20,SD,24,NO,31,Home,7,55,55579,201210070nor,2463
2012100800,2012_05_HOU_NYJ,2012,5,2012-10-08,Monday,20:30,HOU,23,NYJ,17,Home,-6,40,55580,201210080nyj,2466
2012101100,2012_06_PIT_TEN,2012,6,2012-10-11,Thursday,20:20,PIT,23,TEN,26,Home,3,49,55581,201210110oti,2467
2012101400,2012_06_OAK_ATL,2012,6,2012-10-14,Sunday,13:00,OAK,20,ATL,23,Home,3,43,55582,201210140atl,2478
2012101401,2012_06_KC_TB,2012,6,2012-10-14,Sunday,13:00,KC,10,TB,38,Home,28,48,55588,201210140tam,2474
2012101402,2012_06_IND_NYJ,2012,6,2012-10-14,Sunday,13:00,IND,9,NYJ,35,Home,26,44,55586,201210140nyj,2473
2012101403,2012_06_CIN_CLE,2012,6,2012-10-14,Sunday,13:00,CIN,24,CLE,34,Home,10,58,55584,201210140cle,2469
2012101404,2012_06_DET_PHI,2012,6,2012-10-14,Sunday,13:00,DET,26,PHI,23,Home,-3,49,55587,201210140phi,2471
2012101405,2012_06_STL_MIA,2012,6,2012-10-14,Sunday,13:00,STL,14,MIA,17,Home,3,31,55585,201210140mia,2479
2012101406,2012_06_DAL_BAL,2012,6,2012-10-14,Sunday,13:00,DAL,29,BAL,31,Home,2,60,55583,201210140rav,2470
2012101407,2012_06_BUF_ARI,2012,6,2012-10-14,Sunday,16:05,BUF,19,ARI,16,Home,-3,35,55589,201210140crd,2468
2012101408,2012_06_NE_SEA,2012,6,2012-10-14,Sunday,16:05,NE,23,SEA,24,Home,1,47,55590,201210140sea,2476
2012101409,2012_06_NYG_SF,2012,6,2012-10-14,Sunday,16:25,NYG,26,SF,3,Home,-23,29,55591,201210140sfo,2477
2012101410,2012_06_MIN_WAS,2012,6,2012-10-14,Sunday,16:25,MIN,26,WAS,38,Home,12,64,55592,201210140was,2475
2012101411,2012_06_GB_HOU,2012,6,2012-10-14,Sunday,20:20,GB,42,HOU,24,Home,-18,66,55593,201210140htx,2472
2012101500,2012_06_DEN_SD,2012,6,2012-10-15,Monday,20:30,DEN,35,SD,24,Home,-11,59,55594,201210150sdg,2480
2012101800,2012_07_SEA_SF,2012,7,2012-10-18,Thursday,20:20,SEA,6,SF,13,Home,7,19,55595,201210180sfo,2481
2012102100,2012_07_WAS_NYG,2012,7,2012-10-21,Sunday,13:00,WAS,23,NYG,27,Home,4,50,55601,201210210nyg,2492
2012102101,2012_07_ARI_MIN,2012,7,2012-10-21,Sunday,13:00,ARI,14,MIN,21,Home,7,35,55600,201210210min,2482
2012102102,2012_07_DAL_CAR,2012,7,2012-10-21,Sunday,13:00,DAL,19,CAR,14,Home,-5,33,55597,201210210car,2485
2012102103,2012_07_NO_TB,2012,7,2012-10-21,Sunday,13:00,NO,35,TB,28,Home,-7,63,55603,201210210tam,2488
2012102104,2012_07_GB_STL,2012,7,2012-10-21,Sunday,13:00,GB,30,STL,20,Home,-10,50,55602,201210210ram,2486
2012102105,2012_07_BAL_HOU,2012,7,2012-10-21,Sunday,13:00,BAL,13,HOU,43,Home,30,56,55598,201210210htx,2483
2012102106,2012_07_CLE_IND,2012,7,2012-10-21,Sunday,13:00,CLE,13,IND,17,Home,4,30,55599,201210210clt,2484
2012102107,2012_07_TEN_BUF,2012,7,2012-10-21,Sunday,13:00,TEN,35,BUF,34,Home,-1,69,55596,201210210buf,2491
2012102108,2012_07_NYJ_NE,2012,7,2012-10-21,Sunday,16:25,NYJ,26,NE,29,Home,3,55,55604,201210210nwe,2489
2012102109,2012_07_JAX_OAK,2012,7,2012-10-21,Sunday,16:25,JAX,23,OAK,26,Home,3,49,55605,201210210rai,2487
2012102110,2012_07_PIT_CIN,2012,7,2012-10-21,Sunday,20:20,PIT,24,CIN,17,Home,-7,41,55606,201210210cin,2490
2012102200,2012_07_DET_CHI,2012,7,2012-10-22,Monday,20:30,DET,7,CHI,13,Home,6,20,55607,201210220chi,2493
2012102500,2012_08_TB_MIN,2012,8,2012-10-25,Thursday,20:20,TB,36,MIN,17,Home,-19,53,55608,201210250min,2494
2012102800,2012_08_JAX_GB,2012,8,2012-10-28,Sunday,13:00,JAX,15,GB,24,Home,9,39,55612,201210280gnb,2498
2012102801,2012_08_MIA_NYJ,2012,8,2012-10-28,Sunday,13:00,MIA,30,NYJ,9,Home,-21,39,55613,201210280nyj,2499
2012102802,2012_08_SD_CLE,2012,8,2012-10-28,Sunday,13:00,SD,6,CLE,7,Home,1,13,55610,201210280cle,2504
2012102803,2012_08_IND_TEN,2012,8,2012-10-28,Sunday,13:00,IND,19,TEN,13,Home,-6,32,55617,201210280oti,2497
2012102804,2012_08_NE_STL,2012,8,2012-10-28,Sunday,13:00,NE,45,STL,7,Neutral,-38,52,55616,201210280ram,2500
2012102805,2012_08_ATL_PHI,2012,8,2012-10-28,Sunday,13:00,ATL,30,PHI,17,Home,-13,47,55614,201210280phi,2495
2012102806,2012_08_CAR_CHI,2012,8,2012-10-28,Sunday,13:00,CAR,22,CHI,23,Home,1,45,55609,201210280chi,2496
2012102807,2012_08_SEA_DET,2012,8,2012-10-28,Sunday,13:00,SEA,24,DET,28,Home,4,52,55611,201210280det,2505
2012102808,2012_08_WAS_PIT,2012,8,2012-10-28,Sunday,13:00,WAS,12,PIT,27,Home,15,39,55615,201210280pit,2506
2012102809,2012_08_OAK_KC,2012,8,2012-10-28,Sunday,16:05,OAK,26,KC,16,Home,-10,42,55618,201210280kan,2503
2012102810,2012_08_NYG_DAL,2012,8,2012-10-28,Sunday,16:25,NYG,29,DAL,24,Home,-5,53,55619,201210280dal,2502
2012102811,2012_08_NO_DEN,2012,8,2012-10-28,Sunday,20:20,NO,14,DEN,34,Home,20,48,55620,201210280den,2501
2012102900,2012_08_SF_ARI,2012,8,2012-10-29,Monday,20:30,SF,24,ARI,3,Home,-21,27,55621,201210290crd,2507
2012110100,2012_09_KC_SD,2012,9,2012-11-01,Thursday,20:20,KC,13,SD,31,Home,18,44,55622,201211010sdg,2508
2012110400,2012_09_CAR_WAS,2012,9,2012-11-04,Sunday,13:00,CAR,21,WAS,13,Home,-8,34,55630,201211040was,2512
2012110401,2012_09_ARI_GB,2012,9,2012-11-04,Sunday,13:00,ARI,17,GB,31,Home,14,48,55625,201211040gnb,2509
2012110402,2012_09_DET_JAX,2012,9,2012-11-04,Sunday,13:00,DET,31,JAX,14,Home,-17,45,55628,201211040jax,2516
2012110403,2012_09_CHI_TEN,2012,9,2012-11-04,Sunday,13:00,CHI,51,TEN,20,Home,-31,71,55629,201211040oti,2513
2012110404,2012_09_DEN_CIN,2012,9,2012-11-04,Sunday,13:00,DEN,31,CIN,23,Home,-8,54,55623,201211040cin,2515
2012110405,2012_09_BAL_CLE,2012,9,2012-11-04,Sunday,13:00,BAL,25,CLE,15,Home,-10,40,55624,201211040cle,2510
2012110406,2012_09_BUF_HOU,2012,9,2012-11-04,Sunday,13:00,BUF,9,HOU,21,Home,12,30,55626,201211040htx,2511
2012110407,2012_09_MIA_IND,2012,9,2012-11-04,Sunday,13:00,MIA,20,IND,23,Home,3,43,55627,201211040clt,2517
2012110408,2012_09_MIN_SEA,2012,9,2012-11-04,Sunday,16:05,MIN,20,SEA,30,Home,10,50,55632,201211040sea,2518
2012110409,2012_09_TB_OAK,2012,9,2012-11-04,Sunday,16:05,TB,42,OAK,32,Home,-10,74,55631,201211040rai,2520
2012110410,2012_09_PIT_NYG,2012,9,2012-11-04,Sunday,16:25,PIT,24,NYG,20,Home,-4,44,55633,201211040nyg,2519
2012110411,2012_09_DAL_ATL,2012,9,2012-11-04,Sunday,20:20,DAL,13,ATL,19,Home,6,32,55634,201211040atl,2514
2012110500,2012_09_PHI_NO,2012,9,2012-11-05,Monday,20:30,PHI,13,NO,28,Home,15,41,55635,201211050nor,2521
2012110800,2012_10_IND_JAX,2012,10,2012-11-08,Thursday,20:20,IND,27,JAX,10,Home,-17,37,55636,201211080jax,2522
2012111100,2012_10_DEN_CAR,2012,10,2012-11-11,Sunday,13:00,DEN,36,CAR,14,Home,-22,50,55638,201211110car,2526
2012111101,2012_10_SD_TB,2012,10,2012-11-11,Sunday,13:00,SD,24,TB,34,Home,10,58,55644,201211110tam,2532
2012111102,2012_10_TEN_MIA,2012,10,2012-11-11,Sunday,13:00,TEN,37,MIA,3,Home,-34,40,55640,201211110mia,2534
2012111103,2012_10_BUF_NE,2012,10,2012-11-11,Sunday,13:00,BUF,31,NE,37,Home,6,68,55642,201211110nwe,2524
2012111104,2012_10_OAK_BAL,2012,10,2012-11-11,Sunday,13:00,OAK,20,BAL,55,Home,35,75,55637,201211110rav,2531
2012111105,2012_10_NYG_CIN,2012,10,2012-11-11,Sunday,13:00,NYG,13,CIN,31,Home,18,44,55639,201211110cin,2529
2012111106,2012_10_ATL_NO,2012,10,2012-11-11,Sunday,13:00,ATL,27,NO,31,Home,4,58,55643,201211110nor,2523
2012111107,2012_10_DET_MIN,2012,10,2012-11-11,Sunday,13:00,DET,24,MIN,34,Home,10,58,55641,201211110min,2527
2012111108,2012_10_NYJ_SEA,2012,10,2012-11-11,Sunday,16:05,NYJ,7,SEA,28,Home,21,35,55645,201211110sea,2530
2012111109,2012_10_DAL_PHI,2012,10,2012-11-11,Sunday,16:25,DAL,38,PHI,23,Home,-15,61,55646,201211110phi,2525
2012111110,2012_10_STL_SF,2012,10,2012-11-11,Sunday,16:25,STL,24,SF,24,Home,0,48,55647,201211110sfo,2533
2012111111,2012_10_HOU_CHI,2012,10,2012-11-11,Sunday,20:20,HOU,13,CHI,6,Home,-7,19,55648,201211110chi,2528
2012111200,2012_10_KC_PIT,2012,10,2012-11-12,Monday,20:30,KC,13,PIT,16,Home,3,29,55649,201211120pit,2535
2012111500,2012_11_MIA_BUF,2012,11,2012-11-15,Thursday,20:20,MIA,14,BUF,19,Home,5,33,55650,201211150buf,2536
2012111800,2012_11_PHI_WAS,2012,11,2012-11-18,Sunday,13:00,PHI,6,WAS,31,Home,25,37,55659,201211180was,2546
2012111801,2012_11_GB_DET,2012,11,2012-11-18,Sunday,13:00,GB,24,DET,20,Home,-4,44,55654,201211180det,2541
2012111802,2012_11_ARI_ATL,2012,11,2012-11-18,Sunday,13:00,ARI,19,ATL,23,Home,4,42,55651,201211180atl,2537
2012111803,2012_11_TB_CAR,2012,11,2012-11-18,Sunday,13:00,TB,27,CAR,21,Home,-6,48,55652,201211180car,2548
2012111804,2012_11_CLE_DAL,2012,11,2012-11-18,Sunday,13:00,CLE,20,DAL,23,Home,3,43,55653,201211180dal,2540
2012111805,2012_11_NYJ_STL,2012,11,2012-11-18,Sunday,13:00,NYJ,27,STL,13,Home,-14,40,55658,201211180ram,2545
2012111806,2012_11_IND_NE,2012,11,2012-11-18,Sunday,16:25,IND,24,NE,59,Home,35,83,55657,201211180nwe,2542
2012111807,2012_11_JAX_HOU,2012,11,2012-11-18,Sunday,13:00,JAX,37,HOU,43,Home,6,80,55655,201211180htx,2543
2012111808,2012_11_CIN_KC,2012,11,2012-11-18,Sunday,13:00,CIN,28,KC,6,Home,-22,34,55656,201211180kan,2539
2012111809,2012_11_NO_OAK,2012,11,2012-11-18,Sunday,16:05,NO,38,OAK,17,Home,-21,55,55660,201211180rai,2544
2012111810,2012_11_SD_DEN,2012,11,2012-11-18,Sunday,16:25,SD,23,DEN,30,Home,7,53,55661,201211180den,2547
2012111811,2012_11_BAL_PIT,2012,11,2012-11-18,Sunday,20:20,BAL,13,PIT,10,Home,-3,23,55662,201211180pit,2538
2012111900,2012_11_CHI_SF,2012,11,2012-11-19,Monday,20:30,CHI,7,SF,32,Home,25,39,55663,201211190sfo,2549
2012112200,2012_12_HOU_DET,2012,12,2012-11-22,Thursday,12:30,HOU,34,DET,31,Home,-3,65,55664,201211220det,2550
2012112201,2012_12_WAS_DAL,2012,12,2012-11-22,Thursday,16:15,WAS,38,DAL,31,Home,-7,69,55665,201211220dal,2552
2012112202,2012_12_NE_NYJ,2012,12,2012-11-22,Thursday,20:20,NE,49,NYJ,19,Home,-30,68,55666,201211220nyj,2551
2012112500,2012_12_OAK_CIN,2012,12,2012-11-25,Sunday,13:00,OAK,10,CIN,34,Home,24,44,55668,201211250cin,2559
2012112501,2012_12_PIT_CLE,2012,12,2012-11-25,Sunday,13:00,PIT,14,CLE,20,Home,6,34,55669,201211250cle,2560
2012112502,2012_12_BUF_IND,2012,12,2012-11-25,Sunday,13:00,BUF,13,IND,20,Home,7,33,55670,201211250clt,2555
2012112503,2012_12_TEN_JAX,2012,12,2012-11-25,Sunday,13:00,TEN,19,JAX,24,Home,5,43,55671,201211250jax,2564
2012112504,2012_12_DEN_KC,2012,12,2012-11-25,Sunday,13:00,DEN,17,KC,9,Home,-8,26,55672,201211250kan,2556
2012112505,2012_12_MIN_CHI,2012,12,2012-11-25,Sunday,13:00,MIN,10,CHI,28,Home,18,38,55667,201211250chi,2558
2012112506,2012_12_ATL_TB,2012,12,2012-11-25,Sunday,13:00,ATL,24,TB,23,Home,-1,47,55674,201211250tam,2553
2012112507,2012_12_SEA_MIA,2012,12,2012-11-25,Sunday,13:00,SEA,21,MIA,24,Home,3,45,55673,201211250mia,2561
2012112508,2012_12_BAL_SD,2012,12,2012-11-25,Sunday,16:05,BAL,16,SD,13,Home,-3,29,55675,201211250sdg,2554
2012112509,2012_12_SF_NO,2012,12,2012-11-25,Sunday,16:25,SF,31,NO,21,Home,-10,52,55677,201211250nor,2562
2012112510,2012_12_STL_ARI,2012,12,2012-11-25,Sunday,16:25,STL,31,ARI,17,Home,-14,48,55676,201211250crd,2563
2012112511,2012_12_GB_NYG,2012,12,2012-11-25,Sunday,20:20,GB,10,NYG,38,Home,28,48,55678,201211250nyg,2557
2012112600,2012_12_CAR_PHI,2012,12,2012-11-26,Monday,20:30,CAR,30,PHI,22,Home,-8,52,55679,201211260phi,2565
2012112900,2012_13_NO_ATL,2012,13,2012-11-29,Thursday,20:20,NO,13,ATL,23,Home,10,36,55680,201211290atl,2566
2012120200,2012_13_SEA_CHI,2012,13,2012-12-02,Sunday,13:00,SEA,23,CHI,17,Home,-6,40,55682,201212020chi,2578
2012120201,2012_13_MIN_GB,2012,13,2012-12-02,Sunday,13:00,MIN,14,GB,23,Home,9,37,55684,201212020gnb,2574
2012120202,2012_13_SF_STL,2012,13,2012-12-02,Sunday,13:00,SF,13,STL,16,Home,3,29,55688,201212020ram,2579
2012120203,2012_13_ARI_NYJ,2012,13,2012-12-02,Sunday,13:00,ARI,6,NYJ,7,Home,1,13,55687,201212020nyj,2567
2012120204,2012_13_CAR_KC,2012,13,2012-12-02,Sunday,13:00,CAR,21,KC,27,Home,6,48,55685,201212020kan,2568
2012120205,2012_13_IND_DET,2012,13,2012-12-02,Sunday,13:00,IND,35,DET,33,Home,-2,68,55683,201212020det,2572
2012120206,2012_13_JAX_BUF,2012,13,2012-12-02,Sunday,13:00,JAX,18,BUF,34,Home,16,52,55681,201212020buf,2573
2012120207,2012_13_NE_MIA,2012,13,2012-12-02,Sunday,13:00,NE,23,MIA,16,Home,-7,39,55686,201212020mia,2575
2012120208,2012_13_HOU_TEN,2012,13,2012-12-02,Sunday,13:00,HOU,24,TEN,10,Home,-14,34,55689,201212020oti,2571
2012120209,2012_13_TB_DEN,2012,13,2012-12-02,Sunday,16:05,TB,23,DEN,31,Home,8,54,55690,201212020den,2580
2012120210,2012_13_PIT_BAL,2012,13,2012-12-02,Sunday,16:25,PIT,23,BAL,20,Home,-3,43,55691,201212020rav,2577
2012120211,2012_13_CLE_OAK,2012,13,2012-12-02,Sunday,16:25,CLE,20,OAK,17,Home,-3,37,55692,201212020rai,2570
2012120212,2012_13_CIN_SD,2012,13,2012-12-02,Sunday,16:25,CIN,20,SD,13,Home,-7,33,55693,201212020sdg,2569
2012120213,2012_13_PHI_DAL,2012,13,2012-12-02,Sunday,20:20,PHI,33,DAL,38,Home,5,71,55694,201212020dal,2576
2012120300,2012_13_NYG_WAS,2012,13,2012-12-03,Monday,20:30,NYG,16,WAS,17,Home,1,33,55695,201212030was,2581
2012120600,2012_14_DEN_OAK,2012,14,2012-12-06,Thursday,20:20,DEN,26,OAK,13,Home,-13,39,55696,201212060rai,2582
2012120900,2012_14_BAL_WAS,2012,14,2012-12-09,Sunday,13:00,BAL,28,WAS,31,Home,3,59,55706,201212090was,2585
2012120901,2012_14_KC_CLE,2012,14,2012-12-09,Sunday,13:00,KC,7,CLE,30,Home,23,37,55700,201212090cle,2589
2012120902,2012_14_SD_PIT,2012,14,2012-12-09,Sunday,13:00,SD,34,PIT,24,Home,-10,58,55704,201212090pit,2594
2012120903,2012_14_TEN_IND,2012,14,2012-12-09,Sunday,13:00,TEN,23,IND,27,Home,4,50,55701,201212090clt,2596
2012120904,2012_14_NYJ_JAX,2012,14,2012-12-09,Sunday,13:00,NYJ,17,JAX,10,Home,-7,27,55702,201212090jax,2592
2012120905,2012_14_CHI_MIN,2012,14,2012-12-09,Sunday,13:00,CHI,14,MIN,21,Home,7,35,55703,201212090min,2586
2012120906,2012_14_ATL_CAR,2012,14,2012-12-09,Sunday,13:00,ATL,20,CAR,30,Home,10,50,55698,201212090car,2584
2012120907,2012_14_PHI_TB,2012,14,2012-12-09,Sunday,13:00,PHI,23,TB,21,Home,-2,44,55705,201212090tam,2593
2012120908,2012_14_STL_BUF,2012,14,2012-12-09,Sunday,13:00,STL,15,BUF,12,Home,-3,27,55697,201212090buf,2595
2012120909,2012_14_DAL_CIN,2012,14,2012-12-09,Sunday,13:00,DAL,20,CIN,19,Home,-1,39,55699,201212090cin,2587
2012120910,2012_14_MIA_SF,2012,14,2012-12-09,Sunday,16:05,MIA,13,SF,27,Home,14,40,55707,201212090sfo,2590
2012120911,2012_14_NO_NYG,2012,14,2012-12-09,Sunday,16:25,NO,27,NYG,52,Home,25,79,55708,201212090nyg,2591
2012120912,2012_14_ARI_SEA,2012,14,2012-12-09,Sunday,16:25,ARI,0,SEA,58,Home,58,58,55709,201212090sea,2583
2012120913,2012_14_DET_GB,2012,14,2012-12-09,Sunday,20:20,DET,20,GB,27,Home,7,47,55710,201212090gnb,2588
2012121000,2012_14_HOU_NE,2012,14,2012-12-10,Monday,20:30,HOU,14,NE,42,Home,28,56,55711,201212100nwe,2597
2012121300,2012_15_CIN_PHI,2012,15,2012-12-13,Thursday,20:20,CIN,34,PHI,13,Home,-21,47,55712,201212130phi,2598
2012121600,2012_15_GB_CHI,2012,15,2012-12-16,Sunday,13:00,GB,21,CHI,13,Home,-8,34,55715,201212160chi,2602
2012121601,2012_15_NYG_ATL,2012,15,2012-12-16,Sunday,13:00,NYG,0,ATL,34,Home,34,34,55713,201212160atl,2607
2012121602,2012_15_TB_NO,2012,15,2012-12-16,Sunday,13:00,TB,0,NO,41,Home,41,41,55719,201212160nor,2611
2012121603,2012_15_MIN_STL,2012,15,2012-12-16,Sunday,13:00,MIN,36,STL,22,Home,-14,58,55720,201212160ram,2606
2012121604,2012_15_WAS_CLE,2012,15,2012-12-16,Sunday,13:00,WAS,38,CLE,21,Home,-17,59,55716,201212160cle,2612
2012121605,2012_15_JAX_MIA,2012,15,2012-12-16,Sunday,13:00,JAX,3,MIA,24,Home,21,27,55718,201212160mia,2604
2012121606,2012_15_DEN_BAL,2012,15,2012-12-16,Sunday,13:00,DEN,34,BAL,17,Home,-17,51,55714,201212160rav,2600
2012121607,2012_15_IND_HOU,2012,15,2012-12-16,Sunday,13:00,IND,17,HOU,29,Home,12,46,55717,201212160htx,2603
2012121608,2012_15_DET_ARI,2012,15,2012-12-16,Sunday,16:05,DET,10,ARI,38,Home,28,48,55721,201212160crd,2601
2012121609,2012_15_CAR_SD,2012,15,2012-12-16,Sunday,16:05,CAR,31,SD,7,Home,-24,38,55723,201212160sdg,2599
2012121610,2012_15_SEA_BUF,2012,15,2012-12-16,Sunday,16:05,SEA,50,BUF,17,Home,-33,67,55722,201212160buf,2609
2012121611,2012_15_PIT_DAL,2012,15,2012-12-16,Sunday,16:25,PIT,24,DAL,27,Home,3,51,55724,201212160dal,2608
2012121612,2012_15_KC_OAK,2012,15,2012-12-16,Sunday,16:25,KC,0,OAK,15,Home,15,15,55725,201212160rai,2605
2012121613,2012_15_SF_NE,2012,15,2012-12-16,Sunday,20:20,SF,41,NE,34,Home,-7,75,55726,201212160nwe,2610
2012121700,2012_15_NYJ_TEN,2012,15,2012-12-17,Monday,20:30,NYJ,10,TEN,14,Home,4,24,55727,201212170oti,2613
2012122200,2012_16_ATL_DET,2012,16,2012-12-22,Saturday,20:30,ATL,31,DET,18,Home,-13,49,55728,201212220det,2614
2012122300,2012_16_TEN_GB,2012,16,2012-12-23,Sunday,13:00,TEN,7,GB,55,Home,48,62,55732,201212230gnb,2628
2012122301,2012_16_OAK_CAR,2012,16,2012-12-23,Sunday,13:00,OAK,6,CAR,17,Home,11,23,55730,201212230car,2624
2012122302,2012_16_BUF_MIA,2012,16,2012-12-23,Sunday,13:00,BUF,10,MIA,24,Home,14,34,55736,201212230mia,2615
2012122303,2012_16_CIN_PIT,2012,16,2012-12-23,Sunday,13:00,CIN,13,PIT,10,Home,-3,23,55738,201212230pit,2617
2012122304,2012_16_NE_JAX,2012,16,2012-12-23,Sunday,13:00,NE,23,JAX,16,Home,-7,39,55734,201212230jax,2621
2012122305,2012_16_IND_KC,2012,16,2012-12-23,Sunday,13:00,IND,20,KC,13,Home,-7,33,55735,201212230kan,2619
2012122306,2012_16_NO_DAL,2012,16,2012-12-23,Sunday,13:00,NO,34,DAL,31,Home,-3,65,55731,201212230dal,2622
2012122307,2012_16_WAS_PHI,2012,16,2012-12-23,Sunday,13:00,WAS,27,PHI,20,Home,-7,47,55737,201212230phi,2629
2012122308,2012_16_STL_TB,2012,16,2012-12-23,Sunday,13:00,STL,28,TB,13,Home,-15,41,55739,201212230tam,2627
2012122309,2012_16_NYG_BAL,2012,16,2012-12-23,Sunday,16:25,NYG,14,BAL,33,Home,19,47,55729,201212230rav,2623
2012122310,2012_16_MIN_HOU,2012,16,2012-12-23,Sunday,13:00,MIN,23,HOU,6,Home,-17,29,55733,201212230htx,2620
2012122311,2012_16_CLE_DEN,2012,16,2012-12-23,Sunday,16:05,CLE,12,DEN,34,Home,22,46,55740,201212230den,2618
2012122312,2012_16_CHI_ARI,2012,16,2012-12-23,Sunday,16:25,CHI,28,ARI,13,Home,-15,41,55741,201212230crd,2616
2012122313,2012_16_SF_SEA,2012,16,2012-12-23,Sunday,20:20,SF,13,SEA,42,Home,29,55,55742,201212230sea,2626
2012122314,2012_16_SD_NYJ,2012,16,2012-12-23,Sunday,13:00,SD,27,NYJ,17,Home,-10,44,55743,201212230nyj,2625
2012123000,2012_17_NYJ_BUF,2012,17,2012-12-30,Sunday,13:00,NYJ,9,BUF,28,Home,19,37,55745,201212300buf,2641
2012123001,2012_17_MIA_NE,2012,17,2012-12-30,Sunday,16:25,MIA,0,NE,28,Home,28,28,55750,201212300nwe,2640
2012123002,2012_17_BAL_CIN,2012,17,2012-12-30,Sunday,13:00,BAL,17,CIN,23,Home,6,40,55746,201212300cin,2631
2012123003,2012_17_CLE_PIT,2012,17,2012-12-30,Sunday,13:00,CLE,10,PIT,24,Home,14,34,55753,201212300pit,2634
2012123004,2012_17_HOU_IND,2012,17,2012-12-30,Sunday,13:00,HOU,16,IND,28,Home,12,44,55748,201212300clt,2637
2012123005,2012_17_JAX_TEN,2012,17,2012-12-30,Sunday,13:00,JAX,20,TEN,38,Home,18,58,55754,201212300oti,2638
2012123006,2012_17_PHI_NYG,2012,17,2012-12-30,Sunday,13:00,PHI,7,NYG,42,Home,35,49,55752,201212300nyg,2643
2012123007,2012_17_DAL_WAS,2012,17,2012-12-30,Sunday,20:20,DAL,18,WAS,28,Home,10,46,55755,201212300was,2635
2012123008,2012_17_CHI_DET,2012,17,2012-12-30,Sunday,13:00,CHI,26,DET,24,Home,-2,50,55747,201212300det,2633
2012123009,2012_17_GB_MIN,2012,17,2012-12-30,Sunday,16:25,GB,34,MIN,37,Home,3,71,55749,201212300min,2636
2012123010,2012_17_TB_ATL,2012,17,2012-12-30,Sunday,13:00,TB,22,ATL,17,Home,-5,39,55744,201212300atl,2645
2012123011,2012_17_CAR_NO,2012,17,2012-12-30,Sunday,13:00,CAR,44,NO,38,Home,-6,82,55751,201212300nor,2632
2012123012,2012_17_KC_DEN,2012,17,2012-12-30,Sunday,16:25,KC,3,DEN,38,Home,35,41,55756,201212300den,2639
2012123013,2012_17_OAK_SD,2012,17,2012-12-30,Sunday,16:25,OAK,21,SD,24,Home,3,45,55757,201212300sdg,2642
2012123014,2012_17_ARI_SF,2012,17,2012-12-30,Sunday,16:25,ARI,13,SF,27,Home,14,40,55758,201212300sfo,2630
2012123015,2012_17_STL_SEA,2012,17,2012-12-30,Sunday,16:25,STL,13,SEA,20,Home,7,33,55759,201212300sea,2644
2013010500,2012_18_CIN_HOU,2012,18,2013-01-05,Saturday,16:30,CIN,13,HOU,19,Home,6,32,55825,201301050htx,2646
2013010501,2012_18_MIN_GB,2012,18,2013-01-05,Saturday,20:00,MIN,10,GB,24,Home,14,34,55826,201301050gnb,2647
2013010600,2012_18_IND_BAL,2012,18,2013-01-06,Sunday,13:00,IND,9,BAL,24,Home,15,33,55827,201301060rav,2648
2013010601,2012_18_SEA_WAS,2012,18,2013-01-06,Sunday,16:30,SEA,24,WAS,14,Home,-10,38,55828,201301060was,2649
2013011200,2012_19_BAL_DEN,2012,19,2013-01-12,Saturday,16:30,BAL,38,DEN,35,Home,-3,73,55829,201301120den,2670
2013011201,2012_19_GB_SF,2012,19,2013-01-12,Saturday,20:00,GB,31,SF,45,Home,14,76,55830,201301120sfo,2671
2013011300,2012_19_HOU_NE,2012,19,2013-01-13,Sunday,16:30,HOU,28,NE,41,Home,13,69,55832,201301130nwe,2673
2013011301,2012_19_SEA_ATL,2012,19,2013-01-13,Sunday,13:00,SEA,28,ATL,30,Home,2,58,55831,201301130atl,2672
2013012000,2012_20_BAL_NE,2012,20,2013-01-20,Sunday,18:30,BAL,28,NE,13,Home,-15,41,55834,201301200nwe,2675
2013012001,2012_20_SF_ATL,2012,20,2013-01-20,Sunday,15:00,SF,28,ATL,24,Home,-4,52,55833,201301200atl,2674
2013020300,2012_21_BAL_SF,2012,21,2013-02-03,Sunday,18:30,BAL,34,SF,31,Neutral,-3,65,55835,201302030sfo,2676
2013090500,2013_01_BAL_DEN,2013,1,2013-09-05,Thursday,20:30,BAL,27,DEN,49,Home,22,76,55837,201309050den,2742
2013090800,2013_01_NE_BUF,2013,1,2013-09-08,Sunday,13:00,NE,23,BUF,21,Home,-2,44,55838,201309080buf,2743
2013090801,2013_01_SEA_CAR,2013,1,2013-09-08,Sunday,13:00,SEA,12,CAR,7,Home,-5,19,55839,201309080car,2744
2013090802,2013_01_CIN_CHI,2013,1,2013-09-08,Sunday,13:00,CIN,21,CHI,24,Home,3,45,55840,201309080chi,2745
2013090803,2013_01_MIA_CLE,2013,1,2013-09-08,Sunday,13:00,MIA,23,CLE,10,Home,-13,33,55841,201309080cle,2746
2013090804,2013_01_MIN_DET,2013,1,2013-09-08,Sunday,13:00,MIN,24,DET,34,Home,10,58,55842,201309080det,2747
2013090805,2013_01_OAK_IND,2013,1,2013-09-08,Sunday,13:00,OAK,17,IND,21,Home,4,38,55843,201309080clt,2748
2013090806,2013_01_KC_JAX,2013,1,2013-09-08,Sunday,13:00,KC,28,JAX,2,Home,-26,30,55844,201309080jax,2749
2013090807,2013_01_TB_NYJ,2013,1,2013-09-08,Sunday,13:00,TB,17,NYJ,18,Home,1,35,55846,201309080nyj,2751
2013090808,2013_01_ATL_NO,2013,1,2013-09-08,Sunday,13:00,ATL,17,NO,23,Home,6,40,55845,201309080nor,2750
2013090809,2013_01_TEN_PIT,2013,1,2013-09-08,Sunday,13:00,TEN,16,PIT,9,Home,-7,25,55847,201309080pit,2752
2013090810,2013_01_ARI_STL,2013,1,2013-09-08,Sunday,16:25,ARI,24,STL,27,Home,3,51,55848,201309080ram,2754
2013090811,2013_01_GB_SF,2013,1,2013-09-08,Sunday,16:25,GB,28,SF,34,Home,6,62,55849,201309080sfo,2753
2013090812,2013_01_NYG_DAL,2013,1,2013-09-08,Sunday,20:30,NYG,31,DAL,36,Home,5,67,55850,201309080dal,2755
2013090900,2013_01_PHI_WAS,2013,1,2013-09-09,Monday,19:00,PHI,33,WAS,27,Home,-6,60,55851,201309090was,2756
2013090901,2013_01_HOU_SD,2013,1,2013-09-09,Monday,22:15,HOU,31,SD,28,Home,-3,59,55852,201309090sdg,2757
2013091200,2013_02_NYJ_NE,2013,2,2013-09-12,Thursday,20:25,NYJ,10,NE,13,Home,3,23,55853,201309120nwe,2758
2013091500,2013_02_STL_ATL,2013,2,2013-09-15,Sunday,13:00,STL,24,ATL,31,Home,7,55,55854,201309150atl,2759
2013091501,2013_02_CLE_BAL,2013,2,2013-09-15,Sunday,13:00,CLE,6,BAL,14,Home,8,20,55855,201309150rav,2760
2013091502,2013_02_CAR_BUF,2013,2,2013-09-15,Sunday,13:00,CAR,23,BUF,24,Home,1,47,55856,201309150buf,2761
2013091503,2013_02_MIN_CHI,2013,2,2013-09-15,Sunday,13:00,MIN,30,CHI,31,Home,1,61,55857,201309150chi,2762
2013091504,2013_02_WAS_GB,2013,2,2013-09-15,Sunday,13:00,WAS,20,GB,38,Home,18,58,55858,201309150gnb,2763
2013091505,2013_02_TEN_HOU,2013,2,2013-09-15,Sunday,13:00,TEN,24,HOU,30,Home,6,54,55859,201309150htx,2764
2013091506,2013_02_MIA_IND,2013,2,2013-09-15,Sunday,13:00,MIA,24,IND,20,Home,-4,44,55860,201309150clt,2765
2013091507,2013_02_DAL_KC,2013,2,2013-09-15,Sunday,13:00,DAL,16,KC,17,Home,1,33,55861,201309150kan,2766
2013091508,2013_02_SD_PHI,2013,2,2013-09-15,Sunday,13:00,SD,33,PHI,30,Home,-3,63,55862,201309150phi,2767
2013091509,2013_02_DET_ARI,2013,2,2013-09-15,Sunday,16:05,DET,21,ARI,25,Home,4,46,55863,201309150crd,2768
2013091510,2013_02_NO_TB,2013,2,2013-09-15,Sunday,16:05,NO,16,TB,14,Home,-2,30,55864,201309150tam,2769
2013091511,2013_02_DEN_NYG,2013,2,2013-09-15,Sunday,16:25,DEN,41,NYG,23,Home,-18,64,55865,201309150nyg,2770
2013091512,2013_02_JAX_OAK,2013,2,2013-09-15,Sunday,16:25,JAX,9,OAK,19,Home,10,28,55866,201309150rai,2771
2013091513,2013_02_SF_SEA,2013,2,2013-09-15,Sunday,20:30,SF,3,SEA,29,Home,26,32,55867,201309150sea,2772
2013091600,2013_02_PIT_CIN,2013,2,2013-09-16,Monday,20:30,PIT,10,CIN,20,Home,10,30,55868,201309160cin,2773
2013091900,2013_03_KC_PHI,2013,3,2013-09-19,Thursday,20:25,KC,26,PHI,16,Home,-10,42,55869,201309190phi,2774
2013092200,2013_03_HOU_BAL,2013,3,2013-09-22,Sunday,13:00,HOU,9,BAL,30,Home,21,39,55870,201309220rav,2775
2013092201,2013_03_GB_CIN,2013,3,2013-09-22,Sunday,13:00,GB,30,CIN,34,Home,4,64,55871,201309220cin,2777
2013092202,2013_03_STL_DAL,2013,3,2013-09-22,Sunday,13:00,STL,7,DAL,31,Home,24,38,55873,201309220dal,2778
2013092203,2013_03_ATL_MIA,2013,3,2013-09-22,Sunday,16:05,ATL,23,MIA,27,Home,4,50,55879,201309220mia,2784
2013092204,2013_03_CLE_MIN,2013,3,2013-09-22,Sunday,13:00,CLE,31,MIN,27,Home,-4,58,55874,201309220min,2779
2013092205,2013_03_BUF_NYJ,2013,3,2013-09-22,Sunday,16:25,BUF,20,NYJ,27,Home,7,47,55880,201309220nyj,2785
2013092206,2013_03_TB_NE,2013,3,2013-09-22,Sunday,13:00,TB,3,NE,23,Home,20,26,55875,201309220nwe,2780
2013092207,2013_03_ARI_NO,2013,3,2013-09-22,Sunday,13:00,ARI,7,NO,31,Home,24,38,55876,201309220nor,2781
2013092208,2013_03_SD_TEN,2013,3,2013-09-22,Sunday,13:00,SD,17,TEN,20,Home,3,37,55877,201309220oti,2782
2013092209,2013_03_DET_WAS,2013,3,2013-09-22,Sunday,13:00,DET,27,WAS,20,Home,-7,47,55878,201309220was,2783
2013092210,2013_03_NYG_CAR,2013,3,2013-09-22,Sunday,13:00,NYG,0,CAR,38,Home,38,38,55872,201309220car,2776
2013092211,2013_03_IND_SF,2013,3,2013-09-22,Sunday,16:25,IND,27,SF,7,Home,-20,34,55881,201309220sfo,2786
2013092212,2013_03_JAX_SEA,2013,3,2013-09-22,Sunday,16:25,JAX,17,SEA,45,Home,28,62,55882,201309220sea,2787
2013092213,2013_03_CHI_PIT,2013,3,2013-09-22,Sunday,20:30,CHI,40,PIT,23,Home,-17,63,55883,201309220pit,2788
2013092300,2013_03_OAK_DEN,2013,3,2013-09-23,Monday,20:30,OAK,21,DEN,37,Home,16,58,55884,201309230den,2789
2013092600,2013_04_SF_STL,2013,4,2013-09-26,Thursday,20:25,SF,35,STL,11,Home,-24,46,55885,201309260ram,2790
2013092900,2013_04_BAL_BUF,2013,4,2013-09-29,Sunday,13:00,BAL,20,BUF,23,Home,3,43,55886,201309290buf,2791
2013092901,2013_04_CIN_CLE,2013,4,2013-09-29,Sunday,13:00,CIN,6,CLE,17,Home,11,23,55887,201309290cle,2792
2013092902,2013_04_CHI_DET,2013,4,2013-09-29,Sunday,13:00,CHI,32,DET,40,Home,8,72,55888,201309290det,2793
2013092903,2013_04_SEA_HOU,2013,4,2013-09-29,Sunday,13:00,SEA,23,HOU,20,Home,-3,43,55889,201309290htx,2794
2013092904,2013_04_IND_JAX,2013,4,2013-09-29,Sunday,13:00,IND,37,JAX,3,Home,-34,40,55890,201309290jax,2795
2013092905,2013_04_NYG_KC,2013,4,2013-09-29,Sunday,13:00,NYG,7,KC,31,Home,24,38,55891,201309290kan,2796
2013092906,2013_04_PIT_MIN,2013,4,2013-09-29,Sunday,13:00,PIT,27,MIN,34,Neutral,7,61,55892,201309290min,2797
2013092907,2013_04_ARI_TB,2013,4,2013-09-29,Sunday,13:00,ARI,13,TB,10,Home,-3,23,55893,201309290tam,2798
2013092908,2013_04_NYJ_TEN,2013,4,2013-09-29,Sunday,16:05,NYJ,13,TEN,38,Home,25,51,55894,201309290oti,2799
2013092909,2013_04_PHI_DEN,2013,4,2013-09-29,Sunday,16:25,PHI,20,DEN,52,Home,32,72,55895,201309290den,2800
2013092910,2013_04_WAS_OAK,2013,4,2013-09-29,Sunday,16:25,WAS,24,OAK,14,Home,-10,38,55896,201309290rai,2801
2013092911,2013_04_DAL_SD,2013,4,2013-09-29,Sunday,16:25,DAL,21,SD,30,Home,9,51,55897,201309290sdg,2802
2013092912,2013_04_NE_ATL,2013,4,2013-09-29,Sunday,20:30,NE,30,ATL,23,Home,-7,53,55898,201309290atl,2803
2013093000,2013_04_MIA_NO,2013,4,2013-09-30,Monday,20:30,MIA,17,NO,38,Home,21,55,55899,201309300nor,2804
2013100300,2013_05_BUF_CLE,2013,5,2013-10-03,Thursday,20:25,BUF,24,CLE,37,Home,13,61,55900,201310030cle,2805
2013100600,2013_05_NO_CHI,2013,5,2013-10-06,Sunday,13:00,NO,26,CHI,18,Home,-8,44,55901,201310060chi,2806
2013100601,2013_05_NE_CIN,2013,5,2013-10-06,Sunday,13:00,NE,6,CIN,13,Home,7,19,55902,201310060cin,2807
2013100602,2013_05_DET_GB,2013,5,2013-10-06,Sunday,13:00,DET,9,GB,22,Home,13,31,55903,201310060gnb,2808
2013100603,2013_05_SEA_IND,2013,5,2013-10-06,Sunday,13:00,SEA,28,IND,34,Home,6,62,55904,201310060clt,2809
2013100604,2013_05_BAL_MIA,2013,5,2013-10-06,Sunday,13:00,BAL,26,MIA,23,Home,-3,49,55905,201310060mia,2810
2013100605,2013_05_PHI_NYG,2013,5,2013-10-06,Sunday,13:00,PHI,36,NYG,21,Home,-15,57,55906,201310060nyg,2811
2013100606,2013_05_JAX_STL,2013,5,2013-10-06,Sunday,13:00,JAX,20,STL,34,Home,14,54,55907,201310060ram,2812
2013100607,2013_05_KC_TEN,2013,5,2013-10-06,Sunday,13:00,KC,26,TEN,17,Home,-9,43,55908,201310060oti,2813
2013100608,2013_05_CAR_ARI,2013,5,2013-10-06,Sunday,16:05,CAR,6,ARI,22,Home,16,28,55909,201310060crd,2814
2013100609,2013_05_DEN_DAL,2013,5,2013-10-06,Sunday,16:25,DEN,51,DAL,48,Home,-3,99,55910,201310060dal,2815
2013100610,2013_05_SD_OAK,2013,5,2013-10-06,Sunday,23:30,SD,17,OAK,27,Home,10,44,55911,201310060rai,2816
2013100611,2013_05_HOU_SF,2013,5,2013-10-06,Sunday,20:30,HOU,3,SF,34,Home,31,37,55912,201310060sfo,2817
2013100700,2013_05_NYJ_ATL,2013,5,2013-10-07,Monday,20:30,NYJ,30,ATL,28,Home,-2,58,55913,201310070atl,2818
2013101000,2013_06_NYG_CHI,2013,6,2013-10-10,Thursday,20:25,NYG,21,CHI,27,Home,6,48,55914,201310100chi,2819
2013101300,2013_06_GB_BAL,2013,6,2013-10-13,Sunday,13:00,GB,19,BAL,17,Home,-2,36,55915,201310130rav,2820
2013101301,2013_06_CIN_BUF,2013,6,2013-10-13,Sunday,13:00,CIN,27,BUF,24,Home,-3,51,55916,201310130buf,2821
2013101302,2013_06_DET_CLE,2013,6,2013-10-13,Sunday,13:00,DET,31,CLE,17,Home,-14,48,55917,201310130cle,2822
2013101303,2013_06_STL_HOU,2013,6,2013-10-13,Sunday,13:00,STL,38,HOU,13,Home,-25,51,55918,201310130htx,2823
2013101304,2013_06_OAK_KC,2013,6,2013-10-13,Sunday,13:00,OAK,7,KC,24,Home,17,31,55919,201310130kan,2824
2013101305,2013_06_CAR_MIN,2013,6,2013-10-13,Sunday,13:00,CAR,35,MIN,10,Home,-25,45,55920,201310130min,2825
2013101306,2013_06_PIT_NYJ,2013,6,2013-10-13,Sunday,13:00,PIT,19,NYJ,6,Home,-13,25,55921,201310130nyj,2826
2013101307,2013_06_PHI_TB,2013,6,2013-10-13,Sunday,13:00,PHI,31,TB,20,Home,-11,51,55922,201310130tam,2827
2013101308,2013_06_JAX_DEN,2013,6,2013-10-13,Sunday,16:05,JAX,19,DEN,35,Home,16,54,55923,201310130den,2828
2013101309,2013_06_TEN_SEA,2013,6,2013-10-13,Sunday,16:05,TEN,13,SEA,20,Home,7,33,55924,201310130sea,2829
2013101310,2013_06_NO_NE,2013,6,2013-10-13,Sunday,16:25,NO,27,NE,30,Home,3,57,55925,201310130nwe,2830
2013101311,2013_06_ARI_SF,2013,6,2013-10-13,Sunday,16:25,ARI,20,SF,32,Home,12,52,55926,201310130sfo,2831
2013101312,2013_06_WAS_DAL,2013,6,2013-10-13,Sunday,20:30,WAS,16,DAL,31,Home,15,47,55927,201310130dal,2832
2013101400,2013_06_IND_SD,2013,6,2013-10-14,Monday,20:30,IND,9,SD,19,Home,10,28,55928,201310140sdg,2833
2013101700,2013_07_SEA_ARI,2013,7,2013-10-17,Thursday,20:25,SEA,34,ARI,22,Home,-12,56,55929,201310170crd,2834
2013102000,2013_07_TB_ATL,2013,7,2013-10-20,Sunday,13:00,TB,23,ATL,31,Home,8,54,55930,201310200atl,2835
2013102001,2013_07_STL_CAR,2013,7,2013-10-20,Sunday,13:00,STL,15,CAR,30,Home,15,45,55931,201310200car,2836
2013102002,2013_07_CIN_DET,2013,7,2013-10-20,Sunday,13:00,CIN,13,DET,31,Home,18,44,55932,201310200det,2837
2013102003,2013_07_CLE_GB,2013,7,2013-10-20,Sunday,16:25,CLE,13,GB,31,Home,18,44,55940,201310200gnb,2845
2013102004,2013_07_SD_JAX,2013,7,2013-10-20,Sunday,13:00,SD,24,JAX,6,Home,-18,30,55933,201310200jax,2838
2013102005,2013_07_HOU_KC,2013,7,2013-10-20,Sunday,16:25,HOU,16,KC,17,Home,1,33,55934,201310200kan,2839
2013102006,2013_07_BUF_MIA,2013,7,2013-10-20,Sunday,13:00,BUF,23,MIA,21,Home,-2,44,55935,201310200mia,2840
2013102007,2013_07_NE_NYJ,2013,7,2013-10-20,Sunday,13:00,NE,27,NYJ,30,Home,3,57,55936,201310200nyj,2841
2013102008,2013_07_DAL_PHI,2013,7,2013-10-20,Sunday,13:00,DAL,17,PHI,3,Home,-14,20,55937,201310200phi,2842
2013102009,2013_07_CHI_WAS,2013,7,2013-10-20,Sunday,13:00,CHI,41,WAS,45,Home,4,86,55938,201310200was,2843
2013102010,2013_07_SF_TEN,2013,7,2013-10-20,Sunday,16:05,SF,31,TEN,17,Home,-14,48,55939,201310200oti,2844
2013102011,2013_07_BAL_PIT,2013,7,2013-10-20,Sunday,16:25,BAL,16,PIT,19,Home,3,35,55941,201310200pit,2846
2013102012,2013_07_DEN_IND,2013,7,2013-10-20,Sunday,20:30,DEN,33,IND,39,Home,6,72,55942,201310200clt,2847
2013102100,2013_07_MIN_NYG,2013,7,2013-10-21,Monday,20:30,MIN,7,NYG,23,Home,16,30,55943,201310210nyg,2848
2013102400,2013_08_CAR_TB,2013,8,2013-10-24,Thursday,20:25,CAR,31,TB,13,Home,-18,44,55944,201310240tam,2849
2013102700,2013_08_DAL_DET,2013,8,2013-10-27,Sunday,13:00,DAL,30,DET,31,Home,1,61,55945,201310270det,2850
2013102701,2013_08_SF_JAX,2013,8,2013-10-27,Sunday,13:00,SF,42,JAX,10,Neutral,-32,52,55946,201310270jax,2851
2013102702,2013_08_CLE_KC,2013,8,2013-10-27,Sunday,13:00,CLE,17,KC,23,Home,6,40,55947,201310270kan,2852
2013102703,2013_08_MIA_NE,2013,8,2013-10-27,Sunday,13:00,MIA,17,NE,27,Home,10,44,55948,201310270nwe,2853
2013102704,2013_08_BUF_NO,2013,8,2013-10-27,Sunday,13:00,BUF,17,NO,35,Home,18,52,55949,201310270nor,2854
2013102705,2013_08_NYG_PHI,2013,8,2013-10-27,Sunday,13:00,NYG,15,PHI,7,Home,-8,22,55950,201310270phi,2855
2013102706,2013_08_PIT_OAK,2013,8,2013-10-27,Sunday,16:05,PIT,18,OAK,21,Home,3,39,55951,201310270rai,2857
2013102707,2013_08_NYJ_CIN,2013,8,2013-10-27,Sunday,16:05,NYJ,9,CIN,49,Home,40,58,55952,201310270cin,2856
2013102708,2013_08_ATL_ARI,2013,8,2013-10-27,Sunday,16:25,ATL,13,ARI,27,Home,14,40,55953,201310270crd,2858
2013102709,2013_08_WAS_DEN,2013,8,2013-10-27,Sunday,16:25,WAS,21,DEN,45,Home,24,66,55954,201310270den,2859
2013102710,2013_08_GB_MIN,2013,8,2013-10-27,Sunday,20:30,GB,44,MIN,31,Home,-13,75,55955,201310270min,2860
2013102800,2013_08_SEA_STL,2013,8,2013-10-28,Monday,20:30,SEA,14,STL,9,Home,-5,23,55956,201310280ram,2861
2013103100,2013_09_CIN_MIA,2013,9,2013-10-31,Thursday,20:25,CIN,20,MIA,22,Home,2,42,55957,201310310mia,2862
2013110300,2013_09_KC_BUF,2013,9,2013-11-03,Sunday,13:00,KC,23,BUF,13,Home,-10,36,55958,201311030buf,2863
2013110301,2013_09_ATL_CAR,2013,9,2013-11-03,Sunday,13:00,ATL,10,CAR,34,Home,24,44,55959,201311030car,2864
2013110302,2013_09_MIN_DAL,2013,9,2013-11-03,Sunday,13:00,MIN,23,DAL,27,Home,4,50,55960,201311030dal,2865
2013110303,2013_09_NO_NYJ,2013,9,2013-11-03,Sunday,13:00,NO,20,NYJ,26,Home,6,46,55961,201311030nyj,2866
2013110304,2013_09_TEN_STL,2013,9,2013-11-03,Sunday,13:00,TEN,28,STL,21,Home,-7,49,55962,201311030ram,2867
2013110305,2013_09_SD_WAS,2013,9,2013-11-03,Sunday,13:00,SD,24,WAS,30,Home,6,54,55963,201311030was,2868
2013110306,2013_09_PHI_OAK,2013,9,2013-11-03,Sunday,16:05,PHI,49,OAK,20,Home,-29,69,55964,201311030rai,2869
2013110307,2013_09_TB_SEA,2013,9,2013-11-03,Sunday,16:05,TB,24,SEA,27,Home,3,51,55965,201311030sea,2870
2013110308,2013_09_BAL_CLE,2013,9,2013-11-03,Sunday,16:25,BAL,18,CLE,24,Home,6,42,55966,201311030cle,2871
2013110309,2013_09_PIT_NE,2013,9,2013-11-03,Sunday,16:25,PIT,31,NE,55,Home,24,86,55967,201311030nwe,2872
2013110310,2013_09_IND_HOU,2013,9,2013-11-03,Sunday,20:30,IND,27,HOU,24,Home,-3,51,55968,201311030htx,2873
2013110400,2013_09_CHI_GB,2013,9,2013-11-04,Monday,20:30,CHI,27,GB,20,Home,-7,47,55969,201311040gnb,2874
2013110700,2013_10_WAS_MIN,2013,10,2013-11-07,Thursday,20:25,WAS,27,MIN,34,Home,7,61,55970,201311070min,2875
2013111000,2013_10_SEA_ATL,2013,10,2013-11-10,Sunday,13:00,SEA,33,ATL,10,Home,-23,43,55971,201311100atl,2877
2013111001,2013_10_CIN_BAL,2013,10,2013-11-10,Sunday,13:00,CIN,17,BAL,20,Home,3,37,55972,201311100rav,2878
2013111002,2013_10_DET_CHI,2013,10,2013-11-10,Sunday,13:00,DET,21,CHI,19,Home,-2,40,55973,201311100chi,2879
2013111003,2013_10_PHI_GB,2013,10,2013-11-10,Sunday,13:00,PHI,27,GB,13,Home,-14,40,55974,201311100gnb,2880
2013111004,2013_10_STL_IND,2013,10,2013-11-10,Sunday,13:00,STL,38,IND,8,Home,-30,46,55975,201311100clt,2881
2013111005,2013_10_OAK_NYG,2013,10,2013-11-10,Sunday,13:00,OAK,20,NYG,24,Home,4,44,55976,201311100nyg,2882
2013111006,2013_10_BUF_PIT,2013,10,2013-11-10,Sunday,13:00,BUF,10,PIT,23,Home,13,33,55977,201311100pit,2876
2013111007,2013_10_JAX_TEN,2013,10,2013-11-10,Sunday,13:00,JAX,29,TEN,27,Home,-2,56,55978,201311100oti,2883
2013111008,2013_10_CAR_SF,2013,10,2013-11-10,Sunday,16:05,CAR,10,SF,9,Home,-1,19,55979,201311100sfo,2884
2013111009,2013_10_HOU_ARI,2013,10,2013-11-10,Sunday,16:25,HOU,24,ARI,27,Home,3,51,55980,201311100crd,2885
2013111010,2013_10_DEN_SD,2013,10,2013-11-10,Sunday,16:25,DEN,28,SD,20,Home,-8,48,55981,201311100sdg,2886
2013111011,2013_10_DAL_NO,2013,10,2013-11-10,Sunday,20:30,DAL,17,NO,49,Home,32,66,55982,201311100nor,2887
2013111100,2013_10_MIA_TB,2013,10,2013-11-11,Monday,20:30,MIA,19,TB,22,Home,3,41,55983,201311110tam,2888
2013111400,2013_11_IND_TEN,2013,11,2013-11-14,Thursday,20:25,IND,30,TEN,27,Home,-3,57,55984,201311140oti,2889
2013111700,2013_11_NYJ_BUF,2013,11,2013-11-17,Sunday,13:00,NYJ,14,BUF,37,Home,23,51,55985,201311170buf,2890
2013111701,2013_11_BAL_CHI,2013,11,2013-11-17,Sunday,13:00,BAL,20,CHI,23,Home,3,43,55986,201311170chi,2891
2013111702,2013_11_CLE_CIN,2013,11,2013-11-17,Sunday,13:00,CLE,20,CIN,41,Home,21,61,55987,201311170cin,2892
2013111703,2013_11_OAK_HOU,2013,11,2013-11-17,Sunday,13:00,OAK,28,HOU,23,Home,-5,51,55988,201311170htx,2893
2013111704,2013_11_ARI_JAX,2013,11,2013-11-17,Sunday,13:00,ARI,27,JAX,14,Home,-13,41,55989,201311170jax,2894
2013111705,2013_11_SD_MIA,2013,11,2013-11-17,Sunday,16:05,SD,16,MIA,20,Home,4,36,55990,201311170mia,2895
2013111706,2013_11_WAS_PHI,2013,11,2013-11-17,Sunday,13:00,WAS,16,PHI,24,Home,8,40,55991,201311170phi,2896
2013111707,2013_11_DET_PIT,2013,11,2013-11-17,Sunday,13:00,DET,27,PIT,37,Home,10,64,55992,201311170pit,2897
2013111708,2013_11_ATL_TB,2013,11,2013-11-17,Sunday,13:00,ATL,28,TB,41,Home,13,69,55993,201311170tam,2898
2013111709,2013_11_KC_DEN,2013,11,2013-11-17,Sunday,20:30,KC,17,DEN,27,Home,10,44,55994,201311170den,2899
2013111710,2013_11_SF_NO,2013,11,2013-11-17,Sunday,16:25,SF,20,NO,23,Home,3,43,55995,201311170nor,2900
2013111711,2013_11_MIN_SEA,2013,11,2013-11-17,Sunday,16:25,MIN,20,SEA,41,Home,21,61,55996,201311170sea,2901
2013111712,2013_11_GB_NYG,2013,11,2013-11-17,Sunday,16:25,GB,13,NYG,27,Home,14,40,55997,201311170nyg,2902
2013111800,2013_11_NE_CAR,2013,11,2013-11-18,Monday,20:30,NE,20,CAR,24,Home,4,44,55998,201311180car,2903
2013112100,2013_12_NO_ATL,2013,12,2013-11-21,Thursday,20:25,NO,17,ATL,13,Home,-4,30,55999,201311210atl,2904
2013112400,2013_12_NYJ_BAL,2013,12,2013-11-24,Sunday,13:00,NYJ,3,BAL,19,Home,16,22,56000,201311240rav,2905
2013112401,2013_12_PIT_CLE,2013,12,2013-11-24,Sunday,13:00,PIT,27,CLE,11,Home,-16,38,56001,201311240cle,2906
2013112402,2013_12_TB_DET,2013,12,2013-11-24,Sunday,13:00,TB,24,DET,21,Home,-3,45,56002,201311240det,2907
2013112403,2013_12_MIN_GB,2013,12,2013-11-24,Sunday,13:00,MIN,26,GB,26,Home,0,52,56003,201311240gnb,2908
2013112404,2013_12_JAX_HOU,2013,12,2013-11-24,Sunday,13:00,JAX,13,HOU,6,Home,-7,19,56004,201311240htx,2909
2013112405,2013_12_SD_KC,2013,12,2013-11-24,Sunday,13:00,SD,41,KC,38,Home,-3,79,56005,201311240kan,2910
2013112406,2013_12_CAR_MIA,2013,12,2013-11-24,Sunday,13:00,CAR,20,MIA,16,Home,-4,36,56006,201311240mia,2911
2013112407,2013_12_CHI_STL,2013,12,2013-11-24,Sunday,13:00,CHI,21,STL,42,Home,21,63,56007,201311240ram,2912
2013112408,2013_12_IND_ARI,2013,12,2013-11-24,Sunday,16:05,IND,11,ARI,40,Home,29,51,56008,201311240crd,2913
2013112409,2013_12_TEN_OAK,2013,12,2013-11-24,Sunday,16:05,TEN,23,OAK,19,Home,-4,42,56009,201311240rai,2914
2013112410,2013_12_DAL_NYG,2013,12,2013-11-24,Sunday,16:25,DAL,24,NYG,21,Home,-3,45,56010,201311240nyg,2915
2013112411,2013_12_DEN_NE,2013,12,2013-11-24,Sunday,20:30,DEN,31,NE,34,Home,3,65,56011,201311240nwe,2916
2013112500,2013_12_SF_WAS,2013,12,2013-11-25,Monday,20:30,SF,27,WAS,6,Home,-21,33,56012,201311250was,2917
2013112800,2013_13_GB_DET,2013,13,2013-11-28,Thursday,12:30,GB,10,DET,40,Home,30,50,56013,201311280det,2918
2013112801,2013_13_OAK_DAL,2013,13,2013-11-28,Thursday,16:30,OAK,24,DAL,31,Home,7,55,56014,201311280dal,2919
2013112802,2013_13_PIT_BAL,2013,13,2013-11-28,Thursday,20:30,PIT,20,BAL,22,Home,2,42,56015,201311280rav,2920
2013120100,2013_13_TB_CAR,2013,13,2013-12-01,Sunday,13:00,TB,6,CAR,27,Home,21,33,56016,201312010car,2921
2013120101,2013_13_JAX_CLE,2013,13,2013-12-01,Sunday,13:00,JAX,32,CLE,28,Home,-4,60,56017,201312010cle,2922
2013120102,2013_13_TEN_IND,2013,13,2013-12-01,Sunday,13:00,TEN,14,IND,22,Home,8,36,56018,201312010clt,2923
2013120103,2013_13_DEN_KC,2013,13,2013-12-01,Sunday,16:25,DEN,35,KC,28,Home,-7,63,56019,201312010kan,2924
2013120104,2013_13_CHI_MIN,2013,13,2013-12-01,Sunday,13:00,CHI,20,MIN,23,Home,3,43,56020,201312010min,2925
2013120105,2013_13_MIA_NYJ,2013,13,2013-12-01,Sunday,13:00,MIA,23,NYJ,3,Home,-20,26,56021,201312010nyj,2926
2013120106,2013_13_ARI_PHI,2013,13,2013-12-01,Sunday,13:00,ARI,21,PHI,24,Home,3,45,56022,201312010phi,2927
2013120107,2013_13_ATL_BUF,2013,13,2013-12-01,Sunday,16:05,ATL,34,BUF,31,Neutral,-3,65,56023,201312010buf,2928
2013120108,2013_13_STL_SF,2013,13,2013-12-01,Sunday,16:05,STL,13,SF,23,Home,10,36,56024,201312010sfo,2929
2013120109,2013_13_NE_HOU,2013,13,2013-12-01,Sunday,13:00,NE,34,HOU,31,Home,-3,65,56025,201312010htx,2930
2013120110,2013_13_CIN_SD,2013,13,2013-12-01,Sunday,16:25,CIN,17,SD,10,Home,-7,27,56026,201312010sdg,2931
2013120111,2013_13_NYG_WAS,2013,13,2013-12-01,Sunday,20:30,NYG,24,WAS,17,Home,-7,41,56027,201312010was,2932
2013120200,2013_13_NO_SEA,2013,13,2013-12-02,Monday,20:30,NO,7,SEA,34,Home,27,41,56028,201312020sea,2933
2013120500,2013_14_HOU_JAX,2013,14,2013-12-05,Thursday,20:25,HOU,20,JAX,27,Home,7,47,56029,201312050jax,2934
2013120800,2013_14_MIN_BAL,2013,14,2013-12-08,Sunday,13:00,MIN,26,BAL,29,Home,3,55,56030,201312080rav,2935
2013120801,2013_14_IND_CIN,2013,14,2013-12-08,Sunday,13:00,IND,28,CIN,42,Home,14,70,56031,201312080cin,2936
2013120802,2013_14_CLE_NE,2013,14,2013-12-08,Sunday,13:00,CLE,26,NE,27,Home,1,53,56032,201312080nwe,2937
2013120803,2013_14_OAK_NYJ,2013,14,2013-12-08,Sunday,13:00,OAK,27,NYJ,37,Home,10,64,56033,201312080nyj,2939
2013120804,2013_14_CAR_NO,2013,14,2013-12-08,Sunday,20:30,CAR,13,NO,31,Home,18,44,56034,201312080nor,2938
2013120805,2013_14_DET_PHI,2013,14,2013-12-08,Sunday,13:00,DET,20,PHI,34,Home,14,54,56035,201312080phi,2940
2013120806,2013_14_MIA_PIT,2013,14,2013-12-08,Sunday,13:00,MIA,34,PIT,28,Home,-6,62,56036,201312080pit,2941
2013120807,2013_14_BUF_TB,2013,14,2013-12-08,Sunday,13:00,BUF,6,TB,27,Home,21,33,56037,201312080tam,2942
2013120808,2013_14_KC_WAS,2013,14,2013-12-08,Sunday,13:00,KC,45,WAS,10,Home,-35,55,56038,201312080was,2943
2013120809,2013_14_TEN_DEN,2013,14,2013-12-08,Sunday,16:05,TEN,28,DEN,51,Home,23,79,56039,201312080den,2944
2013120810,2013_14_STL_ARI,2013,14,2013-12-08,Sunday,16:25,STL,10,ARI,30,Home,20,40,56040,201312080crd,2945
2013120811,2013_14_NYG_SD,2013,14,2013-12-08,Sunday,16:25,NYG,14,SD,37,Home,23,51,56041,201312080sdg,2946
2013120812,2013_14_SEA_SF,2013,14,2013-12-08,Sunday,16:25,SEA,17,SF,19,Home,2,36,56042,201312080sfo,2947
2013120813,2013_14_ATL_GB,2013,14,2013-12-08,Sunday,13:00,ATL,21,GB,22,Home,1,43,56043,201312080gnb,2948
2013120900,2013_14_DAL_CHI,2013,14,2013-12-09,Monday,20:30,DAL,28,CHI,45,Home,17,73,56044,201312090chi,2949
2013121200,2013_15_SD_DEN,2013,15,2013-12-12,Thursday,20:25,SD,27,DEN,20,Home,-7,47,56045,201312120den,2950
2013121500,2013_15_WAS_ATL,2013,15,2013-12-15,Sunday,13:00,WAS,26,ATL,27,Home,1,53,56046,201312150atl,2951
2013121501,2013_15_CHI_CLE,2013,15,2013-12-15,Sunday,13:00,CHI,38,CLE,31,Home,-7,69,56047,201312150cle,2952
2013121502,2013_15_HOU_IND,2013,15,2013-12-15,Sunday,13:00,HOU,3,IND,25,Home,22,28,56048,201312150clt,2953
2013121503,2013_15_BUF_JAX,2013,15,2013-12-15,Sunday,13:00,BUF,27,JAX,20,Home,-7,47,56049,201312150jax,2954
2013121504,2013_15_NE_MIA,2013,15,2013-12-15,Sunday,13:00,NE,20,MIA,24,Home,4,44,56050,201312150mia,2955
2013121505,2013_15_PHI_MIN,2013,15,2013-12-15,Sunday,13:00,PHI,30,MIN,48,Home,18,78,56051,201312150min,2956
2013121506,2013_15_SEA_NYG,2013,15,2013-12-15,Sunday,13:00,SEA,23,NYG,0,Home,-23,23,56052,201312150nyg,2957
2013121507,2013_15_NO_STL,2013,15,2013-12-15,Sunday,16:25,NO,16,STL,27,Home,11,43,56053,201312150ram,2958
2013121508,2013_15_SF_TB,2013,15,2013-12-15,Sunday,13:00,SF,33,TB,14,Home,-19,47,56054,201312150tam,2959
2013121509,2013_15_ARI_TEN,2013,15,2013-12-15,Sunday,16:25,ARI,37,TEN,34,Home,-3,71,56055,201312150oti,2960
2013121510,2013_15_NYJ_CAR,2013,15,2013-12-15,Sunday,16:05,NYJ,20,CAR,30,Home,10,50,56056,201312150car,2961
2013121511,2013_15_KC_OAK,2013,15,2013-12-15,Sunday,16:05,KC,56,OAK,31,Home,-25,87,56057,201312150rai,2962
2013121512,2013_15_GB_DAL,2013,15,2013-12-15,Sunday,16:25,GB,37,DAL,36,Home,-1,73,56058,201312150dal,2963
2013121513,2013_15_CIN_PIT,2013,15,2013-12-15,Sunday,20:30,CIN,20,PIT,30,Home,10,50,56059,201312150pit,2964
2013121600,2013_15_BAL_DET,2013,15,2013-12-16,Monday,20:30,BAL,18,DET,16,Home,-2,34,56060,201312160det,2965
2013122200,2013_16_MIA_BUF,2013,16,2013-12-22,Sunday,13:00,MIA,0,BUF,19,Home,19,19,56061,201312220buf,2966
2013122201,2013_16_NO_CAR,2013,16,2013-12-22,Sunday,13:00,NO,13,CAR,17,Home,4,30,56062,201312220car,2967
2013122202,2013_16_MIN_CIN,2013,16,2013-12-22,Sunday,13:00,MIN,14,CIN,42,Home,28,56,56063,201312220cin,2968
2013122203,2013_16_DEN_HOU,2013,16,2013-12-22,Sunday,13:00,DEN,37,HOU,13,Home,-24,50,56064,201312220htx,2969
2013122204,2013_16_TEN_JAX,2013,16,2013-12-22,Sunday,13:00,TEN,20,JAX,16,Home,-4,36,56065,201312220jax,2970
2013122205,2013_16_IND_KC,2013,16,2013-12-22,Sunday,13:00,IND,23,KC,7,Home,-16,30,56066,201312220kan,2971
2013122206,2013_16_CLE_NYJ,2013,16,2013-12-22,Sunday,13:00,CLE,13,NYJ,24,Home,11,37,56067,201312220nyj,2972
2013122207,2013_16_CHI_PHI,2013,16,2013-12-22,Sunday,20:30,CHI,11,PHI,54,Home,43,65,56068,201312220phi,2973
2013122208,2013_16_TB_STL,2013,16,2013-12-22,Sunday,13:00,TB,13,STL,23,Home,10,36,56069,201312220ram,2974
2013122209,2013_16_DAL_WAS,2013,16,2013-12-22,Sunday,13:00,DAL,24,WAS,23,Home,-1,47,56070,201312220was,2975
2013122210,2013_16_NYG_DET,2013,16,2013-12-22,Sunday,16:05,NYG,23,DET,20,Home,-3,43,56071,201312220det,2976
2013122211,2013_16_ARI_SEA,2013,16,2013-12-22,Sunday,16:05,ARI,17,SEA,10,Home,-7,27,56072,201312220sea,2977
2013122212,2013_16_PIT_GB,2013,16,2013-12-22,Sunday,16:25,PIT,38,GB,31,Home,-7,69,56073,201312220gnb,2978
2013122213,2013_16_OAK_SD,2013,16,2013-12-22,Sunday,16:25,OAK,13,SD,26,Home,13,39,56074,201312220sdg,2979
2013122214,2013_16_NE_BAL,2013,16,2013-12-22,Sunday,16:25,NE,41,BAL,7,Home,-34,48,56075,201312220rav,2980
2013122300,2013_16_ATL_SF,2013,16,2013-12-23,Monday,20:30,ATL,24,SF,34,Home,10,58,56076,201312230sfo,2981
2013122900,2013_17_CAR_ATL,2013,17,2013-12-29,Sunday,13:00,CAR,21,ATL,20,Home,-1,41,56077,201312290atl,2982
2013122901,2013_17_GB_CHI,2013,17,2013-12-29,Sunday,16:25,GB,33,CHI,28,Home,-5,61,56078,201312290chi,2983
2013122902,2013_17_BAL_CIN,2013,17,2013-12-29,Sunday,13:00,BAL,17,CIN,34,Home,17,51,56079,201312290cin,2984
2013122903,2013_17_PHI_DAL,2013,17,2013-12-29,Sunday,20:30,PHI,24,DAL,22,Home,-2,46,56080,201312290dal,2985
2013122904,2013_17_JAX_IND,2013,17,2013-12-29,Sunday,13:00,JAX,10,IND,30,Home,20,40,56081,201312290clt,2986
2013122905,2013_17_NYJ_MIA,2013,17,2013-12-29,Sunday,13:00,NYJ,20,MIA,7,Home,-13,27,56082,201312290mia,2987
2013122906,2013_17_DET_MIN,2013,17,2013-12-29,Sunday,13:00,DET,13,MIN,14,Home,1,27,56083,201312290min,2988
2013122907,2013_17_BUF_NE,2013,17,2013-12-29,Sunday,16:25,BUF,20,NE,34,Home,14,54,56084,201312290nwe,2989
2013122908,2013_17_TB_NO,2013,17,2013-12-29,Sunday,16:25,TB,17,NO,42,Home,25,59,56085,201312290nor,2990
2013122909,2013_17_WAS_NYG,2013,17,2013-12-29,Sunday,13:00,WAS,6,NYG,20,Home,14,26,56086,201312290nyg,2991
2013122910,2013_17_CLE_PIT,2013,17,2013-12-29,Sunday,13:00,CLE,7,PIT,20,Home,13,27,56087,201312290pit,2992
2013122911,2013_17_HOU_TEN,2013,17,2013-12-29,Sunday,13:00,HOU,10,TEN,16,Home,6,26,56088,201312290oti,2993
2013122912,2013_17_SF_ARI,2013,17,2013-12-29,Sunday,16:25,SF,23,ARI,20,Home,-3,43,56089,201312290crd,2994
2013122913,2013_17_DEN_OAK,2013,17,2013-12-29,Sunday,16:25,DEN,34,OAK,14,Home,-20,48,56090,201312290rai,2995
2013122914,2013_17_KC_SD,2013,17,2013-12-29,Sunday,16:25,KC,24,SD,27,Home,3,51,56091,201312290sdg,2996
2013122915,2013_17_STL_SEA,2013,17,2013-12-29,Sunday,16:25,STL,9,SEA,27,Home,18,36,56092,201312290sea,2997
2014010400,2013_18_KC_IND,2013,18,2014-01-04,Saturday,16:35,KC,44,IND,45,Home,1,89,56158,201401040clt,2998
2014010401,2013_18_NO_PHI,2013,18,2014-01-04,Saturday,20:10,NO,26,PHI,24,Home,-2,50,56159,201401040phi,2999
2014010500,2013_18_SD_CIN,2013,18,2014-01-05,Sunday,13:05,SD,27,CIN,10,Home,-17,37,56160,201401050cin,3000
2014010501,2013_18_SF_GB,2013,18,2014-01-05,Sunday,16:40,SF,23,GB,20,Home,-3,43,56161,201401050gnb,3001
2014011100,2013_19_NO_SEA,2013,19,2014-01-11,Saturday,16:35,NO,15,SEA,23,Home,8,38,56162,201401110sea,3002
2014011101,2013_19_IND_NE,2013,19,2014-01-11,Saturday,20:15,IND,22,NE,43,Home,21,65,56163,201401110nwe,3003
2014011200,2013_19_SF_CAR,2013,19,2014-01-12,Sunday,13:05,SF,23,CAR,10,Home,-13,33,56164,201401120car,3004
2014011201,2013_19_SD_DEN,2013,19,2014-01-12,Sunday,16:40,SD,17,DEN,24,Home,7,41,56165,201401120den,3005
2014011900,2013_20_NE_DEN,2013,20,2014-01-19,Sunday,15:00,NE,16,DEN,26,Home,10,42,56166,201401190den,3006
2014011901,2013_20_SF_SEA,2013,20,2014-01-19,Sunday,18:30,SF,17,SEA,23,Home,6,40,56167,201401190sea,3007
2014020200,2013_21_SEA_DEN,2013,21,2014-02-02,Sunday,18:25,SEA,43,DEN,8,Neutral,-35,51,56169,201402020den,3008
2014090400,2014_01_GB_SEA,2014,1,2014-09-04,Thursday,20:30,GB,16,SEA,36,Home,20,52,56170,201409040sea,3074
2014090700,2014_01_NO_ATL,2014,1,2014-09-07,Sunday,13:00,NO,34,ATL,37,Home,3,71,56171,201409070atl,3075
2014090701,2014_01_CIN_BAL,2014,1,2014-09-07,Sunday,13:00,CIN,23,BAL,16,Home,-7,39,56172,201409070rav,3076
2014090702,2014_01_BUF_CHI,2014,1,2014-09-07,Sunday,13:00,BUF,23,CHI,20,Home,-3,43,56173,201409070chi,3077
2014090703,2014_01_WAS_HOU,2014,1,2014-09-07,Sunday,13:00,WAS,6,HOU,17,Home,11,23,56174,201409070htx,3078
2014090704,2014_01_TEN_KC,2014,1,2014-09-07,Sunday,13:00,TEN,26,KC,10,Home,-16,36,56175,201409070kan,3079
2014090705,2014_01_NE_MIA,2014,1,2014-09-07,Sunday,13:00,NE,20,MIA,33,Home,13,53,56176,201409070mia,3080
2014090706,2014_01_OAK_NYJ,2014,1,2014-09-07,Sunday,13:00,OAK,14,NYJ,19,Home,5,33,56177,201409070nyj,3081
2014090707,2014_01_JAX_PHI,2014,1,2014-09-07,Sunday,13:00,JAX,17,PHI,34,Home,17,51,56178,201409070phi,3082
2014090708,2014_01_CLE_PIT,2014,1,2014-09-07,Sunday,13:00,CLE,27,PIT,30,Home,3,57,56179,201409070pit,3083
2014090709,2014_01_MIN_STL,2014,1,2014-09-07,Sunday,13:00,MIN,34,STL,6,Home,-28,40,56180,201409070ram,3084
2014090710,2014_01_SF_DAL,2014,1,2014-09-07,Sunday,16:25,SF,28,DAL,17,Home,-11,45,56181,201409070dal,3085
2014090711,2014_01_CAR_TB,2014,1,2014-09-07,Sunday,16:25,CAR,20,TB,14,Home,-6,34,56182,201409070tam,3086
2014090712,2014_01_IND_DEN,2014,1,2014-09-07,Sunday,20:30,IND,24,DEN,31,Home,7,55,56183,201409070den,3087
2014090800,2014_01_NYG_DET,2014,1,2014-09-08,Monday,19:10,NYG,14,DET,35,Home,21,49,56184,201409080det,3088
2014090801,2014_01_SD_ARI,2014,1,2014-09-08,Monday,21:20,SD,17,ARI,18,Home,1,35,56185,201409080crd,3089
2014091100,2014_02_PIT_BAL,2014,2,2014-09-11,Thursday,20:25,PIT,6,BAL,26,Home,20,32,56186,201409110rav,3090
2014091400,2014_02_MIA_BUF,2014,2,2014-09-14,Sunday,13:00,MIA,10,BUF,29,Home,19,39,56187,201409140buf,3091
2014091401,2014_02_DET_CAR,2014,2,2014-09-14,Sunday,13:00,DET,7,CAR,24,Home,17,31,56188,201409140car,3092
2014091402,2014_02_ATL_CIN,2014,2,2014-09-14,Sunday,13:00,ATL,10,CIN,24,Home,14,34,56189,201409140cin,3093
2014091403,2014_02_NO_CLE,2014,2,2014-09-14,Sunday,13:00,NO,24,CLE,26,Home,2,50,56190,201409140cle,3094
2014091404,2014_02_NE_MIN,2014,2,2014-09-14,Sunday,13:00,NE,30,MIN,7,Home,-23,37,56191,201409140min,3095
2014091405,2014_02_ARI_NYG,2014,2,2014-09-14,Sunday,13:00,ARI,25,NYG,14,Home,-11,39,56192,201409140nyg,3096
2014091406,2014_02_DAL_TEN,2014,2,2014-09-14,Sunday,13:00,DAL,26,TEN,10,Home,-16,36,56193,201409140oti,3097
2014091407,2014_02_JAX_WAS,2014,2,2014-09-14,Sunday,13:00,JAX,10,WAS,41,Home,31,51,56194,201409140was,3098
2014091408,2014_02_SEA_SD,2014,2,2014-09-14,Sunday,16:05,SEA,21,SD,30,Home,9,51,56195,201409140sdg,3099
2014091409,2014_02_STL_TB,2014,2,2014-09-14,Sunday,16:05,STL,19,TB,17,Home,-2,36,56196,201409140tam,3100
2014091410,2014_02_KC_DEN,2014,2,2014-09-14,Sunday,16:25,KC,17,DEN,24,Home,7,41,56197,201409140den,3101
2014091411,2014_02_NYJ_GB,2014,2,2014-09-14,Sunday,16:25,NYJ,24,GB,31,Home,7,55,56198,201409140gnb,3102
2014091412,2014_02_HOU_OAK,2014,2,2014-09-14,Sunday,16:25,HOU,30,OAK,14,Home,-16,44,56199,201409140rai,3103
2014091413,2014_02_CHI_SF,2014,2,2014-09-14,Sunday,20:30,CHI,28,SF,20,Home,-8,48,56200,201409140sfo,3104
2014091500,2014_02_PHI_IND,2014,2,2014-09-15,Monday,20:30,PHI,30,IND,27,Home,-3,57,56201,201409150clt,3105
2014091800,2014_03_TB_ATL,2014,3,2014-09-18,Thursday,20:25,TB,14,ATL,56,Home,42,70,56202,201409180atl,3106
2014092100,2014_03_SD_BUF,2014,3,2014-09-21,Sunday,13:00,SD,22,BUF,10,Home,-12,32,56203,201409210buf,3107
2014092101,2014_03_TEN_CIN,2014,3,2014-09-21,Sunday,13:00,TEN,7,CIN,33,Home,26,40,56204,201409210cin,3108
2014092102,2014_03_BAL_CLE,2014,3,2014-09-21,Sunday,13:00,BAL,23,CLE,21,Home,-2,44,56205,201409210cle,3109
2014092103,2014_03_GB_DET,2014,3,2014-09-21,Sunday,13:00,GB,7,DET,19,Home,12,26,56206,201409210det,3110
2014092104,2014_03_IND_JAX,2014,3,2014-09-21,Sunday,13:00,IND,44,JAX,17,Home,-27,61,56207,201409210jax,3111
2014092105,2014_03_OAK_NE,2014,3,2014-09-21,Sunday,13:00,OAK,9,NE,16,Home,7,25,56208,201409210nwe,3112
2014092106,2014_03_MIN_NO,2014,3,2014-09-21,Sunday,13:00,MIN,9,NO,20,Home,11,29,56209,201409210nor,3113
2014092107,2014_03_HOU_NYG,2014,3,2014-09-21,Sunday,13:00,HOU,17,NYG,30,Home,13,47,56210,201409210nyg,3114
2014092108,2014_03_WAS_PHI,2014,3,2014-09-21,Sunday,13:00,WAS,34,PHI,37,Home,3,71,56211,201409210phi,3115
2014092109,2014_03_DAL_STL,2014,3,2014-09-21,Sunday,13:00,DAL,34,STL,31,Home,-3,65,56212,201409210ram,3116
2014092110,2014_03_SF_ARI,2014,3,2014-09-21,Sunday,16:05,SF,14,ARI,23,Home,9,37,56213,201409210crd,3117
2014092111,2014_03_KC_MIA,2014,3,2014-09-21,Sunday,16:25,KC,34,MIA,15,Home,-19,49,56214,201409210mia,3118
2014092112,2014_03_DEN_SEA,2014,3,2014-09-21,Sunday,16:25,DEN,20,SEA,26,Home,6,46,56215,201409210sea,3119
2014092113,2014_03_PIT_CAR,2014,3,2014-09-21,Sunday,20:30,PIT,37,CAR,19,Home,-18,56,56216,201409210car,3120
2014092200,2014_03_CHI_NYJ,2014,3,2014-09-22,Monday,20:30,CHI,27,NYJ,19,Home,-8,46,56217,201409220nyj,3121
2014092500,2014_04_NYG_WAS,2014,4,2014-09-25,Thursday,20:25,NYG,45,WAS,14,Home,-31,59,56218,201409250was,3122
2014092800,2014_04_CAR_BAL,2014,4,2014-09-28,Sunday,13:00,CAR,10,BAL,38,Home,28,48,56219,201409280rav,3123
2014092801,2014_04_GB_CHI,2014,4,2014-09-28,Sunday,13:00,GB,38,CHI,17,Home,-21,55,56220,201409280chi,3124
2014092802,2014_04_BUF_HOU,2014,4,2014-09-28,Sunday,13:00,BUF,17,HOU,23,Home,6,40,56221,201409280htx,3125
2014092803,2014_04_TEN_IND,2014,4,2014-09-28,Sunday,13:00,TEN,17,IND,41,Home,24,58,56222,201409280clt,3126
2014092804,2014_04_ATL_MIN,2014,4,2014-09-28,Sunday,16:25,ATL,28,MIN,41,Home,13,69,56227,201409280min,3131
2014092805,2014_04_DET_NYJ,2014,4,2014-09-28,Sunday,13:00,DET,24,NYJ,17,Home,-7,41,56223,201409280nyj,3127
2014092806,2014_04_MIA_OAK,2014,4,2014-09-28,Sunday,13:00,MIA,38,OAK,14,Neutral,-24,52,56224,201409280rai,3128
2014092807,2014_04_TB_PIT,2014,4,2014-09-28,Sunday,13:00,TB,27,PIT,24,Home,-3,51,56225,201409280pit,3129
2014092808,2014_04_JAX_SD,2014,4,2014-09-28,Sunday,16:05,JAX,14,SD,33,Home,19,47,56226,201409280sdg,3130
2014092809,2014_04_PHI_SF,2014,4,2014-09-28,Sunday,16:25,PHI,21,SF,26,Home,5,47,56228,201409280sfo,3132
2014092810,2014_04_NO_DAL,2014,4,2014-09-28,Sunday,20:30,NO,17,DAL,38,Home,21,55,56229,201409280dal,3133
2014092900,2014_04_NE_KC,2014,4,2014-09-29,Monday,20:30,NE,14,KC,41,Home,27,55,56230,201409290kan,3134
2014100200,2014_05_MIN_GB,2014,5,2014-10-02,Thursday,20:25,MIN,10,GB,42,Home,32,52,56231,201410020gnb,3135
2014100500,2014_05_CHI_CAR,2014,5,2014-10-05,Sunday,13:00,CHI,24,CAR,31,Home,7,55,56232,201410050car,3136
2014100501,2014_05_HOU_DAL,2014,5,2014-10-05,Sunday,13:00,HOU,17,DAL,20,Home,3,37,56233,201410050dal,3137
2014100502,2014_05_BUF_DET,2014,5,2014-10-05,Sunday,13:00,BUF,17,DET,14,Home,-3,31,56234,201410050det,3138
2014100503,2014_05_BAL_IND,2014,5,2014-10-05,Sunday,13:00,BAL,13,IND,20,Home,7,33,56235,201410050clt,3139
2014100504,2014_05_PIT_JAX,2014,5,2014-10-05,Sunday,13:00,PIT,17,JAX,9,Home,-8,26,56236,201410050jax,3140
2014100505,2014_05_TB_NO,2014,5,2014-10-05,Sunday,13:00,TB,31,NO,37,Home,6,68,56237,201410050nor,3141
2014100506,2014_05_ATL_NYG,2014,5,2014-10-05,Sunday,13:00,ATL,20,NYG,30,Home,10,50,56238,201410050nyg,3142
2014100507,2014_05_STL_PHI,2014,5,2014-10-05,Sunday,13:00,STL,28,PHI,34,Home,6,62,56239,201410050phi,3143
2014100508,2014_05_CLE_TEN,2014,5,2014-10-05,Sunday,13:00,CLE,29,TEN,28,Home,-1,57,56240,201410050oti,3144
2014100509,2014_05_ARI_DEN,2014,5,2014-10-05,Sunday,16:05,ARI,20,DEN,41,Home,21,61,56241,201410050den,3145
2014100510,2014_05_NYJ_SD,2014,5,2014-10-05,Sunday,16:25,NYJ,0,SD,31,Home,31,31,56242,201410050sdg,3146
2014100511,2014_05_KC_SF,2014,5,2014-10-05,Sunday,16:25,KC,17,SF,22,Home,5,39,56243,201410050sfo,3147
2014100512,2014_05_CIN_NE,2014,5,2014-10-05,Sunday,20:30,CIN,17,NE,43,Home,26,60,56244,201410050nwe,3148
2014100600,2014_05_SEA_WAS,2014,5,2014-10-06,Monday,20:30,SEA,27,WAS,17,Home,-10,44,56245,201410060was,3149
2014100900,2014_06_IND_HOU,2014,6,2014-10-09,Thursday,20:25,IND,33,HOU,28,Home,-5,61,56246,201410090htx,3150
2014101200,2014_06_CHI_ATL,2014,6,2014-10-12,Sunday,16:25,CHI,27,ATL,13,Home,-14,40,56247,201410120atl,3151
2014101201,2014_06_NE_BUF,2014,6,2014-10-12,Sunday,13:00,NE,37,BUF,22,Home,-15,59,56248,201410120buf,3152
2014101202,2014_06_CAR_CIN,2014,6,2014-10-12,Sunday,13:00,CAR,37,CIN,37,Home,0,74,56249,201410120cin,3153
2014101203,2014_06_PIT_CLE,2014,6,2014-10-12,Sunday,13:00,PIT,10,CLE,31,Home,21,41,56250,201410120cle,3154
2014101204,2014_06_GB_MIA,2014,6,2014-10-12,Sunday,13:00,GB,27,MIA,24,Home,-3,51,56251,201410120mia,3155
2014101205,2014_06_DET_MIN,2014,6,2014-10-12,Sunday,13:00,DET,17,MIN,3,Home,-14,20,56252,201410120min,3156
2014101206,2014_06_DEN_NYJ,2014,6,2014-10-12,Sunday,13:00,DEN,31,NYJ,17,Home,-14,48,56253,201410120nyj,3157
2014101207,2014_06_BAL_TB,2014,6,2014-10-12,Sunday,13:00,BAL,48,TB,17,Home,-31,65,56254,201410120tam,3158
2014101208,2014_06_JAX_TEN,2014,6,2014-10-12,Sunday,13:00,JAX,14,TEN,16,Home,2,30,56255,201410120oti,3159
2014101209,2014_06_SD_OAK,2014,6,2014-10-12,Sunday,16:05,SD,31,OAK,28,Home,-3,59,56256,201410120rai,3160
2014101210,2014_06_WAS_ARI,2014,6,2014-10-12,Sunday,16:25,WAS,20,ARI,30,Home,10,50,56257,201410120crd,3161
2014101211,2014_06_DAL_SEA,2014,6,2014-10-12,Sunday,16:25,DAL,30,SEA,23,Home,-7,53,56258,201410120sea,3162
2014101212,2014_06_NYG_PHI,2014,6,2014-10-12,Sunday,20:30,NYG,0,PHI,27,Home,27,27,56259,201410120phi,3163
2014101300,2014_06_SF_STL,2014,6,2014-10-13,Monday,20:30,SF,31,STL,17,Home,-14,48,56260,201410130ram,3164
2014101600,2014_07_NYJ_NE,2014,7,2014-10-16,Thursday,20:25,NYJ,25,NE,27,Home,2,52,56261,201410160nwe,3165
2014101900,2014_07_ATL_BAL,2014,7,2014-10-19,Sunday,13:00,ATL,7,BAL,29,Home,22,36,56262,201410190rav,3166
2014101901,2014_07_MIN_BUF,2014,7,2014-10-19,Sunday,13:00,MIN,16,BUF,17,Home,1,33,56263,201410190buf,3167
2014101902,2014_07_MIA_CHI,2014,7,2014-10-19,Sunday,13:00,MIA,27,CHI,14,Home,-13,41,56264,201410190chi,3168
2014101903,2014_07_NO_DET,2014,7,2014-10-19,Sunday,13:00,NO,23,DET,24,Home,1,47,56265,201410190det,3169
2014101904,2014_07_CAR_GB,2014,7,2014-10-19,Sunday,13:00,CAR,17,GB,38,Home,21,55,56266,201410190gnb,3170
2014101905,2014_07_CIN_IND,2014,7,2014-10-19,Sunday,13:00,CIN,0,IND,27,Home,27,27,56267,201410190clt,3171
2014101906,2014_07_CLE_JAX,2014,7,2014-10-19,Sunday,13:00,CLE,6,JAX,24,Home,18,30,56268,201410190jax,3172
2014101907,2014_07_SEA_STL,2014,7,2014-10-19,Sunday,13:00,SEA,26,STL,28,Home,2,54,56269,201410190ram,3173
2014101908,2014_07_TEN_WAS,2014,7,2014-10-19,Sunday,13:00,TEN,17,WAS,19,Home,2,36,56270,201410190was,3174
2014101909,2014_07_KC_SD,2014,7,2014-10-19,Sunday,16:05,KC,23,SD,20,Home,-3,43,56271,201410190sdg,3175
2014101910,2014_07_NYG_DAL,2014,7,2014-10-19,Sunday,16:25,NYG,21,DAL,31,Home,10,52,56272,201410190dal,3176
2014101911,2014_07_ARI_OAK,2014,7,2014-10-19,Sunday,16:25,ARI,24,OAK,13,Home,-11,37,56273,201410190rai,3177
2014101912,2014_07_SF_DEN,2014,7,2014-10-19,Sunday,20:30,SF,17,DEN,42,Home,25,59,56274,201410190den,3178
2014102000,2014_07_HOU_PIT,2014,7,2014-10-20,Monday,20:30,HOU,23,PIT,30,Home,7,53,56275,201410200pit,3179
2014102300,2014_08_SD_DEN,2014,8,2014-10-23,Thursday,20:25,SD,21,DEN,35,Home,14,56,56276,201410230den,3180
2014102600,2014_08_DET_ATL,2014,8,2014-10-26,Sunday,09:30,DET,22,ATL,21,Neutral,-1,43,56277,201410260atl,3181
2014102601,2014_08_SEA_CAR,2014,8,2014-10-26,Sunday,13:00,SEA,13,CAR,9,Home,-4,22,56278,201410260car,3182
2014102602,2014_08_BAL_CIN,2014,8,2014-10-26,Sunday,13:00,BAL,24,CIN,27,Home,3,51,56279,201410260cin,3183
2014102603,2014_08_MIA_JAX,2014,8,2014-10-26,Sunday,13:00,MIA,27,JAX,13,Home,-14,40,56280,201410260jax,3184
2014102604,2014_08_STL_KC,2014,8,2014-10-26,Sunday,13:00,STL,7,KC,34,Home,27,41,56281,201410260kan,3185
2014102605,2014_08_CHI_NE,2014,8,2014-10-26,Sunday,13:00,CHI,23,NE,51,Home,28,74,56282,201410260nwe,3186
2014102606,2014_08_BUF_NYJ,2014,8,2014-10-26,Sunday,13:00,BUF,43,NYJ,23,Home,-20,66,56283,201410260nyj,3187
2014102607,2014_08_MIN_TB,2014,8,2014-10-26,Sunday,13:00,MIN,19,TB,13,Home,-6,32,56284,201410260tam,3188
2014102608,2014_08_HOU_TEN,2014,8,2014-10-26,Sunday,13:00,HOU,30,TEN,16,Home,-14,46,56285,201410260oti,3189
2014102609,2014_08_PHI_ARI,2014,8,2014-10-26,Sunday,16:05,PHI,20,ARI,24,Home,4,44,56286,201410260crd,3190
2014102610,2014_08_OAK_CLE,2014,8,2014-10-26,Sunday,16:25,OAK,13,CLE,23,Home,10,36,56287,201410260cle,3191
2014102611,2014_08_IND_PIT,2014,8,2014-10-26,Sunday,16:25,IND,34,PIT,51,Home,17,85,56288,201410260pit,3192
2014102612,2014_08_GB_NO,2014,8,2014-10-26,Sunday,20:30,GB,23,NO,44,Home,21,67,56289,201410260nor,3193
2014102700,2014_08_WAS_DAL,2014,8,2014-10-27,Monday,20:30,WAS,20,DAL,17,Home,-3,37,56290,201410270dal,3194
2014103000,2014_09_NO_CAR,2014,9,2014-10-30,Thursday,20:25,NO,28,CAR,10,Home,-18,38,56291,201410300car,3195
2014110200,2014_09_JAX_CIN,2014,9,2014-11-02,Sunday,13:00,JAX,23,CIN,33,Home,10,56,56292,201411020cin,3196
2014110201,2014_09_TB_CLE,2014,9,2014-11-02,Sunday,13:00,TB,17,CLE,22,Home,5,39,56293,201411020cle,3197
2014110202,2014_09_ARI_DAL,2014,9,2014-11-02,Sunday,13:00,ARI,28,DAL,17,Home,-11,45,56294,201411020dal,3198
2014110203,2014_09_PHI_HOU,2014,9,2014-11-02,Sunday,13:00,PHI,31,HOU,21,Home,-10,52,56295,201411020htx,3199
2014110204,2014_09_NYJ_KC,2014,9,2014-11-02,Sunday,13:00,NYJ,10,KC,24,Home,14,34,56296,201411020kan,3200
2014110205,2014_09_SD_MIA,2014,9,2014-11-02,Sunday,13:00,SD,0,MIA,37,Home,37,37,56297,201411020mia,3201
2014110206,2014_09_WAS_MIN,2014,9,2014-11-02,Sunday,13:00,WAS,26,MIN,29,Home,3,55,56298,201411020min,3202
2014110207,2014_09_STL_SF,2014,9,2014-11-02,Sunday,16:05,STL,13,SF,10,Home,-3,23,56299,201411020sfo,3203
2014110208,2014_09_DEN_NE,2014,9,2014-11-02,Sunday,16:25,DEN,21,NE,43,Home,22,64,56300,201411020nwe,3204
2014110209,2014_09_OAK_SEA,2014,9,2014-11-02,Sunday,16:25,OAK,24,SEA,30,Home,6,54,56301,201411020sea,3205
2014110210,2014_09_BAL_PIT,2014,9,2014-11-02,Sunday,20:30,BAL,23,PIT,43,Home,20,66,56302,201411020pit,3206
2014110300,2014_09_IND_NYG,2014,9,2014-11-03,Monday,20:30,IND,40,NYG,24,Home,-16,64,56303,201411030nyg,3207
2014110600,2014_10_CLE_CIN,2014,10,2014-11-06,Thursday,20:25,CLE,24,CIN,3,Home,-21,27,56304,201411060cin,3208
2014110900,2014_10_TEN_BAL,2014,10,2014-11-09,Sunday,13:00,TEN,7,BAL,21,Home,14,28,56305,201411090rav,3209
2014110901,2014_10_KC_BUF,2014,10,2014-11-09,Sunday,13:00,KC,17,BUF,13,Home,-4,30,56306,201411090buf,3210
2014110902,2014_10_MIA_DET,2014,10,2014-11-09,Sunday,13:00,MIA,16,DET,20,Home,4,36,56307,201411090det,3211
2014110903,2014_10_DAL_JAX,2014,10,2014-11-09,Sunday,13:00,DAL,31,JAX,17,Neutral,-14,48,56308,201411090jax,3212
2014110904,2014_10_SF_NO,2014,10,2014-11-09,Sunday,13:00,SF,27,NO,24,Home,-3,51,56309,201411090nor,3213
2014110905,2014_10_PIT_NYJ,2014,10,2014-11-09,Sunday,13:00,PIT,13,NYJ,20,Home,7,33,56310,201411090nyj,3214
2014110906,2014_10_ATL_TB,2014,10,2014-11-09,Sunday,13:00,ATL,27,TB,17,Home,-10,44,56311,201411090tam,3215
2014110907,2014_10_DEN_OAK,2014,10,2014-11-09,Sunday,16:05,DEN,41,OAK,17,Home,-24,58,56312,201411090rai,3216
2014110908,2014_10_STL_ARI,2014,10,2014-11-09,Sunday,16:25,STL,14,ARI,31,Home,17,45,56313,201411090crd,3217
2014110909,2014_10_NYG_SEA,2014,10,2014-11-09,Sunday,16:25,NYG,17,SEA,38,Home,21,55,56314,201411090sea,3218
2014110910,2014_10_CHI_GB,2014,10,2014-11-09,Sunday,20:30,CHI,14,GB,55,Home,41,69,56315,201411090gnb,3219
2014111000,2014_10_CAR_PHI,2014,10,2014-11-10,Monday,20:30,CAR,21,PHI,45,Home,24,66,56316,201411100phi,3220
2014111300,2014_11_BUF_MIA,2014,11,2014-11-13,Thursday,20:25,BUF,9,MIA,22,Home,13,31,56317,201411130mia,3221
2014111600,2014_11_ATL_CAR,2014,11,2014-11-16,Sunday,13:00,ATL,19,CAR,17,Home,-2,36,56318,201411160car,3222
2014111601,2014_11_MIN_CHI,2014,11,2014-11-16,Sunday,13:00,MIN,13,CHI,21,Home,8,34,56319,201411160chi,3223
2014111602,2014_11_HOU_CLE,2014,11,2014-11-16,Sunday,13:00,HOU,23,CLE,7,Home,-16,30,56320,201411160cle,3224
2014111603,2014_11_PHI_GB,2014,11,2014-11-16,Sunday,16:25,PHI,20,GB,53,Home,33,73,56321,201411160gnb,3225
2014111604,2014_11_SEA_KC,2014,11,2014-11-16,Sunday,13:00,SEA,20,KC,24,Home,4,44,56322,201411160kan,3226
2014111605,2014_11_CIN_NO,2014,11,2014-11-16,Sunday,13:00,CIN,27,NO,10,Home,-17,37,56323,201411160nor,3227
2014111606,2014_11_SF_NYG,2014,11,2014-11-16,Sunday,13:00,SF,16,NYG,10,Home,-6,26,56324,201411160nyg,3228
2014111607,2014_11_DEN_STL,2014,11,2014-11-16,Sunday,13:00,DEN,7,STL,22,Home,15,29,56325,201411160ram,3229
2014111608,2014_11_TB_WAS,2014,11,2014-11-16,Sunday,13:00,TB,27,WAS,7,Home,-20,34,56326,201411160was,3230
2014111609,2014_11_OAK_SD,2014,11,2014-11-16,Sunday,16:05,OAK,6,SD,13,Home,7,19,56327,201411160sdg,3231
2014111610,2014_11_DET_ARI,2014,11,2014-11-16,Sunday,16:25,DET,6,ARI,14,Home,8,20,56328,201411160crd,3232
2014111611,2014_11_NE_IND,2014,11,2014-11-16,Sunday,20:30,NE,42,IND,20,Home,-22,62,56329,201411160clt,3233
2014111700,2014_11_PIT_TEN,2014,11,2014-11-17,Monday,20:30,PIT,27,TEN,24,Home,-3,51,56330,201411170oti,3234
2014112000,2014_12_KC_OAK,2014,12,2014-11-20,Thursday,20:25,KC,20,OAK,24,Home,4,44,56331,201411200rai,3235
2014112300,2014_12_CLE_ATL,2014,12,2014-11-23,Sunday,13:00,CLE,26,ATL,24,Home,-2,50,56332,201411230atl,3236
2014112301,2014_12_NYJ_BUF,2014,12,2014-11-24,Monday,19:00,NYJ,3,BUF,38,Neutral,35,41,56333,201411240buf,3237
2014112302,2014_12_TB_CHI,2014,12,2014-11-23,Sunday,13:00,TB,13,CHI,21,Home,8,34,56334,201411230chi,3238
2014112303,2014_12_CIN_HOU,2014,12,2014-11-23,Sunday,13:00,CIN,22,HOU,13,Home,-9,35,56335,201411230htx,3239
2014112304,2014_12_JAX_IND,2014,12,2014-11-23,Sunday,13:00,JAX,3,IND,23,Home,20,26,56336,201411230clt,3240
2014112305,2014_12_GB_MIN,2014,12,2014-11-23,Sunday,13:00,GB,24,MIN,21,Home,-3,45,56337,201411230min,3241
2014112306,2014_12_DET_NE,2014,12,2014-11-23,Sunday,13:00,DET,9,NE,34,Home,25,43,56338,201411230nwe,3242
2014112307,2014_12_TEN_PHI,2014,12,2014-11-23,Sunday,13:00,TEN,24,PHI,43,Home,19,67,56339,201411230phi,3243
2014112308,2014_12_STL_SD,2014,12,2014-11-23,Sunday,16:05,STL,24,SD,27,Home,3,51,56340,201411230sdg,3244
2014112309,2014_12_ARI_SEA,2014,12,2014-11-23,Sunday,16:05,ARI,3,SEA,19,Home,16,22,56341,201411230sea,3245
2014112310,2014_12_MIA_DEN,2014,12,2014-11-23,Sunday,16:25,MIA,36,DEN,39,Home,3,75,56342,201411230den,3246
2014112311,2014_12_WAS_SF,2014,12,2014-11-23,Sunday,16:25,WAS,13,SF,17,Home,4,30,56343,201411230sfo,3247
2014112312,2014_12_DAL_NYG,2014,12,2014-11-23,Sunday,20:30,DAL,31,NYG,28,Home,-3,59,56344,201411230nyg,3248
2014112400,2014_12_BAL_NO,2014,12,2014-11-24,Monday,20:30,BAL,34,NO,27,Home,-7,61,56345,201411240nor,3249
2014112700,2014_13_CHI_DET,2014,13,2014-11-27,Thursday,12:30,CHI,17,DET,34,Home,17,51,56346,201411270det,3250
2014112701,2014_13_PHI_DAL,2014,13,2014-11-27,Thursday,16:30,PHI,33,DAL,10,Home,-23,43,56347,201411270dal,3251
2014112702,2014_13_SEA_SF,2014,13,2014-11-27,Thursday,20:30,SEA,19,SF,3,Home,-16,22,56348,201411270sfo,3252
2014113000,2014_13_SD_BAL,2014,13,2014-11-30,Sunday,13:00,SD,34,BAL,33,Home,-1,67,56349,201411300rav,3253
2014113001,2014_13_CLE_BUF,2014,13,2014-11-30,Sunday,13:00,CLE,10,BUF,26,Home,16,36,56350,201411300buf,3254
2014113002,2014_13_TEN_HOU,2014,13,2014-11-30,Sunday,13:00,TEN,21,HOU,45,Home,24,66,56351,201411300htx,3255
2014113003,2014_13_WAS_IND,2014,13,2014-11-30,Sunday,13:00,WAS,27,IND,49,Home,22,76,56352,201411300clt,3256
2014113004,2014_13_NYG_JAX,2014,13,2014-11-30,Sunday,13:00,NYG,24,JAX,25,Home,1,49,56353,201411300jax,3257
2014113005,2014_13_CAR_MIN,2014,13,2014-11-30,Sunday,13:00,CAR,13,MIN,31,Home,18,44,56354,201411300min,3258
2014113006,2014_13_NO_PIT,2014,13,2014-11-30,Sunday,13:00,NO,35,PIT,32,Home,-3,67,56355,201411300pit,3259
2014113007,2014_13_OAK_STL,2014,13,2014-11-30,Sunday,13:00,OAK,0,STL,52,Home,52,52,56356,201411300ram,3260
2014113008,2014_13_CIN_TB,2014,13,2014-11-30,Sunday,13:00,CIN,14,TB,13,Home,-1,27,56357,201411300tam,3261
2014113009,2014_13_ARI_ATL,2014,13,2014-11-30,Sunday,16:05,ARI,18,ATL,29,Home,11,47,56358,201411300atl,3262
2014113010,2014_13_NE_GB,2014,13,2014-11-30,Sunday,16:25,NE,21,GB,26,Home,5,47,56359,201411300gnb,3263
2014113011,2014_13_DEN_KC,2014,13,2014-11-30,Sunday,20:30,DEN,29,KC,16,Home,-13,45,56360,201411300kan,3264
2014120100,2014_13_MIA_NYJ,2014,13,2014-12-01,Monday,20:30,MIA,16,NYJ,13,Home,-3,29,56361,201412010nyj,3265
2014120400,2014_14_DAL_CHI,2014,14,2014-12-04,Thursday,20:25,DAL,41,CHI,28,Home,-13,69,56362,201412040chi,3266
2014120700,2014_14_PIT_CIN,2014,14,2014-12-07,Sunday,13:00,PIT,42,CIN,21,Home,-21,63,56363,201412070cin,3267
2014120701,2014_14_IND_CLE,2014,14,2014-12-07,Sunday,13:00,IND,25,CLE,24,Home,-1,49,56364,201412070cle,3268
2014120702,2014_14_TB_DET,2014,14,2014-12-07,Sunday,13:00,TB,17,DET,34,Home,17,51,56365,201412070det,3269
2014120703,2014_14_HOU_JAX,2014,14,2014-12-07,Sunday,13:00,HOU,27,JAX,13,Home,-14,40,56366,201412070jax,3270
2014120704,2014_14_BAL_MIA,2014,14,2014-12-07,Sunday,13:00,BAL,28,MIA,13,Home,-15,41,56367,201412070mia,3271
2014120705,2014_14_NYJ_MIN,2014,14,2014-12-07,Sunday,13:00,NYJ,24,MIN,30,Home,6,54,56368,201412070min,3272
2014120706,2014_14_CAR_NO,2014,14,2014-12-07,Sunday,13:00,CAR,41,NO,10,Home,-31,51,56369,201412070nor,3273
2014120707,2014_14_NYG_TEN,2014,14,2014-12-07,Sunday,13:00,NYG,36,TEN,7,Home,-29,43,56370,201412070oti,3274
2014120708,2014_14_STL_WAS,2014,14,2014-12-07,Sunday,13:00,STL,24,WAS,0,Home,-24,24,56371,201412070was,3275
2014120709,2014_14_KC_ARI,2014,14,2014-12-07,Sunday,16:05,KC,14,ARI,17,Home,3,31,56372,201412070crd,3276
2014120710,2014_14_BUF_DEN,2014,14,2014-12-07,Sunday,16:05,BUF,17,DEN,24,Home,7,41,56373,201412070den,3277
2014120711,2014_14_SF_OAK,2014,14,2014-12-07,Sunday,16:25,SF,13,OAK,24,Home,11,37,56374,201412070rai,3278
2014120712,2014_14_SEA_PHI,2014,14,2014-12-07,Sunday,16:25,SEA,24,PHI,14,Home,-10,38,56375,201412070phi,3279
2014120713,2014_14_NE_SD,2014,14,2014-12-07,Sunday,20:30,NE,23,SD,14,Home,-9,37,56376,201412070sdg,3280
2014120800,2014_14_ATL_GB,2014,14,2014-12-08,Monday,20:30,ATL,37,GB,43,Home,6,80,56377,201412080gnb,3281
2014121100,2014_15_ARI_STL,2014,15,2014-12-11,Thursday,20:25,ARI,12,STL,6,Home,-6,18,56378,201412110ram,3282
2014121400,2014_15_PIT_ATL,2014,15,2014-12-14,Sunday,13:00,PIT,27,ATL,20,Home,-7,47,56379,201412140atl,3283
2014121401,2014_15_JAX_BAL,2014,15,2014-12-14,Sunday,13:00,JAX,12,BAL,20,Home,8,32,56380,201412140rav,3284
2014121402,2014_15_GB_BUF,2014,15,2014-12-14,Sunday,13:00,GB,13,BUF,21,Home,8,34,56381,201412140buf,3285
2014121403,2014_15_TB_CAR,2014,15,2014-12-14,Sunday,13:00,TB,17,CAR,19,Home,2,36,56382,201412140car,3286
2014121404,2014_15_CIN_CLE,2014,15,2014-12-14,Sunday,13:00,CIN,30,CLE,0,Home,-30,30,56383,201412140cle,3287
2014121405,2014_15_MIN_DET,2014,15,2014-12-14,Sunday,16:25,MIN,14,DET,16,Home,2,30,56384,201412140det,3288
2014121406,2014_15_HOU_IND,2014,15,2014-12-14,Sunday,13:00,HOU,10,IND,17,Home,7,27,56385,201412140clt,3289
2014121407,2014_15_OAK_KC,2014,15,2014-12-14,Sunday,13:00,OAK,13,KC,31,Home,18,44,56386,201412140kan,3290
2014121408,2014_15_MIA_NE,2014,15,2014-12-14,Sunday,13:00,MIA,13,NE,41,Home,28,54,56387,201412140nwe,3291
2014121409,2014_15_WAS_NYG,2014,15,2014-12-14,Sunday,13:00,WAS,13,NYG,24,Home,11,37,56388,201412140nyg,3292
2014121410,2014_15_DEN_SD,2014,15,2014-12-14,Sunday,16:05,DEN,22,SD,10,Home,-12,32,56389,201412140sdg,3293
2014121411,2014_15_NYJ_TEN,2014,15,2014-12-14,Sunday,16:05,NYJ,16,TEN,11,Home,-5,27,56390,201412140oti,3294
2014121412,2014_15_SF_SEA,2014,15,2014-12-14,Sunday,16:25,SF,7,SEA,17,Home,10,24,56391,201412140sea,3295
2014121413,2014_15_DAL_PHI,2014,15,2014-12-14,Sunday,20:30,DAL,38,PHI,27,Home,-11,65,56392,201412140phi,3296
2014121500,2014_15_NO_CHI,2014,15,2014-12-15,Monday,20:30,NO,31,CHI,15,Home,-16,46,56393,201412150chi,3297
2014121800,2014_16_TEN_JAX,2014,16,2014-12-18,Thursday,20:25,TEN,13,JAX,21,Home,8,34,56394,201412180jax,3298
2014122000,2014_16_PHI_WAS,2014,16,2014-12-20,Saturday,16:25,PHI,24,WAS,27,Home,3,51,56396,201412200was,3300
2014122001,2014_16_SD_SF,2014,16,2014-12-20,Saturday,20:25,SD,38,SF,35,Home,-3,73,56395,201412200sfo,3299
2014122100,2014_16_CLE_CAR,2014,16,2014-12-21,Sunday,13:00,CLE,13,CAR,17,Home,4,30,56397,201412210car,3301
2014122101,2014_16_DET_CHI,2014,16,2014-12-21,Sunday,13:00,DET,20,CHI,14,Home,-6,34,56398,201412210chi,3302
2014122102,2014_16_BAL_HOU,2014,16,2014-12-21,Sunday,13:00,BAL,13,HOU,25,Home,12,38,56399,201412210htx,3303
2014122103,2014_16_MIN_MIA,2014,16,2014-12-21,Sunday,13:00,MIN,35,MIA,37,Home,2,72,56400,201412210mia,3304
2014122104,2014_16_ATL_NO,2014,16,2014-12-21,Sunday,13:00,ATL,30,NO,14,Home,-16,44,56401,201412210nor,3305
2014122105,2014_16_NE_NYJ,2014,16,2014-12-21,Sunday,13:00,NE,17,NYJ,16,Home,-1,33,56402,201412210nyj,3306
2014122106,2014_16_KC_PIT,2014,16,2014-12-21,Sunday,13:00,KC,12,PIT,20,Home,8,32,56403,201412210pit,3307
2014122107,2014_16_GB_TB,2014,16,2014-12-21,Sunday,13:00,GB,20,TB,3,Home,-17,23,56404,201412210tam,3308
2014122108,2014_16_NYG_STL,2014,16,2014-12-21,Sunday,16:05,NYG,37,STL,27,Home,-10,64,56405,201412210ram,3309
2014122109,2014_16_IND_DAL,2014,16,2014-12-21,Sunday,16:25,IND,7,DAL,42,Home,35,49,56406,201412210dal,3310
2014122110,2014_16_BUF_OAK,2014,16,2014-12-21,Sunday,16:25,BUF,24,OAK,26,Home,2,50,56407,201412210rai,3311
2014122111,2014_16_SEA_ARI,2014,16,2014-12-21,Sunday,20:30,SEA,35,ARI,6,Home,-29,41,56408,201412210crd,3312
2014122200,2014_16_DEN_CIN,2014,16,2014-12-22,Monday,20:30,DEN,28,CIN,37,Home,9,65,56409,201412220cin,3313
2014122800,2014_17_CAR_ATL,2014,17,2014-12-28,Sunday,16:25,CAR,34,ATL,3,Home,-31,37,56410,201412280atl,3314
2014122801,2014_17_CLE_BAL,2014,17,2014-12-28,Sunday,13:00,CLE,10,BAL,20,Home,10,30,56411,201412280rav,3315
2014122802,2014_17_DET_GB,2014,17,2014-12-28,Sunday,16:25,DET,20,GB,30,Home,10,50,56412,201412280gnb,3316
2014122803,2014_17_JAX_HOU,2014,17,2014-12-28,Sunday,13:00,JAX,17,HOU,23,Home,6,40,56413,201412280htx,3317
2014122804,2014_17_SD_KC,2014,17,2014-12-28,Sunday,13:00,SD,7,KC,19,Home,12,26,56414,201412280kan,3318
2014122805,2014_17_NYJ_MIA,2014,17,2014-12-28,Sunday,13:00,NYJ,37,MIA,24,Home,-13,61,56415,201412280mia,3319
2014122806,2014_17_CHI_MIN,2014,17,2014-12-28,Sunday,13:00,CHI,9,MIN,13,Home,4,22,56416,201412280min,3320
2014122807,2014_17_BUF_NE,2014,17,2014-12-28,Sunday,13:00,BUF,17,NE,9,Home,-8,26,56417,201412280nwe,3321
2014122808,2014_17_PHI_NYG,2014,17,2014-12-28,Sunday,13:00,PHI,34,NYG,26,Home,-8,60,56418,201412280nyg,3322
2014122809,2014_17_CIN_PIT,2014,17,2014-12-28,Sunday,20:30,CIN,17,PIT,27,Home,10,44,56419,201412280pit,3323
2014122810,2014_17_NO_TB,2014,17,2014-12-28,Sunday,13:00,NO,23,TB,20,Home,-3,43,56420,201412280tam,3324
2014122811,2014_17_IND_TEN,2014,17,2014-12-28,Sunday,13:00,IND,27,TEN,10,Home,-17,37,56421,201412280oti,3325
2014122812,2014_17_DAL_WAS,2014,17,2014-12-28,Sunday,13:00,DAL,44,WAS,17,Home,-27,61,56422,201412280was,3326
2014122813,2014_17_OAK_DEN,2014,17,2014-12-28,Sunday,16:25,OAK,14,DEN,47,Home,33,61,56423,201412280den,3327
2014122814,2014_17_ARI_SF,2014,17,2014-12-28,Sunday,16:25,ARI,17,SF,20,Home,3,37,56424,201412280sfo,3328
2014122815,2014_17_STL_SEA,2014,17,2014-12-28,Sunday,16:25,STL,6,SEA,20,Home,14,26,56425,201412280sea,3329
2015010300,2014_18_ARI_CAR,2014,18,2015-01-03,Saturday,16:35,ARI,16,CAR,27,Home,11,43,56491,201501030car,3330
2015010301,2014_18_BAL_PIT,2014,18,2015-01-03,Saturday,20:15,BAL,30,PIT,17,Home,-13,47,56492,201501030pit,3331
2015010400,2014_18_CIN_IND,2014,18,2015-01-04,Sunday,13:05,CIN,10,IND,26,Home,16,36,56493,201501040clt,3332
2015010401,2014_18_DET_DAL,2014,18,2015-01-04,Sunday,16:40,DET,20,DAL,24,Home,4,44,56494,201501040dal,3333
2015011000,2014_19_BAL_NE,2014,19,2015-01-10,Saturday,16:35,BAL,31,NE,35,Home,4,66,56495,201501100nwe,3334
2015011001,2014_19_CAR_SEA,2014,19,2015-01-10,Saturday,20:15,CAR,17,SEA,31,Home,14,48,56496,201501100sea,3335
2015011100,2014_19_DAL_GB,2014,19,2015-01-11,Sunday,13:05,DAL,21,GB,26,Home,5,47,56497,201501110gnb,3336
2015011101,2014_19_IND_DEN,2014,19,2015-01-11,Sunday,16:40,IND,24,DEN,13,Home,-11,37,56498,201501110den,3337
2015011800,2014_20_GB_SEA,2014,20,2015-01-18,Sunday,15:05,GB,22,SEA,28,Home,6,50,56499,201501180sea,3338
2015011801,2014_20_IND_NE,2014,20,2015-01-18,Sunday,18:50,IND,7,NE,45,Home,38,52,56500,201501180nwe,3339
2015020100,2014_21_NE_SEA,2014,21,2015-02-01,Sunday,18:30,NE,28,SEA,24,Neutral,-4,52,56502,201502010sea,3340
2015091000,2015_01_PIT_NE,2015,1,2015-09-10,Thursday,20:30,PIT,21,NE,28,Home,7,49,56503,201509100nwe,3406
2015091300,2015_01_GB_CHI,2015,1,2015-09-13,Sunday,13:00,GB,31,CHI,23,Home,-8,54,56505,201509130chi,3407
2015091301,2015_01_SEA_STL,2015,1,2015-09-13,Sunday,13:00,SEA,31,STL,34,Home,3,65,56509,201509130ram,3408
2015091302,2015_01_CAR_JAX,2015,1,2015-09-13,Sunday,13:00,CAR,20,JAX,9,Home,-11,29,56507,201509130jax,3411
2015091303,2015_01_MIA_WAS,2015,1,2015-09-13,Sunday,13:00,MIA,17,WAS,10,Home,-7,27,56510,201509130was,3410
2015091304,2015_01_IND_BUF,2015,1,2015-09-13,Sunday,13:00,IND,14,BUF,27,Home,13,41,56504,201509130buf,3413
2015091305,2015_01_CLE_NYJ,2015,1,2015-09-13,Sunday,13:00,CLE,10,NYJ,31,Home,21,41,56508,201509130nyj,3412
2015091306,2015_01_KC_HOU,2015,1,2015-09-13,Sunday,13:00,KC,27,HOU,20,Home,-7,47,56506,201509130htx,3409
2015091307,2015_01_NO_ARI,2015,1,2015-09-13,Sunday,16:05,NO,19,ARI,31,Home,12,50,56511,201509130crd,3414
2015091308,2015_01_DET_SD,2015,1,2015-09-13,Sunday,16:05,DET,28,SD,33,Home,5,61,56512,201509130sdg,3415
2015091309,2015_01_BAL_DEN,2015,1,2015-09-13,Sunday,16:25,BAL,13,DEN,19,Home,6,32,56513,201509130den,3417
2015091310,2015_01_CIN_OAK,2015,1,2015-09-13,Sunday,16:25,CIN,33,OAK,13,Home,-20,46,56514,201509130rai,3416
2015091311,2015_01_TEN_TB,2015,1,2015-09-13,Sunday,16:25,TEN,42,TB,14,Home,-28,56,56515,201509130tam,3418
2015091312,2015_01_NYG_DAL,2015,1,2015-09-13,Sunday,20:30,NYG,26,DAL,27,Home,1,53,56516,201509130dal,3419
2015091400,2015_01_PHI_ATL,2015,1,2015-09-14,Monday,19:10,PHI,24,ATL,26,Home,2,50,56517,201509140atl,3420
2015091401,2015_01_MIN_SF,2015,1,2015-09-14,Monday,22:20,MIN,3,SF,20,Home,17,23,56518,201509140sfo,3421
2015091700,2015_02_DEN_KC,2015,2,2015-09-17,Thursday,20:25,DEN,31,KC,24,Home,-7,55,56519,201509170kan,3422
2015092000,2015_02_HOU_CAR,2015,2,2015-09-20,Sunday,13:00,HOU,17,CAR,24,Home,7,41,56521,201509200car,3431
2015092001,2015_02_NE_BUF,2015,2,2015-09-20,Sunday,13:00,NE,40,BUF,32,Home,-8,72,56520,201509200buf,3428
2015092002,2015_02_SD_CIN,2015,2,2015-09-20,Sunday,13:00,SD,19,CIN,24,Home,5,43,56523,201509200cin,3426
2015092003,2015_02_TEN_CLE,2015,2,2015-09-20,Sunday,13:00,TEN,14,CLE,28,Home,14,42,56524,201509200cle,3432
2015092004,2015_02_ATL_NYG,2015,2,2015-09-20,Sunday,13:00,ATL,24,NYG,20,Home,-4,44,56527,201509200nyg,3427
2015092005,2015_02_STL_WAS,2015,2,2015-09-20,Sunday,13:00,STL,10,WAS,24,Home,14,34,56529,201509200was,3430
2015092006,2015_02_ARI_CHI,2015,2,2015-09-20,Sunday,13:00,ARI,48,CHI,23,Home,-25,71,56522,201509200chi,3425
2015092007,2015_02_DET_MIN,2015,2,2015-09-20,Sunday,13:00,DET,16,MIN,26,Home,10,42,56525,201509200min,3423
2015092008,2015_02_TB_NO,2015,2,2015-09-20,Sunday,13:00,TB,26,NO,19,Home,-7,45,56526,201509200nor,3424
2015092009,2015_02_SF_PIT,2015,2,2015-09-20,Sunday,13:00,SF,18,PIT,43,Home,25,61,56528,201509200pit,3429
2015092010,2015_02_BAL_OAK,2015,2,2015-09-20,Sunday,16:05,BAL,33,OAK,37,Home,4,70,56531,201509200rai,3433
2015092011,2015_02_MIA_JAX,2015,2,2015-09-20,Sunday,16:05,MIA,20,JAX,23,Home,3,43,56530,201509200jax,3434
2015092012,2015_02_DAL_PHI,2015,2,2015-09-20,Sunday,16:25,DAL,20,PHI,10,Home,-10,30,56532,201509200phi,3435
2015092013,2015_02_SEA_GB,2015,2,2015-09-20,Sunday,20:30,SEA,17,GB,27,Home,10,44,56533,201509200gnb,3436
2015092100,2015_02_NYJ_IND,2015,2,2015-09-21,Monday,20:30,NYJ,20,IND,7,Home,-13,27,56534,201509210clt,3437
2015092400,2015_03_WAS_NYG,2015,3,2015-09-24,Thursday,20:25,WAS,21,NYG,32,Home,11,53,56535,201509240nyg,3438
2015092700,2015_03_ATL_DAL,2015,3,2015-09-27,Sunday,13:00,ATL,39,DAL,28,Home,-11,67,56539,201509270dal,3442
2015092701,2015_03_NO_CAR,2015,3,2015-09-27,Sunday,13:00,NO,22,CAR,27,Home,5,49,56537,201509270car,3444
2015092702,2015_03_PHI_NYJ,2015,3,2015-09-27,Sunday,13:00,PHI,24,NYJ,17,Home,-7,41,56543,201509270nyj,3448
2015092703,2015_03_TB_HOU,2015,3,2015-09-27,Sunday,13:00,TB,9,HOU,19,Home,10,28,56540,201509270htx,3443
2015092704,2015_03_SD_MIN,2015,3,2015-09-27,Sunday,13:00,SD,14,MIN,31,Home,17,45,56541,201509270min,3441
2015092705,2015_03_PIT_STL,2015,3,2015-09-27,Sunday,13:00,PIT,12,STL,6,Home,-6,18,56544,201509270ram,3440
2015092706,2015_03_JAX_NE,2015,3,2015-09-27,Sunday,13:00,JAX,17,NE,51,Home,34,68,56542,201509270nwe,3447
2015092707,2015_03_CIN_BAL,2015,3,2015-09-27,Sunday,13:00,CIN,28,BAL,24,Home,-4,52,56536,201509270rav,3446
2015092708,2015_03_OAK_CLE,2015,3,2015-09-27,Sunday,13:00,OAK,27,CLE,20,Home,-7,47,56538,201509270cle,3445
2015092709,2015_03_IND_TEN,2015,3,2015-09-27,Sunday,13:00,IND,35,TEN,33,Home,-2,68,56545,201509270oti,3439
2015092710,2015_03_SF_ARI,2015,3,2015-09-27,Sunday,16:05,SF,7,ARI,47,Home,40,54,56546,201509270crd,3449
2015092711,2015_03_CHI_SEA,2015,3,2015-09-27,Sunday,16:25,CHI,0,SEA,26,Home,26,26,56548,201509270sea,3450
2015092712,2015_03_BUF_MIA,2015,3,2015-09-27,Sunday,16:25,BUF,41,MIA,14,Home,-27,55,56547,201509270mia,3451
2015092713,2015_03_DEN_DET,2015,3,2015-09-27,Sunday,20:30,DEN,24,DET,12,Home,-12,36,56549,201509270det,3452
2015092800,2015_03_KC_GB,2015,3,2015-09-28,Monday,20:30,KC,28,GB,38,Home,10,66,56550,201509280gnb,3453
2015100100,2015_04_BAL_PIT,2015,4,2015-10-01,Thursday,20:25,BAL,23,PIT,20,Home,-3,43,56551,201510010pit,3454
2015100400,2015_04_NYJ_MIA,2015,4,2015-10-04,Sunday,09:30,NYJ,27,MIA,14,Neutral,-13,41,56552,201510040mia,3466
2015100401,2015_04_OAK_CHI,2015,4,2015-10-04,Sunday,13:00,OAK,20,CHI,22,Home,2,42,56555,201510040chi,3455
2015100402,2015_04_HOU_ATL,2015,4,2015-10-04,Sunday,13:00,HOU,21,ATL,48,Home,27,69,56553,201510040atl,3458
2015100403,2015_04_KC_CIN,2015,4,2015-10-04,Sunday,13:00,KC,21,CIN,36,Home,15,57,56556,201510040cin,3456
2015100404,2015_04_JAX_IND,2015,4,2015-10-04,Sunday,13:00,JAX,13,IND,16,Home,3,29,56557,201510040clt,3457
2015100405,2015_04_PHI_WAS,2015,4,2015-10-04,Sunday,13:00,PHI,20,WAS,23,Home,3,43,56559,201510040was,3461
2015100406,2015_04_CAR_TB,2015,4,2015-10-04,Sunday,13:00,CAR,37,TB,23,Home,-14,60,56558,201510040tam,3460
2015100407,2015_04_NYG_BUF,2015,4,2015-10-04,Sunday,13:00,NYG,24,BUF,10,Home,-14,34,56554,201510040buf,3459
2015100408,2015_04_CLE_SD,2015,4,2015-10-04,Sunday,16:05,CLE,27,SD,30,Home,3,57,56560,201510040sdg,3462
2015100409,2015_04_GB_SF,2015,4,2015-10-04,Sunday,16:25,GB,17,SF,3,Home,-14,20,56563,201510040sfo,3463
2015100410,2015_04_STL_ARI,2015,4,2015-10-04,Sunday,16:25,STL,24,ARI,22,Home,-2,46,56561,201510040crd,3464
2015100411,2015_04_MIN_DEN,2015,4,2015-10-04,Sunday,16:25,MIN,20,DEN,23,Home,3,43,56562,201510040den,3465
2015100412,2015_04_DAL_NO,2015,4,2015-10-04,Sunday,20:30,DAL,20,NO,26,Home,6,46,56564,201510040nor,3467
2015100500,2015_04_DET_SEA,2015,4,2015-10-05,Monday,20:30,DET,10,SEA,13,Home,3,23,56565,201510050sea,3468
2015100800,2015_05_IND_HOU,2015,5,2015-10-08,Thursday,20:25,IND,27,HOU,20,Home,-7,47,56566,201510080htx,3469
2015101100,2015_05_NO_PHI,2015,5,2015-10-11,Sunday,13:00,NO,17,PHI,39,Home,22,56,56572,201510110phi,3474
2015101101,2015_05_CHI_KC,2015,5,2015-10-11,Sunday,13:00,CHI,18,KC,17,Home,-1,35,56571,201510110kan,3472
2015101102,2015_05_SEA_CIN,2015,5,2015-10-11,Sunday,13:00,SEA,24,CIN,27,Home,3,51,56569,201510110cin,3476
2015101103,2015_05_WAS_ATL,2015,5,2015-10-11,Sunday,13:00,WAS,19,ATL,25,Home,6,44,56567,201510110atl,3475
2015101104,2015_05_JAX_TB,2015,5,2015-10-11,Sunday,13:00,JAX,31,TB,38,Home,7,69,56573,201510110tam,3473
2015101105,2015_05_CLE_BAL,2015,5,2015-10-11,Sunday,13:00,CLE,33,BAL,30,Home,-3,63,56568,201510110rav,3477
2015101106,2015_05_BUF_TEN,2015,5,2015-10-11,Sunday,13:00,BUF,14,TEN,13,Home,-1,27,56574,201510110oti,3471
2015101107,2015_05_STL_GB,2015,5,2015-10-11,Sunday,13:00,STL,10,GB,24,Home,14,34,56570,201510110gnb,3470
2015101108,2015_05_ARI_DET,2015,5,2015-10-11,Sunday,16:05,ARI,42,DET,17,Home,-25,59,56575,201510110det,3480
2015101109,2015_05_NE_DAL,2015,5,2015-10-11,Sunday,16:25,NE,30,DAL,6,Home,-24,36,56576,201510110dal,3479
2015101110,2015_05_DEN_OAK,2015,5,2015-10-11,Sunday,16:25,DEN,16,OAK,10,Home,-6,26,56577,201510110rai,3478
2015101111,2015_05_SF_NYG,2015,5,2015-10-11,Sunday,20:30,SF,27,NYG,30,Home,3,57,56578,201510110nyg,3481
2015101200,2015_05_PIT_SD,2015,5,2015-10-12,Monday,20:30,PIT,24,SD,20,Home,-4,44,56579,201510120sdg,3482
2015101500,2015_06_ATL_NO,2015,6,2015-10-15,Thursday,20:25,ATL,21,NO,31,Home,10,52,56580,201510150nor,3483
2015101800,2015_06_CHI_DET,2015,6,2015-10-18,Sunday,13:00,CHI,34,DET,37,Home,3,71,56583,201510180det,3491
2015101801,2015_06_WAS_NYJ,2015,6,2015-10-18,Sunday,13:00,WAS,20,NYJ,34,Home,14,54,56586,201510180nyj,3489
2015101802,2015_06_ARI_PIT,2015,6,2015-10-18,Sunday,13:00,ARI,21,PIT,31,Home,10,52,56587,201510180pit,3486
2015101803,2015_06_KC_MIN,2015,6,2015-10-18,Sunday,13:00,KC,10,MIN,16,Home,6,26,56585,201510180min,3485
2015101804,2015_06_CIN_BUF,2015,6,2015-10-18,Sunday,13:00,CIN,34,BUF,21,Home,-13,55,56581,201510180buf,3490
2015101805,2015_06_DEN_CLE,2015,6,2015-10-18,Sunday,13:00,DEN,26,CLE,23,Home,-3,49,56582,201510180cle,3488
2015101806,2015_06_MIA_TEN,2015,6,2015-10-18,Sunday,13:00,MIA,38,TEN,10,Home,-28,48,56588,201510180oti,3484
2015101807,2015_06_HOU_JAX,2015,6,2015-10-18,Sunday,13:00,HOU,31,JAX,20,Home,-11,51,56584,201510180jax,3487
2015101808,2015_06_CAR_SEA,2015,6,2015-10-18,Sunday,16:05,CAR,27,SEA,23,Home,-4,50,56589,201510180sea,3492
2015101809,2015_06_SD_GB,2015,6,2015-10-18,Sunday,16:25,SD,20,GB,27,Home,7,47,56590,201510180gnb,3494
2015101810,2015_06_BAL_SF,2015,6,2015-10-18,Sunday,16:25,BAL,20,SF,25,Home,5,45,56591,201510180sfo,3493
2015101811,2015_06_NE_IND,2015,6,2015-10-18,Sunday,20:30,NE,34,IND,27,Home,-7,61,56592,201510180clt,3495
2015101900,2015_06_NYG_PHI,2015,6,2015-10-19,Monday,20:30,NYG,7,PHI,27,Home,20,34,56593,201510190phi,3496
2015102200,2015_07_SEA_SF,2015,7,2015-10-22,Thursday,20:25,SEA,20,SF,3,Home,-17,23,56594,201510220sfo,3497
2015102500,2015_07_BUF_JAX,2015,7,2015-10-25,Sunday,09:30,BUF,31,JAX,34,Neutral,3,65,56595,201510250jax,3507
2015102501,2015_07_CLE_STL,2015,7,2015-10-25,Sunday,13:00,CLE,6,STL,24,Home,18,30,56601,201510250ram,3499
2015102502,2015_07_HOU_MIA,2015,7,2015-10-25,Sunday,13:00,HOU,26,MIA,44,Home,18,70,56599,201510250mia,3503
2015102503,2015_07_NYJ_NE,2015,7,2015-10-25,Sunday,13:00,NYJ,23,NE,30,Home,7,53,56600,201510250nwe,3504
2015102504,2015_07_PIT_KC,2015,7,2015-10-25,Sunday,13:00,PIT,13,KC,23,Home,10,36,56598,201510250kan,3498
2015102505,2015_07_TB_WAS,2015,7,2015-10-25,Sunday,13:00,TB,30,WAS,31,Home,1,61,56603,201510250was,3505
2015102506,2015_07_MIN_DET,2015,7,2015-10-25,Sunday,13:00,MIN,28,DET,19,Home,-9,47,56596,201510250det,3502
2015102507,2015_07_NO_IND,2015,7,2015-10-25,Sunday,13:00,NO,27,IND,21,Home,-6,48,56597,201510250clt,3501
2015102508,2015_07_ATL_TEN,2015,7,2015-10-25,Sunday,13:00,ATL,10,TEN,7,Home,-3,17,56602,201510250oti,3500
2015102509,2015_07_OAK_SD,2015,7,2015-10-25,Sunday,16:05,OAK,37,SD,29,Home,-8,66,56604,201510250sdg,3506
2015102510,2015_07_DAL_NYG,2015,7,2015-10-25,Sunday,16:25,DAL,20,NYG,27,Home,7,47,56605,201510250nyg,3508
2015102511,2015_07_PHI_CAR,2015,7,2015-10-25,Sunday,20:30,PHI,16,CAR,27,Home,11,43,56606,201510250car,3509
2015102600,2015_07_BAL_ARI,2015,7,2015-10-26,Monday,20:30,BAL,18,ARI,26,Home,8,44,56607,201510260crd,3510
2015102900,2015_08_MIA_NE,2015,8,2015-10-29,Thursday,20:25,MIA,7,NE,36,Home,29,43,56608,201510290nwe,3511
2015110100,2015_08_DET_KC,2015,8,2015-11-01,Sunday,09:30,DET,10,KC,45,Neutral,35,55,56609,201511010kan,3521
2015110101,2015_08_SD_BAL,2015,8,2015-11-01,Sunday,13:00,SD,26,BAL,29,Home,3,55,56611,201511010rav,3516
2015110102,2015_08_CIN_PIT,2015,8,2015-11-01,Sunday,13:00,CIN,16,PIT,10,Home,-6,26,56616,201511010pit,3517
2015110103,2015_08_TEN_HOU,2015,8,2015-11-01,Sunday,13:00,TEN,6,HOU,20,Home,14,26,56614,201511010htx,3513
2015110104,2015_08_MIN_CHI,2015,8,2015-11-01,Sunday,13:00,MIN,23,CHI,20,Home,-3,43,56612,201511010chi,3515
2015110105,2015_08_TB_ATL,2015,8,2015-11-01,Sunday,13:00,TB,23,ATL,20,Home,-3,43,56610,201511010atl,3518
2015110106,2015_08_NYG_NO,2015,8,2015-11-01,Sunday,13:00,NYG,49,NO,52,Home,3,101,56615,201511010nor,3512
2015110107,2015_08_SF_STL,2015,8,2015-11-01,Sunday,13:00,SF,6,STL,27,Home,21,33,56617,201511010ram,3514
2015110108,2015_08_ARI_CLE,2015,8,2015-11-01,Sunday,13:00,ARI,34,CLE,20,Home,-14,54,56613,201511010cle,3519
2015110109,2015_08_NYJ_OAK,2015,8,2015-11-01,Sunday,16:05,NYJ,20,OAK,34,Home,14,54,56618,201511010rai,3520
2015110110,2015_08_SEA_DAL,2015,8,2015-11-01,Sunday,16:25,SEA,13,DAL,12,Home,-1,25,56619,201511010dal,3522
2015110111,2015_08_GB_DEN,2015,8,2015-11-01,Sunday,20:30,GB,10,DEN,29,Home,19,39,56620,201511010den,3523
2015110200,2015_08_IND_CAR,2015,8,2015-11-02,Monday,20:30,IND,26,CAR,29,Home,3,55,56621,201511020car,3524
2015110500,2015_09_CLE_CIN,2015,9,2015-11-05,Thursday,20:25,CLE,10,CIN,31,Home,21,41,56622,201511050cin,3525
2015110800,2015_09_STL_MIN,2015,9,2015-11-08,Sunday,13:00,STL,18,MIN,21,Home,3,39,56625,201511080min,3526
2015110801,2015_09_GB_CAR,2015,9,2015-11-08,Sunday,13:00,GB,29,CAR,37,Home,8,66,56624,201511080car,3531
2015110802,2015_09_WAS_NE,2015,9,2015-11-08,Sunday,13:00,WAS,10,NE,27,Home,17,37,56626,201511080nwe,3530
2015110803,2015_09_TEN_NO,2015,9,2015-11-08,Sunday,13:00,TEN,34,NO,28,Home,-6,62,56627,201511080nor,3527
2015110804,2015_09_MIA_BUF,2015,9,2015-11-08,Sunday,13:00,MIA,17,BUF,33,Home,16,50,56623,201511080buf,3532
2015110805,2015_09_JAX_NYJ,2015,9,2015-11-08,Sunday,13:00,JAX,23,NYJ,28,Home,5,51,56628,201511080nyj,3528
2015110806,2015_09_OAK_PIT,2015,9,2015-11-08,Sunday,13:00,OAK,35,PIT,38,Home,3,73,56629,201511080pit,3529
2015110807,2015_09_NYG_TB,2015,9,2015-11-08,Sunday,16:05,NYG,32,TB,18,Home,-14,50,56631,201511080tam,3534
2015110808,2015_09_ATL_SF,2015,9,2015-11-08,Sunday,16:05,ATL,16,SF,17,Home,1,33,56630,201511080sfo,3533
2015110809,2015_09_DEN_IND,2015,9,2015-11-08,Sunday,16:25,DEN,24,IND,27,Home,3,51,56632,201511080clt,3535
2015110810,2015_09_PHI_DAL,2015,9,2015-11-08,Sunday,20:30,PHI,18,DAL,21,Home,3,39,56633,201511080dal,3536
2015110900,2015_09_CHI_SD,2015,9,2015-11-09,Monday,20:30,CHI,22,SD,19,Home,-3,41,56634,201511090sdg,3537
2015111200,2015_10_BUF_NYJ,2015,10,2015-11-12,Thursday,20:25,BUF,22,NYJ,17,Home,-5,39,56635,201511120nyj,3538
2015111500,2015_10_NO_WAS,2015,10,2015-11-15,Sunday,13:00,NO,14,WAS,47,Home,33,61,56643,201511150was,3544
2015111501,2015_10_DET_GB,2015,10,2015-11-15,Sunday,13:00,DET,18,GB,16,Home,-2,34,56637,201511150gnb,3540
2015111502,2015_10_DAL_TB,2015,10,2015-11-15,Sunday,13:00,DAL,6,TB,10,Home,4,16,56641,201511150tam,3543
2015111503,2015_10_CAR_TEN,2015,10,2015-11-15,Sunday,13:00,CAR,27,TEN,10,Home,-17,37,56642,201511150oti,3541
2015111504,2015_10_CHI_STL,2015,10,2015-11-15,Sunday,13:00,CHI,37,STL,13,Home,-24,50,56640,201511150ram,3539
2015111505,2015_10_MIA_PHI,2015,10,2015-11-15,Sunday,13:00,MIA,20,PHI,19,Home,-1,39,56638,201511150phi,3545
2015111506,2015_10_JAX_BAL,2015,10,2015-11-15,Sunday,13:00,JAX,22,BAL,20,Home,-2,42,56636,201511150rav,3542
2015111507,2015_10_CLE_PIT,2015,10,2015-11-15,Sunday,13:00,CLE,9,PIT,30,Home,21,39,56639,201511150pit,3546
2015111508,2015_10_MIN_OAK,2015,10,2015-11-15,Sunday,16:05,MIN,30,OAK,14,Home,-16,44,56644,201511150rai,3547
2015111509,2015_10_NE_NYG,2015,10,2015-11-15,Sunday,16:25,NE,27,NYG,26,Home,-1,53,56646,201511150nyg,3549
2015111510,2015_10_KC_DEN,2015,10,2015-11-15,Sunday,16:25,KC,29,DEN,13,Home,-16,42,56645,201511150den,3548
2015111511,2015_10_ARI_SEA,2015,10,2015-11-15,Sunday,20:30,ARI,39,SEA,32,Home,-7,71,56647,201511150sea,3550
2015111600,2015_10_HOU_CIN,2015,10,2015-11-16,Monday,20:30,HOU,10,CIN,6,Home,-4,16,56648,201511160cin,3551
2015111900,2015_11_TEN_JAX,2015,11,2015-11-19,Thursday,20:25,TEN,13,JAX,19,Home,6,32,56649,201511190jax,3552
2015112200,2015_11_DEN_CHI,2015,11,2015-11-22,Sunday,13:00,DEN,17,CHI,15,Home,-2,32,56653,201511220chi,3554
2015112201,2015_11_OAK_DET,2015,11,2015-11-22,Sunday,13:00,OAK,13,DET,18,Home,5,31,56654,201511220det,3558
2015112202,2015_11_IND_ATL,2015,11,2015-11-22,Sunday,13:00,IND,24,ATL,21,Home,-3,45,56650,201511220atl,3560
2015112203,2015_11_NYJ_HOU,2015,11,2015-11-22,Sunday,13:00,NYJ,17,HOU,24,Home,7,41,56655,201511220htx,3553
2015112204,2015_11_TB_PHI,2015,11,2015-11-22,Sunday,13:00,TB,45,PHI,17,Home,-28,62,56658,201511220phi,3556
2015112205,2015_11_GB_MIN,2015,11,2015-11-22,Sunday,16:25,GB,30,MIN,13,Home,-17,43,56657,201511220min,3555
2015112206,2015_11_WAS_CAR,2015,11,2015-11-22,Sunday,13:00,WAS,16,CAR,44,Home,28,60,56652,201511220car,3561
2015112207,2015_11_DAL_MIA,2015,11,2015-11-22,Sunday,13:00,DAL,24,MIA,14,Home,-10,38,56656,201511220mia,3559
2015112208,2015_11_STL_BAL,2015,11,2015-11-22,Sunday,13:00,STL,13,BAL,16,Home,3,29,56651,201511220rav,3557
2015112209,2015_11_CIN_ARI,2015,11,2015-11-22,Sunday,20:30,CIN,31,ARI,34,Home,3,65,56659,201511220crd,3563
2015112210,2015_11_SF_SEA,2015,11,2015-11-22,Sunday,16:25,SF,13,SEA,29,Home,16,42,56660,201511220sea,3562
2015112211,2015_11_KC_SD,2015,11,2015-11-22,Sunday,16:05,KC,33,SD,3,Home,-30,36,56661,201511220sdg,3564
2015112300,2015_11_BUF_NE,2015,11,2015-11-23,Monday,20:30,BUF,13,NE,20,Home,7,33,56662,201511230nwe,3565
2015112600,2015_12_PHI_DET,2015,12,2015-11-26,Thursday,12:30,PHI,14,DET,45,Home,31,59,56663,201511260det,3566
2015112601,2015_12_CAR_DAL,2015,12,2015-11-26,Thursday,16:30,CAR,33,DAL,14,Home,-19,47,56664,201511260dal,3567
2015112602,2015_12_CHI_GB,2015,12,2015-11-26,Thursday,20:30,CHI,17,GB,13,Home,-4,30,56665,201511260gnb,3568
2015112900,2015_12_NYG_WAS,2015,12,2015-11-29,Sunday,13:00,NYG,14,WAS,20,Home,6,34,56674,201511290was,3572
2015112901,2015_12_MIN_ATL,2015,12,2015-11-29,Sunday,13:00,MIN,20,ATL,10,Home,-10,30,56666,201511290atl,3576
2015112902,2015_12_STL_CIN,2015,12,2015-11-29,Sunday,13:00,STL,7,CIN,31,Home,24,38,56667,201511290cin,3577
2015112903,2015_12_NO_HOU,2015,12,2015-11-29,Sunday,13:00,NO,6,HOU,24,Home,18,30,56668,201511290htx,3571
2015112904,2015_12_TB_IND,2015,12,2015-11-29,Sunday,13:00,TB,12,IND,25,Home,13,37,56669,201511290clt,3575
2015112905,2015_12_MIA_NYJ,2015,12,2015-11-29,Sunday,13:00,MIA,20,NYJ,38,Home,18,58,56672,201511290nyj,3574
2015112906,2015_12_SD_JAX,2015,12,2015-11-29,Sunday,13:00,SD,31,JAX,25,Home,-6,56,56670,201511290jax,3573
2015112907,2015_12_OAK_TEN,2015,12,2015-11-29,Sunday,13:00,OAK,24,TEN,21,Home,-3,45,56673,201511290oti,3569
2015112908,2015_12_BUF_KC,2015,12,2015-11-29,Sunday,13:00,BUF,22,KC,30,Home,8,52,56671,201511290kan,3570
2015112909,2015_12_ARI_SF,2015,12,2015-11-29,Sunday,16:05,ARI,19,SF,13,Home,-6,32,56675,201511290sfo,3578
2015112910,2015_12_PIT_SEA,2015,12,2015-11-29,Sunday,16:25,PIT,30,SEA,39,Home,9,69,56676,201511290sea,3579
2015112911,2015_12_NE_DEN,2015,12,2015-11-29,Sunday,20:30,NE,24,DEN,30,Home,6,54,56677,201511290den,3580
2015113000,2015_12_BAL_CLE,2015,12,2015-11-30,Monday,20:30,BAL,33,CLE,27,Home,-6,60,56678,201511300cle,3581
2015120300,2015_13_GB_DET,2015,13,2015-12-03,Thursday,20:25,GB,27,DET,23,Home,-4,50,56679,201512030det,3582
2015120600,2015_13_NYJ_NYG,2015,13,2015-12-06,Sunday,13:00,NYJ,23,NYG,20,Home,-3,43,56686,201512060nyg,3589
2015120601,2015_13_HOU_BUF,2015,13,2015-12-06,Sunday,13:00,HOU,21,BUF,30,Home,9,51,56680,201512060buf,3591
2015120602,2015_13_BAL_MIA,2015,13,2015-12-06,Sunday,13:00,BAL,13,MIA,15,Home,2,28,56683,201512060mia,3590
2015120603,2015_13_CIN_CLE,2015,13,2015-12-06,Sunday,13:00,CIN,37,CLE,3,Home,-34,40,56682,201512060cle,3592
2015120604,2015_13_JAX_TEN,2015,13,2015-12-06,Sunday,13:00,JAX,39,TEN,42,Home,3,81,56689,201512060oti,3583
2015120605,2015_13_SF_CHI,2015,13,2015-12-06,Sunday,13:00,SF,26,CHI,20,Home,-6,46,56681,201512060chi,3587
2015120606,2015_13_SEA_MIN,2015,13,2015-12-06,Sunday,13:00,SEA,38,MIN,7,Home,-31,45,56684,201512060min,3585
2015120607,2015_13_CAR_NO,2015,13,2015-12-06,Sunday,16:25,CAR,41,NO,38,Home,-3,79,56685,201512060nor,3586
2015120608,2015_13_ATL_TB,2015,13,2015-12-06,Sunday,13:00,ATL,19,TB,23,Home,4,42,56688,201512060tam,3588
2015120609,2015_13_ARI_STL,2015,13,2015-12-06,Sunday,13:00,ARI,27,STL,3,Home,-24,30,56687,201512060ram,3584
2015120610,2015_13_KC_OAK,2015,13,2015-12-06,Sunday,16:05,KC,34,OAK,20,Home,-14,54,56690,201512060rai,3593
2015120611,2015_13_DEN_SD,2015,13,2015-12-06,Sunday,16:05,DEN,17,SD,3,Home,-14,20,56691,201512060sdg,3594
2015120612,2015_13_PHI_NE,2015,13,2015-12-06,Sunday,16:25,PHI,35,NE,28,Home,-7,63,56692,201512060nwe,3595
2015120613,2015_13_IND_PIT,2015,13,2015-12-06,Sunday,20:30,IND,10,PIT,45,Home,35,55,56693,201512060pit,3596
2015120700,2015_13_DAL_WAS,2015,13,2015-12-07,Monday,20:30,DAL,19,WAS,16,Home,-3,35,56694,201512070was,3597
2015121000,2015_14_MIN_ARI,2015,14,2015-12-10,Thursday,20:25,MIN,20,ARI,23,Home,3,43,56695,201512100crd,3598
2015121300,2015_14_BUF_PHI,2015,14,2015-12-13,Sunday,13:00,BUF,20,PHI,23,Home,3,43,56704,201512130phi,3605
2015121301,2015_14_TEN_NYJ,2015,14,2015-12-13,Sunday,13:00,TEN,8,NYJ,30,Home,22,38,56703,201512130nyj,3604
2015121302,2015_14_PIT_CIN,2015,14,2015-12-13,Sunday,13:00,PIT,33,CIN,20,Home,-13,53,56698,201512130cin,3603
2015121303,2015_14_NE_HOU,2015,14,2015-12-13,Sunday,20:30,NE,27,HOU,6,Home,-21,33,56700,201512130htx,3599
2015121304,2015_14_IND_JAX,2015,14,2015-12-13,Sunday,13:00,IND,16,JAX,51,Home,35,67,56701,201512130jax,3608
2015121305,2015_14_SD_KC,2015,14,2015-12-13,Sunday,13:00,SD,3,KC,10,Home,7,13,56702,201512130kan,3601
2015121306,2015_14_WAS_CHI,2015,14,2015-12-13,Sunday,13:00,WAS,24,CHI,21,Home,-3,45,56697,201512130chi,3600
2015121307,2015_14_ATL_CAR,2015,14,2015-12-13,Sunday,13:00,ATL,0,CAR,38,Home,38,38,56696,201512130car,3607
2015121308,2015_14_NO_TB,2015,14,2015-12-13,Sunday,13:00,NO,24,TB,17,Home,-7,41,56706,201512130tam,3606
2015121309,2015_14_DET_STL,2015,14,2015-12-13,Sunday,13:00,DET,14,STL,21,Home,7,35,56705,201512130ram,3602
2015121310,2015_14_SF_CLE,2015,14,2015-12-13,Sunday,13:00,SF,10,CLE,24,Home,14,34,56699,201512130cle,3609
2015121311,2015_14_OAK_DEN,2015,14,2015-12-13,Sunday,16:05,OAK,15,DEN,12,Home,-3,27,56707,201512130den,3610
2015121312,2015_14_DAL_GB,2015,14,2015-12-13,Sunday,16:25,DAL,7,GB,28,Home,21,35,56708,201512130gnb,3611
2015121313,2015_14_SEA_BAL,2015,14,2015-12-13,Sunday,13:00,SEA,35,BAL,6,Home,-29,41,56709,201512130rav,3612
2015121400,2015_14_NYG_MIA,2015,14,2015-12-14,Monday,20:30,NYG,31,MIA,24,Home,-7,55,56710,201512140mia,3613
2015121700,2015_15_TB_STL,2015,15,2015-12-17,Thursday,20:25,TB,23,STL,31,Home,8,54,56711,201512170ram,3614
2015121900,2015_15_NYJ_DAL,2015,15,2015-12-19,Saturday,20:25,NYJ,19,DAL,16,Home,-3,35,56712,201512190dal,3615
2015122000,2015_15_CAR_NYG,2015,15,2015-12-20,Sunday,13:00,CAR,38,NYG,35,Home,-3,73,56718,201512200nyg,3619
2015122001,2015_15_ARI_PHI,2015,15,2015-12-20,Sunday,20:30,ARI,40,PHI,17,Home,-23,57,56719,201512200phi,3620
2015122002,2015_15_CHI_MIN,2015,15,2015-12-20,Sunday,13:00,CHI,17,MIN,38,Home,21,55,56716,201512200min,3616
2015122003,2015_15_ATL_JAX,2015,15,2015-12-20,Sunday,13:00,ATL,23,JAX,17,Home,-6,40,56715,201512200jax,3622
2015122004,2015_15_HOU_IND,2015,15,2015-12-20,Sunday,13:00,HOU,16,IND,10,Home,-6,26,56714,201512200clt,3618
2015122005,2015_15_TEN_NE,2015,15,2015-12-20,Sunday,13:00,TEN,16,NE,33,Home,17,49,56717,201512200nwe,3617
2015122006,2015_15_KC_BAL,2015,15,2015-12-20,Sunday,13:00,KC,38,BAL,35,Home,-3,73,56713,201512200rav,3623
2015122007,2015_15_BUF_WAS,2015,15,2015-12-20,Sunday,13:00,BUF,25,WAS,35,Home,10,60,56720,201512200was,3621
2015122008,2015_15_CLE_SEA,2015,15,2015-12-20,Sunday,16:05,CLE,13,SEA,30,Home,17,43,56722,201512200sea,3624
2015122009,2015_15_GB_OAK,2015,15,2015-12-20,Sunday,16:05,GB,30,OAK,20,Home,-10,50,56721,201512200rai,3625
2015122010,2015_15_DEN_PIT,2015,15,2015-12-20,Sunday,16:25,DEN,27,PIT,34,Home,7,61,56723,201512200pit,3627
2015122011,2015_15_MIA_SD,2015,15,2015-12-20,Sunday,16:25,MIA,14,SD,30,Home,16,44,56724,201512200sdg,3626
2015122012,2015_15_CIN_SF,2015,15,2015-12-20,Sunday,16:25,CIN,24,SF,14,Home,-10,38,56725,201512200sfo,3628
2015122100,2015_15_DET_NO,2015,15,2015-12-21,Monday,20:30,DET,35,NO,27,Home,-8,62,56726,201512210nor,3629
2015122400,2015_16_SD_OAK,2015,16,2015-12-24,Thursday,20:25,SD,20,OAK,23,Home,3,43,56727,201512240rai,3630
2015122600,2015_16_WAS_PHI,2015,16,2015-12-26,Saturday,20:25,WAS,38,PHI,24,Home,-14,62,56728,201512260phi,3631
2015122700,2015_16_JAX_NO,2015,16,2015-12-27,Sunday,16:05,JAX,27,NO,38,Home,11,65,56735,201512270nor,3633
2015122701,2015_16_IND_MIA,2015,16,2015-12-27,Sunday,13:00,IND,18,MIA,12,Home,-6,30,56733,201512270mia,3636
2015122702,2015_16_NE_NYJ,2015,16,2015-12-27,Sunday,13:00,NE,20,NYJ,26,Home,6,46,56736,201512270nyj,3637
2015122703,2015_16_HOU_TEN,2015,16,2015-12-27,Sunday,13:00,HOU,34,TEN,6,Home,-28,40,56738,201512270oti,3634
2015122704,2015_16_CLE_KC,2015,16,2015-12-27,Sunday,13:00,CLE,13,KC,17,Home,4,30,56732,201512270kan,3635
2015122705,2015_16_SF_DET,2015,16,2015-12-27,Sunday,13:00,SF,17,DET,32,Home,15,49,56731,201512270det,3639
2015122706,2015_16_NYG_MIN,2015,16,2015-12-27,Sunday,20:30,NYG,17,MIN,49,Home,32,66,56734,201512270min,3632
2015122707,2015_16_CAR_ATL,2015,16,2015-12-27,Sunday,13:00,CAR,13,ATL,20,Home,7,33,56729,201512270atl,3640
2015122708,2015_16_CHI_TB,2015,16,2015-12-27,Sunday,13:00,CHI,26,TB,21,Home,-5,47,56737,201512270tam,3638
2015122709,2015_16_DAL_BUF,2015,16,2015-12-27,Sunday,13:00,DAL,6,BUF,16,Home,10,22,56730,201512270buf,3641
2015122710,2015_16_GB_ARI,2015,16,2015-12-27,Sunday,16:25,GB,8,ARI,38,Home,30,46,56739,201512270crd,3643
2015122711,2015_16_STL_SEA,2015,16,2015-12-27,Sunday,16:25,STL,23,SEA,17,Home,-6,40,56740,201512270sea,3642
2015122712,2015_16_PIT_BAL,2015,16,2015-12-27,Sunday,13:00,PIT,17,BAL,20,Home,3,37,56741,201512270rav,3644
2015122800,2015_16_CIN_DEN,2015,16,2015-12-28,Monday,20:30,CIN,17,DEN,20,Home,3,37,56742,201512280den,3645
2016010300,2015_17_NYJ_BUF,2015,17,2016-01-03,Sunday,13:00,NYJ,17,BUF,22,Home,5,39,56744,201601030buf,3658
2016010301,2015_17_NE_MIA,2015,17,2016-01-03,Sunday,13:00,NE,10,MIA,20,Home,10,30,56754,201601030mia,3651
2016010302,2015_17_BAL_CIN,2015,17,2016-01-03,Sunday,13:00,BAL,16,CIN,24,Home,8,40,56747,201601030cin,3656
2016010303,2015_17_PIT_CLE,2015,17,2016-01-03,Sunday,13:00,PIT,28,CLE,12,Home,-16,40,56748,201601030cle,3654
2016010304,2015_17_JAX_HOU,2015,17,2016-01-03,Sunday,13:00,JAX,6,HOU,30,Home,24,36,56751,201601030htx,3650
2016010305,2015_17_TEN_IND,2015,17,2016-01-03,Sunday,13:00,TEN,24,IND,30,Home,6,54,56752,201601030clt,3655
2016010306,2015_17_OAK_KC,2015,17,2016-01-03,Sunday,16:25,OAK,17,KC,23,Home,6,40,56753,201601030kan,3649
2016010307,2015_17_WAS_DAL,2015,17,2016-01-03,Sunday,13:00,WAS,34,DAL,23,Home,-11,57,56749,201601030dal,3647
2016010308,2015_17_PHI_NYG,2015,17,2016-01-03,Sunday,13:00,PHI,35,NYG,30,Home,-5,65,56755,201601030nyg,3652
2016010309,2015_17_DET_CHI,2015,17,2016-01-03,Sunday,13:00,DET,24,CHI,20,Home,-4,44,56746,201601030chi,3646
2016010310,2015_17_MIN_GB,2015,17,2016-01-03,Sunday,20:30,MIN,20,GB,13,Home,-7,33,56750,201601030gnb,3648
2016010311,2015_17_NO_ATL,2015,17,2016-01-03,Sunday,13:00,NO,20,ATL,17,Home,-3,37,56743,201601030atl,3657
2016010312,2015_17_TB_CAR,2015,17,2016-01-03,Sunday,16:25,TB,10,CAR,38,Home,28,48,56745,201601030car,3653
2016010313,2015_17_SD_DEN,2015,17,2016-01-03,Sunday,16:25,SD,20,DEN,27,Home,7,47,56757,201601030den,3661
2016010314,2015_17_SEA_ARI,2015,17,2016-01-03,Sunday,16:25,SEA,36,ARI,6,Home,-30,42,56756,201601030crd,3660
2016010315,2015_17_STL_SF,2015,17,2016-01-03,Sunday,16:25,STL,16,SF,19,Home,3,35,56758,201601030sfo,3659
2016010900,2015_18_KC_HOU,2015,18,2016-01-09,Saturday,16:35,KC,30,HOU,0,Home,-30,30,56824,201601090htx,3662
2016010901,2015_18_PIT_CIN,2015,18,2016-01-09,Saturday,20:15,PIT,18,CIN,16,Home,-2,34,56825,201601090cin,3663
2016011000,2015_18_SEA_MIN,2015,18,2016-01-10,Sunday,13:05,SEA,10,MIN,9,Home,-1,19,56826,201601100min,3664
2016011001,2015_18_GB_WAS,2015,18,2016-01-10,Sunday,16:40,GB,35,WAS,18,Home,-17,53,56827,201601100was,3665
2016011600,2015_19_KC_NE,2015,19,2016-01-16,Saturday,16:35,KC,20,NE,27,Home,7,47,56828,201601160nwe,3666
2016011601,2015_19_GB_ARI,2015,19,2016-01-16,Saturday,20:15,GB,20,ARI,26,Home,6,46,56829,201601160crd,3667
2016011700,2015_19_SEA_CAR,2015,19,2016-01-17,Sunday,13:05,SEA,24,CAR,31,Home,7,55,56830,201601170car,3668
2016011701,2015_19_PIT_DEN,2015,19,2016-01-17,Sunday,16:40,PIT,16,DEN,23,Home,7,39,56831,201601170den,3669
2016012400,2015_20_NE_DEN,2015,20,2016-01-24,Sunday,15:05,NE,18,DEN,20,Home,2,38,56832,201601240den,3670
2016012401,2015_20_ARI_CAR,2015,20,2016-01-24,Sunday,18:40,ARI,15,CAR,49,Home,34,64,56833,201601240car,3671
2016020700,2015_21_CAR_DEN,2015,21,2016-02-07,Sunday,18:30,CAR,10,DEN,24,Neutral,14,34,56834,201602070den,3672
2016090800,2016_01_CAR_DEN,2016,1,2016-09-08,Thursday,20:30,CAR,20,DEN,21,Home,1,41,56901,201609080den,4094
2016091100,2016_01_TB_ATL,2016,1,2016-09-11,Sunday,13:00,TB,31,ATL,24,Home,-7,55,56902,201609110atl,4095
2016091101,2016_01_BUF_BAL,2016,1,2016-09-11,Sunday,13:00,BUF,7,BAL,13,Home,6,20,56903,201609110rav,4096
2016091102,2016_01_CHI_HOU,2016,1,2016-09-11,Sunday,13:00,CHI,14,HOU,23,Home,9,37,56904,201609110htx,4097
2016091103,2016_01_GB_JAX,2016,1,2016-09-11,Sunday,13:00,GB,27,JAX,23,Home,-4,50,56905,201609110jax,4098
2016091104,2016_01_SD_KC,2016,1,2016-09-11,Sunday,13:00,SD,27,KC,33,Home,6,60,56906,201609110kan,4099
2016091105,2016_01_OAK_NO,2016,1,2016-09-11,Sunday,13:00,OAK,35,NO,34,Home,-1,69,56907,201609110nor,4100
2016091106,2016_01_CIN_NYJ,2016,1,2016-09-11,Sunday,13:00,CIN,23,NYJ,22,Home,-1,45,56908,201609110nyj,4101
2016091107,2016_01_CLE_PHI,2016,1,2016-09-11,Sunday,13:00,CLE,10,PHI,29,Home,19,39,56909,201609110phi,4102
2016091108,2016_01_MIN_TEN,2016,1,2016-09-11,Sunday,13:00,MIN,25,TEN,21,Home,-4,46,56910,201609110oti,4103
2016091109,2016_01_MIA_SEA,2016,1,2016-09-11,Sunday,16:05,MIA,10,SEA,12,Home,2,22,56911,201609110sea,4104
2016091110,2016_01_NYG_DAL,2016,1,2016-09-11,Sunday,16:25,NYG,20,DAL,19,Home,-1,39,56912,201609110dal,4105
2016091111,2016_01_DET_IND,2016,1,2016-09-11,Sunday,16:25,DET,39,IND,35,Home,-4,74,56913,201609110clt,4106
2016091112,2016_01_NE_ARI,2016,1,2016-09-11,Sunday,20:30,NE,23,ARI,21,Home,-2,44,56914,201609110crd,4107
2016091200,2016_01_PIT_WAS,2016,1,2016-09-12,Monday,19:10,PIT,38,WAS,16,Home,-22,54,56915,201609120was,4108
2016091201,2016_01_LAR_SF,2016,1,2016-09-12,Monday,22:20,LAR,0,SF,28,Home,28,28,56916,201609120sfo,4109
2016091500,2016_02_NYJ_BUF,2016,2,2016-09-15,Thursday,20:25,NYJ,37,BUF,31,Home,-6,68,56917,201609150buf,4117
2016091800,2016_02_SF_CAR,2016,2,2016-09-18,Sunday,13:00,SF,27,CAR,46,Home,19,73,56918,201609180car,4118
2016091801,2016_02_BAL_CLE,2016,2,2016-09-18,Sunday,13:00,BAL,25,CLE,20,Home,-5,45,56919,201609180cle,4119
2016091802,2016_02_TEN_DET,2016,2,2016-09-18,Sunday,13:00,TEN,16,DET,15,Home,-1,31,56920,201609180det,4120
2016091803,2016_02_KC_HOU,2016,2,2016-09-18,Sunday,13:00,KC,12,HOU,19,Home,7,31,56921,201609180htx,4121
2016091804,2016_02_MIA_NE,2016,2,2016-09-18,Sunday,13:00,MIA,24,NE,31,Home,7,55,56922,201609180nwe,4122
2016091805,2016_02_NO_NYG,2016,2,2016-09-18,Sunday,13:00,NO,13,NYG,16,Home,3,29,56923,201609180nyg,4123
2016091806,2016_02_CIN_PIT,2016,2,2016-09-18,Sunday,13:00,CIN,16,PIT,24,Home,8,40,56924,201609180pit,4124
2016091807,2016_02_DAL_WAS,2016,2,2016-09-18,Sunday,13:00,DAL,27,WAS,23,Home,-4,50,56925,201609180was,4125
2016091808,2016_02_TB_ARI,2016,2,2016-09-18,Sunday,13:00,TB,7,ARI,40,Home,33,47,56926,201609180crd,4110
2016091809,2016_02_SEA_LAR,2016,2,2016-09-18,Sunday,16:05,SEA,3,LAR,9,Home,6,12,56927,201609180ram,4111
2016091810,2016_02_IND_DEN,2016,2,2016-09-18,Sunday,16:25,IND,20,DEN,34,Home,14,54,56928,201609180den,4112
2016091811,2016_02_ATL_OAK,2016,2,2016-09-18,Sunday,16:25,ATL,35,OAK,28,Home,-7,63,56929,201609180rai,4113
2016091812,2016_02_JAX_SD,2016,2,2016-09-18,Sunday,16:25,JAX,14,SD,38,Home,24,52,56930,201609180sdg,4114
2016091813,2016_02_GB_MIN,2016,2,2016-09-18,Sunday,20:30,GB,14,MIN,17,Home,3,31,56931,201609180min,4115
2016091900,2016_02_PHI_CHI,2016,2,2016-09-19,Monday,20:30,PHI,29,CHI,14,Home,-15,43,56932,201609190chi,4116
2016092200,2016_03_HOU_NE,2016,3,2016-09-22,Thursday,20:25,HOU,0,NE,27,Home,27,27,56933,201609220nwe,4126
2016092500,2016_03_ARI_BUF,2016,3,2016-09-25,Sunday,13:00,ARI,18,BUF,33,Home,15,51,56934,201609250buf,4127
2016092501,2016_03_MIN_CAR,2016,3,2016-09-25,Sunday,13:00,MIN,22,CAR,10,Home,-12,32,56935,201609250car,4128
2016092502,2016_03_DEN_CIN,2016,3,2016-09-25,Sunday,13:00,DEN,29,CIN,17,Home,-12,46,56936,201609250cin,4129
2016092503,2016_03_DET_GB,2016,3,2016-09-25,Sunday,13:00,DET,27,GB,34,Home,7,61,56937,201609250gnb,4130
2016092504,2016_03_BAL_JAX,2016,3,2016-09-25,Sunday,13:00,BAL,19,JAX,17,Home,-2,36,56938,201609250jax,4131
2016092505,2016_03_CLE_MIA,2016,3,2016-09-25,Sunday,13:00,CLE,24,MIA,30,Home,6,54,56939,201609250mia,4132
2016092506,2016_03_WAS_NYG,2016,3,2016-09-25,Sunday,13:00,WAS,29,NYG,27,Home,-2,56,56940,201609250nyg,4133
2016092507,2016_03_OAK_TEN,2016,3,2016-09-25,Sunday,13:00,OAK,17,TEN,10,Home,-7,27,56941,201609250oti,4134
2016092508,2016_03_SF_SEA,2016,3,2016-09-25,Sunday,16:05,SF,18,SEA,37,Home,19,55,56942,201609250sea,4135
2016092509,2016_03_LAR_TB,2016,3,2016-09-25,Sunday,16:05,LAR,37,TB,32,Home,-5,69,56943,201609250tam,4136
2016092510,2016_03_PIT_PHI,2016,3,2016-09-25,Sunday,16:25,PIT,3,PHI,34,Home,31,37,56946,201609250phi,4139
2016092511,2016_03_SD_IND,2016,3,2016-09-25,Sunday,16:25,SD,22,IND,26,Home,4,48,56944,201609250clt,4137
2016092512,2016_03_NYJ_KC,2016,3,2016-09-25,Sunday,16:25,NYJ,3,KC,24,Home,21,27,56945,201609250kan,4138
2016092513,2016_03_CHI_DAL,2016,3,2016-09-25,Sunday,20:30,CHI,17,DAL,31,Home,14,48,56947,201609250dal,4140
2016092600,2016_03_ATL_NO,2016,3,2016-09-26,Monday,20:30,ATL,45,NO,32,Home,-13,77,56948,201609260nor,4141
2016092900,2016_04_MIA_CIN,2016,4,2016-09-29,Thursday,20:25,MIA,7,CIN,22,Home,15,29,56949,201609290cin,4142
2016100200,2016_04_IND_JAX,2016,4,2016-10-02,Sunday,09:30,IND,27,JAX,30,Neutral,3,57,56950,201610020jax,4143
2016100201,2016_04_CAR_ATL,2016,4,2016-10-02,Sunday,13:00,CAR,33,ATL,48,Home,15,81,56951,201610020atl,4144
2016100202,2016_04_OAK_BAL,2016,4,2016-10-02,Sunday,13:00,OAK,28,BAL,27,Home,-1,55,56952,201610020rav,4145
2016100203,2016_04_DET_CHI,2016,4,2016-10-02,Sunday,13:00,DET,14,CHI,17,Home,3,31,56953,201610020chi,4146
2016100204,2016_04_TEN_HOU,2016,4,2016-10-02,Sunday,13:00,TEN,20,HOU,27,Home,7,47,56954,201610020htx,4147
2016100205,2016_04_BUF_NE,2016,4,2016-10-02,Sunday,13:00,BUF,16,NE,0,Home,-16,16,56955,201610020nwe,4148
2016100206,2016_04_SEA_NYJ,2016,4,2016-10-02,Sunday,13:00,SEA,27,NYJ,17,Home,-10,44,56956,201610020nyj,4149
2016100207,2016_04_CLE_WAS,2016,4,2016-10-02,Sunday,13:00,CLE,20,WAS,31,Home,11,51,56957,201610020was,4150
2016100208,2016_04_DEN_TB,2016,4,2016-10-02,Sunday,16:05,DEN,27,TB,7,Home,-20,34,56958,201610020tam,4151
2016100209,2016_04_LAR_ARI,2016,4,2016-10-02,Sunday,16:25,LAR,17,ARI,13,Home,-4,30,56959,201610020crd,4152
2016100210,2016_04_NO_SD,2016,4,2016-10-02,Sunday,16:25,NO,35,SD,34,Home,-1,69,56960,201610020sdg,4153
2016100211,2016_04_DAL_SF,2016,4,2016-10-02,Sunday,16:25,DAL,24,SF,17,Home,-7,41,56961,201610020sfo,4154
2016100212,2016_04_KC_PIT,2016,4,2016-10-02,Sunday,20:30,KC,14,PIT,43,Home,29,57,56962,201610020pit,4155
2016100300,2016_04_NYG_MIN,2016,4,2016-10-03,Monday,20:30,NYG,10,MIN,24,Home,14,34,56963,201610030min,4156
2016100600,2016_05_ARI_SF,2016,5,2016-10-06,Thursday,20:25,ARI,33,SF,21,Home,-12,54,56964,201610060sfo,4157
2016100900,2016_05_WAS_BAL,2016,5,2016-10-09,Sunday,13:00,WAS,16,BAL,10,Home,-6,26,56965,201610090rav,4158
2016100901,2016_05_NE_CLE,2016,5,2016-10-09,Sunday,13:00,NE,33,CLE,21,Home,-12,54,56966,201610090cle,4159
2016100902,2016_05_PHI_DET,2016,5,2016-10-09,Sunday,13:00,PHI,23,DET,24,Home,1,47,56967,201610090det,4160
2016100903,2016_05_CHI_IND,2016,5,2016-10-09,Sunday,13:00,CHI,23,IND,29,Home,6,52,56968,201610090clt,4161
2016100904,2016_05_TEN_MIA,2016,5,2016-10-09,Sunday,13:00,TEN,30,MIA,17,Home,-13,47,56969,201610090mia,4162
2016100905,2016_05_HOU_MIN,2016,5,2016-10-09,Sunday,13:00,HOU,13,MIN,31,Home,18,44,56970,201610090min,4163
2016100906,2016_05_NYJ_PIT,2016,5,2016-10-09,Sunday,13:00,NYJ,13,PIT,31,Home,18,44,56971,201610090pit,4164
2016100907,2016_05_ATL_DEN,2016,5,2016-10-09,Sunday,16:05,ATL,23,DEN,16,Home,-7,39,56972,201610090den,4165
2016100908,2016_05_CIN_DAL,2016,5,2016-10-09,Sunday,16:25,CIN,14,DAL,28,Home,14,42,56973,201610090dal,4166
2016100909,2016_05_BUF_LAR,2016,5,2016-10-09,Sunday,16:25,BUF,30,LAR,19,Home,-11,49,56974,201610090ram,4167
2016100910,2016_05_SD_OAK,2016,5,2016-10-09,Sunday,16:25,SD,31,OAK,34,Home,3,65,56975,201610090rai,4168
2016100911,2016_05_NYG_GB,2016,5,2016-10-09,Sunday,20:30,NYG,16,GB,23,Home,7,39,56976,201610090gnb,4169
2016101000,2016_05_TB_CAR,2016,5,2016-10-10,Monday,20:30,TB,17,CAR,14,Home,-3,31,56977,201610100car,4170
2016101300,2016_06_DEN_SD,2016,6,2016-10-13,Thursday,20:25,DEN,13,SD,21,Home,8,34,56978,201610130sdg,4171
2016101600,2016_06_SF_BUF,2016,6,2016-10-16,Sunday,13:00,SF,16,BUF,45,Home,29,61,56979,201610160buf,4172
2016101601,2016_06_JAX_CHI,2016,6,2016-10-16,Sunday,13:00,JAX,17,CHI,16,Home,-1,33,56980,201610160chi,4173
2016101602,2016_06_LAR_DET,2016,6,2016-10-16,Sunday,13:00,LAR,28,DET,31,Home,3,59,56981,201610160det,4174
2016101603,2016_06_PIT_MIA,2016,6,2016-10-16,Sunday,13:00,PIT,15,MIA,30,Home,15,45,56982,201610160mia,4175
2016101604,2016_06_CIN_NE,2016,6,2016-10-16,Sunday,13:00,CIN,17,NE,35,Home,18,52,56983,201610160nwe,4176
2016101605,2016_06_CAR_NO,2016,6,2016-10-16,Sunday,13:00,CAR,38,NO,41,Home,3,79,56984,201610160nor,4177
2016101606,2016_06_BAL_NYG,2016,6,2016-10-16,Sunday,13:00,BAL,23,NYG,27,Home,4,50,56985,201610160nyg,4178
2016101607,2016_06_CLE_TEN,2016,6,2016-10-16,Sunday,13:00,CLE,26,TEN,28,Home,2,54,56986,201610160oti,4179
2016101608,2016_06_PHI_WAS,2016,6,2016-10-16,Sunday,13:00,PHI,20,WAS,27,Home,7,47,56987,201610160was,4180
2016101609,2016_06_KC_OAK,2016,6,2016-10-16,Sunday,16:05,KC,26,OAK,10,Home,-16,36,56988,201610160rai,4181
2016101610,2016_06_DAL_GB,2016,6,2016-10-16,Sunday,16:25,DAL,30,GB,16,Home,-14,46,56989,201610160gnb,4182
2016101611,2016_06_ATL_SEA,2016,6,2016-10-16,Sunday,16:25,ATL,24,SEA,26,Home,2,50,56990,201610160sea,4183
2016101612,2016_06_IND_HOU,2016,6,2016-10-16,Sunday,20:30,IND,23,HOU,26,Home,3,49,56991,201610160htx,4184
2016101700,2016_06_NYJ_ARI,2016,6,2016-10-17,Monday,20:30,NYJ,3,ARI,28,Home,25,31,56992,201610170crd,4185
2016102000,2016_07_CHI_GB,2016,7,2016-10-20,Thursday,20:25,CHI,10,GB,26,Home,16,36,56993,201610200gnb,4190
2016102300,2016_07_NYG_LAR,2016,7,2016-10-23,Sunday,09:30,NYG,17,LAR,10,Neutral,-7,27,56994,201610230ram,4191
2016102301,2016_07_CLE_CIN,2016,7,2016-10-23,Sunday,13:00,CLE,17,CIN,31,Home,14,48,56995,201610230cin,4192
2016102302,2016_07_WAS_DET,2016,7,2016-10-23,Sunday,13:00,WAS,17,DET,20,Home,3,37,56996,201610230det,4193
2016102303,2016_07_OAK_JAX,2016,7,2016-10-23,Sunday,13:00,OAK,33,JAX,16,Home,-17,49,56997,201610230jax,4194
2016102304,2016_07_NO_KC,2016,7,2016-10-23,Sunday,13:00,NO,21,KC,27,Home,6,48,56998,201610230kan,4195
2016102305,2016_07_BUF_MIA,2016,7,2016-10-23,Sunday,13:00,BUF,25,MIA,28,Home,3,53,56999,201610230mia,4196
2016102306,2016_07_BAL_NYJ,2016,7,2016-10-23,Sunday,13:00,BAL,16,NYJ,24,Home,8,40,57000,201610230nyj,4197
2016102307,2016_07_MIN_PHI,2016,7,2016-10-23,Sunday,13:00,MIN,10,PHI,21,Home,11,31,57001,201610230phi,4198
2016102308,2016_07_IND_TEN,2016,7,2016-10-23,Sunday,13:00,IND,34,TEN,26,Home,-8,60,57002,201610230oti,4199
2016102309,2016_07_SD_ATL,2016,7,2016-10-23,Sunday,16:05,SD,33,ATL,30,Home,-3,63,57003,201610230atl,4200
2016102310,2016_07_TB_SF,2016,7,2016-10-23,Sunday,16:05,TB,34,SF,17,Home,-17,51,57004,201610230sfo,4186
2016102311,2016_07_NE_PIT,2016,7,2016-10-23,Sunday,16:25,NE,27,PIT,16,Home,-11,43,57005,201610230pit,4187
2016102312,2016_07_SEA_ARI,2016,7,2016-10-23,Sunday,20:30,SEA,6,ARI,6,Home,0,12,57006,201610230crd,4188
2016102400,2016_07_HOU_DEN,2016,7,2016-10-24,Monday,20:30,HOU,9,DEN,27,Home,18,36,57007,201610240den,4189
2016102700,2016_08_JAX_TEN,2016,8,2016-10-27,Thursday,20:25,JAX,22,TEN,36,Home,14,58,57008,201610270oti,4201
2016103000,2016_08_WAS_CIN,2016,8,2016-10-30,Sunday,09:30,WAS,27,CIN,27,Neutral,0,54,57009,201610300cin,4202
2016103001,2016_08_GB_ATL,2016,8,2016-10-30,Sunday,16:25,GB,32,ATL,33,Home,1,65,57010,201610300atl,4203
2016103002,2016_08_NE_BUF,2016,8,2016-10-30,Sunday,13:00,NE,41,BUF,25,Home,-16,66,57011,201610300buf,4204
2016103003,2016_08_NYJ_CLE,2016,8,2016-10-30,Sunday,13:00,NYJ,31,CLE,28,Home,-3,59,57012,201610300cle,4205
2016103004,2016_08_DET_HOU,2016,8,2016-10-30,Sunday,13:00,DET,13,HOU,20,Home,7,33,57013,201610300htx,4206
2016103005,2016_08_KC_IND,2016,8,2016-10-30,Sunday,13:00,KC,30,IND,14,Home,-16,44,57014,201610300clt,4207
2016103006,2016_08_SEA_NO,2016,8,2016-10-30,Sunday,13:00,SEA,20,NO,25,Home,5,45,57015,201610300nor,4208
2016103007,2016_08_OAK_TB,2016,8,2016-10-30,Sunday,13:00,OAK,30,TB,24,Home,-6,54,57016,201610300tam,4209
2016103008,2016_08_SD_DEN,2016,8,2016-10-30,Sunday,16:05,SD,19,DEN,27,Home,8,46,57017,201610300den,4210
2016103009,2016_08_ARI_CAR,2016,8,2016-10-30,Sunday,13:00,ARI,20,CAR,30,Home,10,50,57018,201610300car,4211
2016103010,2016_08_PHI_DAL,2016,8,2016-10-30,Sunday,20:30,PHI,23,DAL,29,Home,6,52,57019,201610300dal,4212
2016103100,2016_08_MIN_CHI,2016,8,2016-10-31,Monday,20:30,MIN,10,CHI,20,Home,10,30,57020,201610310chi,4213
2016110300,2016_09_ATL_TB,2016,9,2016-11-03,Thursday,20:25,ATL,43,TB,28,Home,-15,71,57021,201611030tam,4214
2016110600,2016_09_DEN_OAK,2016,9,2016-11-06,Sunday,20:30,DEN,20,OAK,30,Home,10,50,57032,201611060rai,4225
2016110601,2016_09_PIT_BAL,2016,9,2016-11-06,Sunday,13:00,PIT,14,BAL,21,Home,7,35,57022,201611060rav,4215
2016110602,2016_09_DAL_CLE,2016,9,2016-11-06,Sunday,13:00,DAL,35,CLE,10,Home,-25,45,57023,201611060cle,4216
2016110603,2016_09_JAX_KC,2016,9,2016-11-06,Sunday,13:00,JAX,14,KC,19,Home,5,33,57024,201611060kan,4217
2016110604,2016_09_NYJ_MIA,2016,9,2016-11-06,Sunday,13:00,NYJ,23,MIA,27,Home,4,50,57025,201611060mia,4218
2016110605,2016_09_DET_MIN,2016,9,2016-11-06,Sunday,13:00,DET,22,MIN,16,Home,-6,38,57026,201611060min,4219
2016110606,2016_09_PHI_NYG,2016,9,2016-11-06,Sunday,13:00,PHI,23,NYG,28,Home,5,51,57027,201611060nyg,4220
2016110607,2016_09_CAR_LAR,2016,9,2016-11-06,Sunday,16:05,CAR,13,LAR,10,Home,-3,23,57028,201611060ram,4221
2016110608,2016_09_NO_SF,2016,9,2016-11-06,Sunday,16:05,NO,41,SF,23,Home,-18,64,57029,201611060sfo,4222
2016110609,2016_09_IND_GB,2016,9,2016-11-06,Sunday,16:25,IND,31,GB,26,Home,-5,57,57030,201611060gnb,4223
2016110610,2016_09_TEN_SD,2016,9,2016-11-06,Sunday,16:25,TEN,35,SD,43,Home,8,78,57031,201611060sdg,4224
2016110700,2016_09_BUF_SEA,2016,9,2016-11-07,Monday,20:30,BUF,25,SEA,31,Home,6,56,57033,201611070sea,4226
2016111000,2016_10_CLE_BAL,2016,10,2016-11-10,Thursday,20:25,CLE,7,BAL,28,Home,21,35,57034,201611100rav,4227
2016111301,2016_10_KC_CAR,2016,10,2016-11-13,Sunday,13:00,KC,20,CAR,17,Home,-3,37,57035,201611130car,4228
2016111302,2016_10_HOU_JAX,2016,10,2016-11-13,Sunday,13:00,HOU,24,JAX,21,Home,-3,45,57036,201611130jax,4229
2016111303,2016_10_DEN_NO,2016,10,2016-11-13,Sunday,13:00,DEN,25,NO,23,Home,-2,48,57037,201611130nor,4230
2016111304,2016_10_LAR_NYJ,2016,10,2016-11-13,Sunday,13:00,LAR,9,NYJ,6,Home,-3,15,57038,201611130nyj,4231
2016111305,2016_10_ATL_PHI,2016,10,2016-11-13,Sunday,13:00,ATL,15,PHI,24,Home,9,39,57039,201611130phi,4232
2016111306,2016_10_CHI_TB,2016,10,2016-11-13,Sunday,13:00,CHI,10,TB,36,Home,26,46,57040,201611130tam,4233
2016111307,2016_10_GB_TEN,2016,10,2016-11-13,Sunday,13:00,GB,25,TEN,47,Home,22,72,57041,201611130oti,4234
2016111308,2016_10_MIN_WAS,2016,10,2016-11-13,Sunday,13:00,MIN,20,WAS,26,Home,6,46,57042,201611130was,4235
2016111309,2016_10_MIA_SD,2016,10,2016-11-13,Sunday,16:05,MIA,31,SD,24,Home,-7,55,57043,201611130sdg,4236
2016111310,2016_10_SF_ARI,2016,10,2016-11-13,Sunday,16:25,SF,20,ARI,23,Home,3,43,57044,201611130crd,4237
2016111311,2016_10_DAL_PIT,2016,10,2016-11-13,Sunday,16:25,DAL,35,PIT,30,Home,-5,65,57045,201611130pit,4238
2016111312,2016_10_SEA_NE,2016,10,2016-11-13,Sunday,20:30,SEA,31,NE,24,Home,-7,55,57046,201611130nwe,4239
2016111400,2016_10_CIN_NYG,2016,10,2016-11-14,Monday,20:30,CIN,20,NYG,21,Home,1,41,57047,201611140nyg,4240
2016111700,2016_11_NO_CAR,2016,11,2016-11-17,Thursday,20:25,NO,20,CAR,23,Home,3,43,57048,201611170car,4242
2016112000,2016_11_BUF_CIN,2016,11,2016-11-20,Sunday,13:00,BUF,16,CIN,12,Home,-4,28,57049,201611200cin,4243
2016112001,2016_11_PIT_CLE,2016,11,2016-11-20,Sunday,13:00,PIT,24,CLE,9,Home,-15,33,57050,201611200cle,4244
2016112002,2016_11_BAL_DAL,2016,11,2016-11-20,Sunday,13:00,BAL,17,DAL,27,Home,10,44,57051,201611200dal,4245
2016112003,2016_11_JAX_DET,2016,11,2016-11-20,Sunday,13:00,JAX,19,DET,26,Home,7,45,57052,201611200det,4246
2016112004,2016_11_TEN_IND,2016,11,2016-11-20,Sunday,13:00,TEN,17,IND,24,Home,7,41,57053,201611200clt,4247
2016112005,2016_11_TB_KC,2016,11,2016-11-20,Sunday,13:00,TB,19,KC,17,Home,-2,36,57054,201611200kan,4248
2016112006,2016_11_ARI_MIN,2016,11,2016-11-20,Sunday,13:00,ARI,24,MIN,30,Home,6,54,57055,201611200min,4249
2016112007,2016_11_CHI_NYG,2016,11,2016-11-20,Sunday,13:00,CHI,16,NYG,22,Home,6,38,57056,201611200nyg,4250
2016112008,2016_11_MIA_LAR,2016,11,2016-11-20,Sunday,16:05,MIA,14,LAR,10,Home,-4,24,57057,201611200ram,4251
2016112009,2016_11_NE_SF,2016,11,2016-11-20,Sunday,16:25,NE,30,SF,17,Home,-13,47,57058,201611200sfo,4252
2016112010,2016_11_PHI_SEA,2016,11,2016-11-20,Sunday,16:25,PHI,15,SEA,26,Home,11,41,57059,201611200sea,4253
2016112011,2016_11_GB_WAS,2016,11,2016-11-20,Sunday,20:30,GB,24,WAS,42,Home,18,66,57060,201611200was,4254
2016112100,2016_11_HOU_OAK,2016,11,2016-11-21,Monday,20:30,HOU,20,OAK,27,Neutral,7,47,57061,201611210rai,4241
2016112400,2016_12_MIN_DET,2016,12,2016-11-24,Thursday,12:30,MIN,13,DET,16,Home,3,29,57062,201611240det,4255
2016112401,2016_12_WAS_DAL,2016,12,2016-11-24,Thursday,16:30,WAS,26,DAL,31,Home,5,57,57063,201611240dal,4256
2016112402,2016_12_PIT_IND,2016,12,2016-11-24,Thursday,20:30,PIT,28,IND,7,Home,-21,35,57064,201611240clt,4257
2016112700,2016_12_ARI_ATL,2016,12,2016-11-27,Sunday,13:00,ARI,19,ATL,38,Home,19,57,57065,201611270atl,4258
2016112701,2016_12_CIN_BAL,2016,12,2016-11-27,Sunday,13:00,CIN,14,BAL,19,Home,5,33,57066,201611270rav,4259
2016112702,2016_12_JAX_BUF,2016,12,2016-11-27,Sunday,13:00,JAX,21,BUF,28,Home,7,49,57067,201611270buf,4260
2016112703,2016_12_TEN_CHI,2016,12,2016-11-27,Sunday,13:00,TEN,27,CHI,21,Home,-6,48,57068,201611270chi,4261
2016112704,2016_12_NYG_CLE,2016,12,2016-11-27,Sunday,13:00,NYG,27,CLE,13,Home,-14,40,57069,201611270cle,4262
2016112705,2016_12_SD_HOU,2016,12,2016-11-27,Sunday,13:00,SD,21,HOU,13,Home,-8,34,57070,201611270htx,4263
2016112706,2016_12_SF_MIA,2016,12,2016-11-27,Sunday,13:00,SF,24,MIA,31,Home,7,55,57071,201611270mia,4264
2016112707,2016_12_LAR_NO,2016,12,2016-11-27,Sunday,13:00,LAR,21,NO,49,Home,28,70,57072,201611270nor,4265
2016112708,2016_12_SEA_TB,2016,12,2016-11-27,Sunday,16:05,SEA,5,TB,14,Home,9,19,57073,201611270tam,4266
2016112709,2016_12_KC_DEN,2016,12,2016-11-27,Sunday,20:30,KC,30,DEN,27,Home,-3,57,57074,201611270den,4267
2016112710,2016_12_CAR_OAK,2016,12,2016-11-27,Sunday,16:25,CAR,32,OAK,35,Home,3,67,57075,201611270rai,4268
2016112711,2016_12_NE_NYJ,2016,12,2016-11-27,Sunday,16:25,NE,22,NYJ,17,Home,-5,39,57076,201611270nyj,4269
2016112800,2016_12_GB_PHI,2016,12,2016-11-28,Monday,20:30,GB,27,PHI,13,Home,-14,40,57077,201611280phi,4270
2016120100,2016_13_DAL_MIN,2016,13,2016-12-01,Thursday,20:25,DAL,17,MIN,15,Home,-2,32,57078,201612010min,4271
2016120400,2016_13_KC_ATL,2016,13,2016-12-04,Sunday,13:00,KC,29,ATL,28,Home,-1,57,57079,201612040atl,4272
2016120401,2016_13_MIA_BAL,2016,13,2016-12-04,Sunday,13:00,MIA,6,BAL,38,Home,32,44,57080,201612040rav,4273
2016120402,2016_13_SF_CHI,2016,13,2016-12-04,Sunday,13:00,SF,6,CHI,26,Home,20,32,57081,201612040chi,4274
2016120403,2016_13_PHI_CIN,2016,13,2016-12-04,Sunday,13:00,PHI,14,CIN,32,Home,18,46,57082,201612040cin,4275
2016120404,2016_13_HOU_GB,2016,13,2016-12-04,Sunday,13:00,HOU,13,GB,21,Home,8,34,57083,201612040gnb,4276
2016120405,2016_13_DEN_JAX,2016,13,2016-12-04,Sunday,13:00,DEN,20,JAX,10,Home,-10,30,57084,201612040jax,4277
2016120406,2016_13_LAR_NE,2016,13,2016-12-04,Sunday,13:00,LAR,10,NE,26,Home,16,36,57085,201612040nwe,4278
2016120407,2016_13_DET_NO,2016,13,2016-12-04,Sunday,13:00,DET,28,NO,13,Home,-15,41,57086,201612040nor,4279
2016120408,2016_13_BUF_OAK,2016,13,2016-12-04,Sunday,16:05,BUF,24,OAK,38,Home,14,62,57087,201612040rai,4280
2016120409,2016_13_WAS_ARI,2016,13,2016-12-04,Sunday,16:25,WAS,23,ARI,31,Home,8,54,57088,201612040crd,4281
2016120410,2016_13_NYG_PIT,2016,13,2016-12-04,Sunday,16:25,NYG,14,PIT,24,Home,10,38,57089,201612040pit,4282
2016120411,2016_13_TB_SD,2016,13,2016-12-04,Sunday,16:25,TB,28,SD,21,Home,-7,49,57090,201612040sdg,4283
2016120412,2016_13_CAR_SEA,2016,13,2016-12-04,Sunday,20:30,CAR,7,SEA,40,Home,33,47,57091,201612040sea,4284
2016120500,2016_13_IND_NYJ,2016,13,2016-12-05,Monday,20:30,IND,41,NYJ,10,Home,-31,51,57092,201612050nyj,4285
2016120800,2016_14_OAK_KC,2016,14,2016-12-08,Thursday,20:25,OAK,13,KC,21,Home,8,34,57093,201612080kan,4286
2016121100,2016_14_PIT_BUF,2016,14,2016-12-11,Sunday,13:00,PIT,27,BUF,20,Home,-7,47,57094,201612110buf,4287
2016121101,2016_14_SD_CAR,2016,14,2016-12-11,Sunday,13:00,SD,16,CAR,28,Home,12,44,57095,201612110car,4288
2016121102,2016_14_CIN_CLE,2016,14,2016-12-11,Sunday,13:00,CIN,23,CLE,10,Home,-13,33,57096,201612110cle,4289
2016121103,2016_14_CHI_DET,2016,14,2016-12-11,Sunday,13:00,CHI,17,DET,20,Home,3,37,57097,201612110det,4290
2016121104,2016_14_HOU_IND,2016,14,2016-12-11,Sunday,13:00,HOU,22,IND,17,Home,-5,39,57098,201612110clt,4291
2016121105,2016_14_MIN_JAX,2016,14,2016-12-11,Sunday,13:00,MIN,25,JAX,16,Home,-9,41,57099,201612110jax,4292
2016121106,2016_14_ARI_MIA,2016,14,2016-12-11,Sunday,13:00,ARI,23,MIA,26,Home,3,49,57100,201612110mia,4293
2016121107,2016_14_WAS_PHI,2016,14,2016-12-11,Sunday,13:00,WAS,27,PHI,22,Home,-5,49,57101,201612110phi,4294
2016121108,2016_14_NO_TB,2016,14,2016-12-11,Sunday,16:25,NO,11,TB,16,Home,5,27,57102,201612110tam,4295
2016121109,2016_14_DEN_TEN,2016,14,2016-12-11,Sunday,13:00,DEN,10,TEN,13,Home,3,23,57103,201612110oti,4296
2016121110,2016_14_NYJ_SF,2016,14,2016-12-11,Sunday,16:05,NYJ,23,SF,17,Home,-6,40,57104,201612110sfo,4297
2016121111,2016_14_SEA_GB,2016,14,2016-12-11,Sunday,16:25,SEA,10,GB,38,Home,28,48,57105,201612110gnb,4298
2016121112,2016_14_ATL_LAR,2016,14,2016-12-11,Sunday,16:25,ATL,42,LAR,14,Home,-28,56,57106,201612110ram,4299
2016121113,2016_14_DAL_NYG,2016,14,2016-12-11,Sunday,20:30,DAL,7,NYG,10,Home,3,17,57107,201612110nyg,4300
2016121200,2016_14_BAL_NE,2016,14,2016-12-12,Monday,20:30,BAL,23,NE,30,Home,7,53,57108,201612120nwe,4301
2016121500,2016_15_LAR_SEA,2016,15,2016-12-15,Thursday,20:25,LAR,3,SEA,24,Home,21,27,57109,201612150sea,4302
2016121700,2016_15_MIA_NYJ,2016,15,2016-12-17,Saturday,20:25,MIA,34,NYJ,13,Home,-21,47,57110,201612170nyj,4303
2016121800,2016_15_PHI_BAL,2016,15,2016-12-18,Sunday,13:00,PHI,26,BAL,27,Home,1,53,57111,201612180rav,4304
2016121801,2016_15_CLE_BUF,2016,15,2016-12-18,Sunday,13:00,CLE,13,BUF,33,Home,20,46,57112,201612180buf,4305
2016121802,2016_15_GB_CHI,2016,15,2016-12-18,Sunday,13:00,GB,30,CHI,27,Home,-3,57,57113,201612180chi,4306
2016121803,2016_15_TB_DAL,2016,15,2016-12-18,Sunday,20:30,TB,20,DAL,26,Home,6,46,57114,201612180dal,4314
2016121804,2016_15_JAX_HOU,2016,15,2016-12-18,Sunday,13:00,JAX,20,HOU,21,Home,1,41,57115,201612180htx,4315
2016121805,2016_15_TEN_KC,2016,15,2016-12-18,Sunday,13:00,TEN,19,KC,17,Home,-2,36,57116,201612180kan,4316
2016121806,2016_15_IND_MIN,2016,15,2016-12-18,Sunday,13:00,IND,34,MIN,6,Home,-28,40,57117,201612180min,4317
2016121807,2016_15_DET_NYG,2016,15,2016-12-18,Sunday,13:00,DET,6,NYG,17,Home,11,23,57118,201612180nyg,4307
2016121808,2016_15_NO_ARI,2016,15,2016-12-18,Sunday,16:05,NO,48,ARI,41,Home,-7,89,57119,201612180crd,4308
2016121809,2016_15_SF_ATL,2016,15,2016-12-18,Sunday,16:05,SF,13,ATL,41,Home,28,54,57120,201612180atl,4309
2016121810,2016_15_NE_DEN,2016,15,2016-12-18,Sunday,16:25,NE,16,DEN,3,Home,-13,19,57121,201612180den,4310
2016121811,2016_15_OAK_SD,2016,15,2016-12-18,Sunday,16:25,OAK,19,SD,16,Home,-3,35,57122,201612180sdg,4311
2016121812,2016_15_PIT_CIN,2016,15,2016-12-18,Sunday,13:00,PIT,24,CIN,20,Home,-4,44,57123,201612180cin,4312
2016121900,2016_15_CAR_WAS,2016,15,2016-12-19,Monday,20:30,CAR,26,WAS,15,Home,-11,41,57124,201612190was,4313
2016122200,2016_16_NYG_PHI,2016,16,2016-12-22,Thursday,20:25,NYG,19,PHI,24,Home,5,43,57125,201612220phi,4318
2016122400,2016_16_MIA_BUF,2016,16,2016-12-24,Saturday,13:00,MIA,34,BUF,31,Home,-3,65,57126,201612240buf,4319
2016122401,2016_16_ATL_CAR,2016,16,2016-12-24,Saturday,13:00,ATL,33,CAR,16,Home,-17,49,57127,201612240car,4320
2016122402,2016_16_WAS_CHI,2016,16,2016-12-24,Saturday,13:00,WAS,41,CHI,21,Home,-20,62,57128,201612240chi,4321
2016122403,2016_16_SD_CLE,2016,16,2016-12-24,Saturday,13:00,SD,17,CLE,20,Home,3,37,57129,201612240cle,4322
2016122404,2016_16_MIN_GB,2016,16,2016-12-24,Saturday,13:00,MIN,25,GB,38,Home,13,63,57130,201612240gnb,4323
2016122405,2016_16_TEN_JAX,2016,16,2016-12-24,Saturday,13:00,TEN,17,JAX,38,Home,21,55,57131,201612240jax,4324
2016122406,2016_16_NYJ_NE,2016,16,2016-12-24,Saturday,13:00,NYJ,3,NE,41,Home,38,44,57132,201612240nwe,4325
2016122407,2016_16_TB_NO,2016,16,2016-12-24,Saturday,16:25,TB,24,NO,31,Home,7,55,57133,201612240nor,4326
2016122408,2016_16_IND_OAK,2016,16,2016-12-24,Saturday,16:05,IND,25,OAK,33,Home,8,58,57134,201612240rai,4327
2016122409,2016_16_SF_LAR,2016,16,2016-12-24,Saturday,16:25,SF,22,LAR,21,Home,-1,43,57135,201612240ram,4328
2016122410,2016_16_ARI_SEA,2016,16,2016-12-24,Saturday,16:25,ARI,34,SEA,31,Home,-3,65,57136,201612240sea,4329
2016122411,2016_16_CIN_HOU,2016,16,2016-12-24,Saturday,20:25,CIN,10,HOU,12,Home,2,22,57137,201612240htx,4330
2016122500,2016_16_BAL_PIT,2016,16,2016-12-25,Sunday,16:30,BAL,27,PIT,31,Home,4,58,57138,201612250pit,4331
2016122501,2016_16_DEN_KC,2016,16,2016-12-25,Sunday,20:30,DEN,10,KC,33,Home,23,43,57139,201612250kan,4332
2016122600,2016_16_DET_DAL,2016,16,2016-12-26,Monday,20:30,DET,21,DAL,42,Home,21,63,57140,201612260dal,4333
2017010100,2016_17_NO_ATL,2016,17,2017-01-01,Sunday,16:25,NO,32,ATL,38,Home,6,70,57141,201701010atl,4334
2017010101,2016_17_BAL_CIN,2016,17,2017-01-01,Sunday,13:00,BAL,10,CIN,27,Home,17,37,57142,201701010cin,4335
2017010102,2016_17_GB_DET,2016,17,2017-01-01,Sunday,20:30,GB,31,DET,24,Home,-7,55,57143,201701010det,4336
2017010103,2016_17_JAX_IND,2016,17,2017-01-01,Sunday,13:00,JAX,20,IND,24,Home,4,44,57144,201701010clt,4337
2017010104,2016_17_NE_MIA,2016,17,2017-01-01,Sunday,13:00,NE,35,MIA,14,Home,-21,49,57145,201701010mia,4338
2017010105,2016_17_CHI_MIN,2016,17,2017-01-01,Sunday,13:00,CHI,10,MIN,38,Home,28,48,57146,201701010min,4339
2017010106,2016_17_BUF_NYJ,2016,17,2017-01-01,Sunday,13:00,BUF,10,NYJ,30,Home,20,40,57147,201701010nyj,4340
2017010107,2016_17_DAL_PHI,2016,17,2017-01-01,Sunday,13:00,DAL,13,PHI,27,Home,14,40,57148,201701010phi,4341
2017010108,2016_17_CLE_PIT,2016,17,2017-01-01,Sunday,13:00,CLE,24,PIT,27,Home,3,51,57149,201701010pit,4342
2017010109,2016_17_CAR_TB,2016,17,2017-01-01,Sunday,13:00,CAR,16,TB,17,Home,1,33,57150,201701010tam,4343
2017010110,2016_17_HOU_TEN,2016,17,2017-01-01,Sunday,13:00,HOU,17,TEN,24,Home,7,41,57151,201701010oti,4344
2017010111,2016_17_NYG_WAS,2016,17,2017-01-01,Sunday,16:25,NYG,19,WAS,10,Home,-9,29,57152,201701010was,4345
2017010112,2016_17_OAK_DEN,2016,17,2017-01-01,Sunday,16:25,OAK,6,DEN,24,Home,18,30,57153,201701010den,4346
2017010113,2016_17_ARI_LAR,2016,17,2017-01-01,Sunday,16:25,ARI,44,LAR,6,Home,-38,50,57154,201701010ram,4347
2017010114,2016_17_KC_SD,2016,17,2017-01-01,Sunday,16:25,KC,37,SD,27,Home,-10,64,57155,201701010sdg,4348
2017010115,2016_17_SEA_SF,2016,17,2017-01-01,Sunday,16:25,SEA,25,SF,23,Home,-2,48,57156,201701010sfo,4349
2017010700,2016_18_OAK_HOU,2016,18,2017-01-07,Saturday,16:35,OAK,14,HOU,27,Home,13,41,57157,201701070htx,4350
2017010701,2016_18_DET_SEA,2016,18,2017-01-07,Saturday,20:15,DET,6,SEA,26,Home,20,32,57158,201701070sea,4351
2017010800,2016_18_MIA_PIT,2016,18,2017-01-08,Sunday,13:05,MIA,12,PIT,30,Home,18,42,57159,201701080pit,4352
2017010801,2016_18_NYG_GB,2016,18,2017-01-08,Sunday,16:40,NYG,13,GB,38,Home,25,51,57160,201701080gnb,4353
2017011400,2016_19_SEA_ATL,2016,19,2017-01-14,Saturday,16:35,SEA,20,ATL,36,Home,16,56,57161,201701140atl,4354
2017011401,2016_19_HOU_NE,2016,19,2017-01-14,Saturday,20:15,HOU,16,NE,34,Home,18,50,57162,201701140nwe,4355
2017011500,2016_19_PIT_KC,2016,19,2017-01-15,Sunday,20:20,PIT,18,KC,16,Home,-2,34,57163,201701150kan,4356
2017011501,2016_19_GB_DAL,2016,19,2017-01-15,Sunday,16:40,GB,34,DAL,31,Home,-3,65,57164,201701150dal,4357
2017012200,2016_20_GB_ATL,2016,20,2017-01-22,Sunday,15:05,GB,21,ATL,44,Home,23,65,57165,201701220atl,4359
2017012201,2016_20_PIT_NE,2016,20,2017-01-22,Sunday,18:40,PIT,17,NE,36,Home,19,53,57166,201701220nwe,4360
2017020500,2016_21_NE_ATL,2016,21,2017-02-05,Sunday,18:30,NE,34,ATL,28,Neutral,-6,62,57167,201702050atl,4361
2017090700,2017_01_KC_NE,2017,1,2017-09-07,Thursday,20:30,KC,42,NE,27,Home,-15,69,57234,201709070nwe,7922
2017091000,2017_01_NYJ_BUF,2017,1,2017-09-10,Sunday,13:00,NYJ,12,BUF,21,Home,9,33,57235,201709100buf,7927
2017091001,2017_01_ATL_CHI,2017,1,2017-09-10,Sunday,13:00,ATL,23,CHI,17,Home,-6,40,57236,201709100chi,7924
2017091002,2017_01_BAL_CIN,2017,1,2017-09-10,Sunday,13:00,BAL,20,CIN,0,Home,-20,20,57237,201709100cin,7925
2017091003,2017_01_PIT_CLE,2017,1,2017-09-10,Sunday,13:00,PIT,21,CLE,18,Home,-3,39,57238,201709100cle,7930
2017091004,2017_01_ARI_DET,2017,1,2017-09-10,Sunday,13:00,ARI,23,DET,35,Home,12,58,57239,201709100det,7923
2017091005,2017_01_JAX_HOU,2017,1,2017-09-10,Sunday,13:00,JAX,29,HOU,7,Home,-22,36,57240,201709100htx,7926
2017091007,2017_01_OAK_TEN,2017,1,2017-09-10,Sunday,13:00,OAK,26,TEN,16,Home,-10,42,57242,201709100oti,7928
2017091008,2017_01_PHI_WAS,2017,1,2017-09-10,Sunday,13:00,PHI,30,WAS,17,Home,-13,47,57243,201709100was,7929
2017091009,2017_01_IND_LAR,2017,1,2017-09-10,Sunday,16:05,IND,9,LAR,46,Home,37,55,57244,201709100ram,7932
2017091010,2017_01_SEA_GB,2017,1,2017-09-10,Sunday,16:25,SEA,9,GB,17,Home,8,26,57245,201709100gnb,7934
2017091011,2017_01_CAR_SF,2017,1,2017-09-10,Sunday,16:25,CAR,23,SF,3,Home,-20,26,57246,201709100sfo,7933
2017091012,2017_01_NYG_DAL,2017,1,2017-09-10,Sunday,20:30,NYG,3,DAL,19,Home,16,22,57247,201709100dal,7935
2017091100,2017_01_NO_MIN,2017,1,2017-09-11,Monday,19:10,NO,19,MIN,29,Home,10,48,57248,201709110min,7936
2017091101,2017_01_LAC_DEN,2017,1,2017-09-11,Monday,22:20,LAC,21,DEN,24,Home,3,45,57249,201709110den,7937
2017091400,2017_02_HOU_CIN,2017,2,2017-09-14,Thursday,20:25,HOU,13,CIN,9,Home,-4,22,57250,201709140cin,7938
2017091700,2017_02_CLE_BAL,2017,2,2017-09-17,Sunday,13:00,CLE,10,BAL,24,Home,14,34,57251,201709170rav,7942
2017091701,2017_02_BUF_CAR,2017,2,2017-09-17,Sunday,13:00,BUF,3,CAR,9,Home,6,12,57252,201709170car,7940
2017091702,2017_02_ARI_IND,2017,2,2017-09-17,Sunday,13:00,ARI,16,IND,13,Home,-3,29,57253,201709170clt,7939
2017091703,2017_02_TEN_JAX,2017,2,2017-09-17,Sunday,13:00,TEN,37,JAX,16,Home,-21,53,57254,201709170jax,7946
2017091704,2017_02_PHI_KC,2017,2,2017-09-17,Sunday,13:00,PHI,20,KC,27,Home,7,47,57255,201709170kan,7945
2017091705,2017_02_NE_NO,2017,2,2017-09-17,Sunday,13:00,NE,36,NO,20,Home,-16,56,57256,201709170nor,7944
2017091706,2017_02_MIN_PIT,2017,2,2017-09-17,Sunday,13:00,MIN,9,PIT,26,Home,17,35,57257,201709170pit,7943
2017091707,2017_02_CHI_TB,2017,2,2017-09-17,Sunday,13:00,CHI,7,TB,29,Home,22,36,57258,201709170tam,7941
2017091708,2017_02_MIA_LAC,2017,2,2017-09-17,Sunday,16:05,MIA,19,LAC,17,Home,-2,36,57259,201709170sdg,7947
2017091709,2017_02_NYJ_OAK,2017,2,2017-09-17,Sunday,16:05,NYJ,20,OAK,45,Home,25,65,57260,201709170rai,7948
2017091710,2017_02_DAL_DEN,2017,2,2017-09-17,Sunday,16:25,DAL,17,DEN,42,Home,25,59,57261,201709170den,7949
2017091711,2017_02_WAS_LAR,2017,2,2017-09-17,Sunday,16:25,WAS,27,LAR,20,Home,-7,47,57262,201709170ram,7951
2017091712,2017_02_SF_SEA,2017,2,2017-09-17,Sunday,16:25,SF,9,SEA,12,Home,3,21,57263,201709170sea,7950
2017091713,2017_02_GB_ATL,2017,2,2017-09-17,Sunday,20:30,GB,23,ATL,34,Home,11,57,57264,201709170atl,7952
2017091800,2017_02_DET_NYG,2017,2,2017-09-18,Monday,20:30,DET,24,NYG,10,Home,-14,34,57265,201709180nyg,7953
2017092100,2017_03_LAR_SF,2017,3,2017-09-21,Thursday,20:25,LAR,41,SF,39,Home,-2,80,57266,201709210sfo,7954
2017092400,2017_03_BAL_JAX,2017,3,2017-09-24,Sunday,21:30,BAL,7,JAX,44,Neutral,37,51,57267,201709240jax,7955
2017092401,2017_03_DEN_BUF,2017,3,2017-09-24,Sunday,13:00,DEN,16,BUF,26,Home,10,42,57268,201709240buf,7958
2017092402,2017_03_NO_CAR,2017,3,2017-09-24,Sunday,13:00,NO,34,CAR,13,Home,-21,47,57269,201709240car,7961
2017092403,2017_03_PIT_CHI,2017,3,2017-09-24,Sunday,13:00,PIT,17,CHI,23,Home,6,40,57270,201709240chi,7963
2017092404,2017_03_ATL_DET,2017,3,2017-09-24,Sunday,13:00,ATL,30,DET,26,Home,-4,56,57271,201709240det,7956
2017092405,2017_03_CLE_IND,2017,3,2017-09-24,Sunday,13:00,CLE,28,IND,31,Home,3,59,57272,201709240clt,7957
2017092406,2017_03_TB_MIN,2017,3,2017-09-24,Sunday,13:00,TB,17,MIN,34,Home,17,51,57273,201709240min,7964
2017092407,2017_03_HOU_NE,2017,3,2017-09-24,Sunday,13:00,HOU,33,NE,36,Home,3,69,57274,201709240nwe,7959
2017092408,2017_03_MIA_NYJ,2017,3,2017-09-24,Sunday,13:00,MIA,6,NYJ,20,Home,14,26,57275,201709240nyj,7960
2017092409,2017_03_NYG_PHI,2017,3,2017-09-24,Sunday,13:00,NYG,24,PHI,27,Home,3,51,57276,201709240phi,7962
2017092410,2017_03_SEA_TEN,2017,3,2017-09-24,Sunday,16:05,SEA,27,TEN,33,Home,6,60,57277,201709240oti,7965
2017092411,2017_03_CIN_GB,2017,3,2017-09-24,Sunday,16:25,CIN,24,GB,27,Home,3,51,57278,201709240gnb,7966
2017092412,2017_03_KC_LAC,2017,3,2017-09-24,Sunday,16:25,KC,24,LAC,10,Home,-14,34,57279,201709240sdg,7967
2017092413,2017_03_OAK_WAS,2017,3,2017-09-24,Sunday,20:30,OAK,10,WAS,27,Home,17,37,57280,201709240was,7968
2017092500,2017_03_DAL_ARI,2017,3,2017-09-25,Monday,20:30,DAL,28,ARI,17,Home,-11,45,57281,201709250crd,7969
2017092800,2017_04_CHI_GB,2017,4,2017-09-28,Thursday,20:25,CHI,14,GB,35,Home,21,49,57282,201709280gnb,7970
2017100100,2017_04_NO_MIA,2017,4,2017-10-01,Sunday,21:30,NO,20,MIA,0,Neutral,-20,20,57283,201710010mia,7971
2017100101,2017_04_BUF_ATL,2017,4,2017-10-01,Sunday,13:00,BUF,23,ATL,17,Home,-6,40,57284,201710010atl,7972
2017100102,2017_04_PIT_BAL,2017,4,2017-10-01,Sunday,13:00,PIT,26,BAL,9,Home,-17,35,57285,201710010rav,7978
2017100103,2017_04_CIN_CLE,2017,4,2017-10-01,Sunday,13:00,CIN,31,CLE,7,Home,-24,38,57286,201710010cle,7974
2017100104,2017_04_LAR_DAL,2017,4,2017-10-01,Sunday,13:00,LAR,35,DAL,30,Home,-5,65,57287,201710010dal,7977
2017100105,2017_04_TEN_HOU,2017,4,2017-10-01,Sunday,13:00,TEN,14,HOU,57,Home,43,71,57288,201710010htx,7979
2017100106,2017_04_DET_MIN,2017,4,2017-10-01,Sunday,13:00,DET,14,MIN,7,Home,-7,21,57289,201710010min,7975
2017100107,2017_04_CAR_NE,2017,4,2017-10-01,Sunday,13:00,CAR,33,NE,30,Home,-3,63,57290,201710010nwe,7973
2017100108,2017_04_JAX_NYJ,2017,4,2017-10-01,Sunday,13:00,JAX,20,NYJ,23,Home,3,43,57291,201710010nyj,7976
2017100109,2017_04_SF_ARI,2017,4,2017-10-01,Sunday,16:05,SF,15,ARI,18,Home,3,33,57292,201710010crd,7982
2017100110,2017_04_PHI_LAC,2017,4,2017-10-01,Sunday,16:05,PHI,26,LAC,24,Home,-2,50,57293,201710010sdg,7981
2017100111,2017_04_NYG_TB,2017,4,2017-10-01,Sunday,16:05,NYG,23,TB,25,Home,2,48,57294,201710010tam,7980
2017100112,2017_04_OAK_DEN,2017,4,2017-10-01,Sunday,16:25,OAK,10,DEN,16,Home,6,26,57295,201710010den,7983
2017100113,2017_04_IND_SEA,2017,4,2017-10-01,Sunday,20:30,IND,18,SEA,46,Home,28,64,57296,201710010sea,7984
2017100200,2017_04_WAS_KC,2017,4,2017-10-02,Monday,20:30,WAS,20,KC,29,Home,9,49,57297,201710020kan,7985
2017100500,2017_05_NE_TB,2017,5,2017-10-05,Thursday,20:25,NE,19,TB,14,Home,-5,33,57298,201710050tam,7986
2017100800,2017_05_BUF_CIN,2017,5,2017-10-08,Sunday,13:00,BUF,16,CIN,20,Home,4,36,57299,201710080cin,7988
2017100801,2017_05_NYJ_CLE,2017,5,2017-10-08,Sunday,13:00,NYJ,17,CLE,14,Home,-3,31,57300,201710080cle,7992
2017100802,2017_05_CAR_DET,2017,5,2017-10-08,Sunday,13:00,CAR,27,DET,24,Home,-3,51,57301,201710080det,7989
2017100803,2017_05_SF_IND,2017,5,2017-10-08,Sunday,13:00,SF,23,IND,26,Home,3,49,57302,201710080clt,7993
2017100804,2017_05_TEN_MIA,2017,5,2017-10-08,Sunday,13:00,TEN,10,MIA,16,Home,6,26,57303,201710080mia,7994
2017100805,2017_05_LAC_NYG,2017,5,2017-10-08,Sunday,13:00,LAC,27,NYG,22,Home,-5,49,57304,201710080nyg,7991
2017100806,2017_05_ARI_PHI,2017,5,2017-10-08,Sunday,13:00,ARI,7,PHI,34,Home,27,41,57305,201710080phi,7987
2017100807,2017_05_JAX_PIT,2017,5,2017-10-08,Sunday,13:00,JAX,30,PIT,9,Home,-21,39,57306,201710080pit,7990
2017100808,2017_05_SEA_LAR,2017,5,2017-10-08,Sunday,16:05,SEA,16,LAR,10,Home,-6,26,57307,201710080ram,7996
2017100809,2017_05_BAL_OAK,2017,5,2017-10-08,Sunday,16:05,BAL,30,OAK,17,Home,-13,47,57308,201710080rai,7995
2017100810,2017_05_GB_DAL,2017,5,2017-10-08,Sunday,16:25,GB,35,DAL,31,Home,-4,66,57309,201710080dal,7997
2017100811,2017_05_KC_HOU,2017,5,2017-10-08,Sunday,20:30,KC,42,HOU,34,Home,-8,76,57310,201710080htx,7998
2017100900,2017_05_MIN_CHI,2017,5,2017-10-09,Monday,20:30,MIN,20,CHI,17,Home,-3,37,57311,201710090chi,7999
2017101200,2017_06_PHI_CAR,2017,6,2017-10-12,Thursday,20:25,PHI,28,CAR,23,Home,-5,51,57312,201710120car,8000
2017101500,2017_06_MIA_ATL,2017,6,2017-10-15,Sunday,13:00,MIA,20,ATL,17,Home,-3,37,57313,201710150atl,8005
2017101501,2017_06_CHI_BAL,2017,6,2017-10-15,Sunday,13:00,CHI,27,BAL,24,Home,-3,51,57314,201710150rav,8001
2017101502,2017_06_CLE_HOU,2017,6,2017-10-15,Sunday,13:00,CLE,17,HOU,33,Home,16,50,57315,201710150htx,8002
2017101503,2017_06_GB_MIN,2017,6,2017-10-15,Sunday,13:00,GB,10,MIN,23,Home,13,33,57316,201710150min,8004
2017101504,2017_06_DET_NO,2017,6,2017-10-15,Sunday,13:00,DET,38,NO,52,Home,14,90,57317,201710150nor,8003
2017101505,2017_06_NE_NYJ,2017,6,2017-10-15,Sunday,13:00,NE,24,NYJ,17,Home,-7,41,57318,201710150nyj,8006
2017101506,2017_06_SF_WAS,2017,6,2017-10-15,Sunday,13:00,SF,24,WAS,26,Home,2,50,57319,201710150was,8007
2017101507,2017_06_TB_ARI,2017,6,2017-10-15,Sunday,16:05,TB,33,ARI,38,Home,5,71,57320,201710150crd,8009
2017101508,2017_06_LAR_JAX,2017,6,2017-10-15,Sunday,16:05,LAR,27,JAX,17,Home,-10,44,57321,201710150jax,8008
2017101509,2017_06_PIT_KC,2017,6,2017-10-15,Sunday,16:25,PIT,19,KC,13,Home,-6,32,57322,201710150kan,8011
2017101510,2017_06_LAC_OAK,2017,6,2017-10-15,Sunday,16:25,LAC,17,OAK,16,Home,-1,33,57323,201710150rai,8010
2017101511,2017_06_NYG_DEN,2017,6,2017-10-15,Sunday,20:30,NYG,23,DEN,10,Home,-13,33,57324,201710150den,8012
2017101600,2017_06_IND_TEN,2017,6,2017-10-16,Monday,20:30,IND,22,TEN,36,Home,14,58,57325,201710160oti,8013
2017101900,2017_07_KC_OAK,2017,7,2017-10-19,Thursday,20:25,KC,30,OAK,31,Home,1,61,57326,201710190rai,8014
2017102200,2017_07_TB_BUF,2017,7,2017-10-22,Sunday,13:00,TB,27,BUF,30,Home,3,57,57327,201710220buf,8022
2017102201,2017_07_CAR_CHI,2017,7,2017-10-22,Sunday,13:00,CAR,3,CHI,17,Home,14,20,57328,201710220chi,8017
2017102202,2017_07_TEN_CLE,2017,7,2017-10-22,Sunday,13:00,TEN,12,CLE,9,Home,-3,21,57329,201710220cle,8023
2017102203,2017_07_NO_GB,2017,7,2017-10-22,Sunday,13:00,NO,26,GB,17,Home,-9,43,57330,201710220gnb,8020
2017102204,2017_07_JAX_IND,2017,7,2017-10-22,Sunday,13:00,JAX,27,IND,0,Home,-27,27,57331,201710220clt,8019
2017102205,2017_07_ARI_LAR,2017,7,2017-10-22,Sunday,13:00,ARI,0,LAR,33,Neutral,33,33,57332,201710220ram,8015
2017102206,2017_07_NYJ_MIA,2017,7,2017-10-22,Sunday,13:00,NYJ,28,MIA,31,Home,3,59,57333,201710220mia,8021
2017102207,2017_07_BAL_MIN,2017,7,2017-10-22,Sunday,13:00,BAL,16,MIN,24,Home,8,40,57334,201710220min,8016
2017102208,2017_07_CIN_PIT,2017,7,2017-10-22,Sunday,16:25,CIN,14,PIT,29,Home,15,43,57335,201710220pit,8018
2017102209,2017_07_DAL_SF,2017,7,2017-10-22,Sunday,16:05,DAL,40,SF,10,Home,-30,50,57336,201710220sfo,8024
2017102210,2017_07_DEN_LAC,2017,7,2017-10-22,Sunday,16:25,DEN,0,LAC,21,Home,21,21,57337,201710220sdg,8025
2017102211,2017_07_SEA_NYG,2017,7,2017-10-22,Sunday,16:25,SEA,24,NYG,7,Home,-17,31,57338,201710220nyg,8026
2017102212,2017_07_ATL_NE,2017,7,2017-10-22,Sunday,20:30,ATL,7,NE,23,Home,16,30,57339,201710220nwe,8027
2017102300,2017_07_WAS_PHI,2017,7,2017-10-23,Monday,20:30,WAS,24,PHI,34,Home,10,58,57340,201710230phi,8028
2017102600,2017_08_MIA_BAL,2017,8,2017-10-26,Thursday,20:25,MIA,0,BAL,40,Home,40,40,57341,201710260rav,8029
2017102900,2017_08_MIN_CLE,2017,8,2017-10-29,Sunday,21:30,MIN,33,CLE,16,Neutral,-17,49,57342,201710290cle,8030
2017102901,2017_08_OAK_BUF,2017,8,2017-10-29,Sunday,13:00,OAK,14,BUF,34,Home,20,48,57343,201710290buf,8036
2017102902,2017_08_IND_CIN,2017,8,2017-10-29,Sunday,13:00,IND,23,CIN,24,Home,1,47,57344,201710290cin,8034
2017102903,2017_08_LAC_NE,2017,8,2017-10-29,Sunday,13:00,LAC,13,NE,21,Home,8,34,57345,201710290nwe,8035
2017102904,2017_08_CHI_NO,2017,8,2017-10-29,Sunday,13:00,CHI,12,NO,20,Home,8,32,57346,201710290nor,8033
2017102905,2017_08_ATL_NYJ,2017,8,2017-10-29,Sunday,13:00,ATL,25,NYJ,20,Home,-5,45,57347,201710290nyj,8031
2017102906,2017_08_SF_PHI,2017,8,2017-10-29,Sunday,13:00,SF,10,PHI,33,Home,23,43,57348,201710290phi,8037
2017102907,2017_08_CAR_TB,2017,8,2017-10-29,Sunday,13:00,CAR,17,TB,3,Home,-14,20,57349,201710290tam,8032
2017102908,2017_08_HOU_SEA,2017,8,2017-10-29,Sunday,16:05,HOU,38,SEA,41,Home,3,79,57350,201710290sea,8038
2017102909,2017_08_DAL_WAS,2017,8,2017-10-29,Sunday,16:25,DAL,33,WAS,19,Home,-14,52,57351,201710290was,8039
2017102910,2017_08_PIT_DET,2017,8,2017-10-29,Sunday,20:30,PIT,20,DET,15,Home,-5,35,57352,201710290det,8040
2017103000,2017_08_DEN_KC,2017,8,2017-10-30,Monday,20:30,DEN,19,KC,29,Home,10,48,57353,201710300kan,8041
2017110200,2017_09_BUF_NYJ,2017,9,2017-11-02,Thursday,20:25,BUF,21,NYJ,34,Home,13,55,57354,201711020nyj,8042
2017110500,2017_09_ATL_CAR,2017,9,2017-11-05,Sunday,13:00,ATL,17,CAR,20,Home,3,37,57355,201711050car,8043
2017110501,2017_09_IND_HOU,2017,9,2017-11-05,Sunday,13:00,IND,20,HOU,14,Home,-6,34,57356,201711050htx,8047
2017110502,2017_09_CIN_JAX,2017,9,2017-11-05,Sunday,13:00,CIN,7,JAX,23,Home,16,30,57357,201711050jax,8045
2017110503,2017_09_TB_NO,2017,9,2017-11-05,Sunday,13:00,TB,10,NO,30,Home,20,40,57358,201711050nor,8049
2017110504,2017_09_LAR_NYG,2017,9,2017-11-05,Sunday,13:00,LAR,51,NYG,17,Home,-34,68,57359,201711050nyg,8048
2017110505,2017_09_DEN_PHI,2017,9,2017-11-05,Sunday,13:00,DEN,23,PHI,51,Home,28,74,57360,201711050phi,8046
2017110506,2017_09_BAL_TEN,2017,9,2017-11-05,Sunday,13:00,BAL,20,TEN,23,Home,3,43,57361,201711050oti,8044
2017110507,2017_09_ARI_SF,2017,9,2017-11-05,Sunday,16:05,ARI,20,SF,10,Home,-10,30,57362,201711050sfo,8050
2017110508,2017_09_WAS_SEA,2017,9,2017-11-05,Sunday,16:05,WAS,17,SEA,14,Home,-3,31,57363,201711050sea,8051
2017110509,2017_09_KC_DAL,2017,9,2017-11-05,Sunday,16:25,KC,17,DAL,28,Home,11,45,57364,201711050dal,8052
2017110510,2017_09_OAK_MIA,2017,9,2017-11-05,Sunday,20:30,OAK,27,MIA,24,Home,-3,51,57365,201711050mia,8053
2017110600,2017_09_DET_GB,2017,9,2017-11-06,Monday,20:30,DET,30,GB,17,Home,-13,47,57366,201711060gnb,8054
2017110900,2017_10_SEA_ARI,2017,10,2017-11-09,Thursday,20:25,SEA,22,ARI,16,Home,-6,38,57367,201711090crd,8055
2017111200,2017_10_NO_BUF,2017,10,2017-11-12,Sunday,13:00,NO,47,BUF,10,Home,-37,57,57368,201711120buf,8061
2017111201,2017_10_GB_CHI,2017,10,2017-11-12,Sunday,13:00,GB,23,CHI,16,Home,-7,39,57369,201711120chi,8058
2017111202,2017_10_CLE_DET,2017,10,2017-11-12,Sunday,13:00,CLE,24,DET,38,Home,14,62,57370,201711120det,8057
2017111203,2017_10_PIT_IND,2017,10,2017-11-12,Sunday,13:00,PIT,20,IND,17,Home,-3,37,57371,201711120clt,8063
2017111204,2017_10_LAC_JAX,2017,10,2017-11-12,Sunday,13:00,LAC,17,JAX,20,Home,3,37,57372,201711120jax,8059
2017111205,2017_10_NYJ_TB,2017,10,2017-11-12,Sunday,13:00,NYJ,10,TB,15,Home,5,25,57373,201711120tam,8062
2017111206,2017_10_CIN_TEN,2017,10,2017-11-12,Sunday,13:00,CIN,20,TEN,24,Home,4,44,57374,201711120oti,8056
2017111207,2017_10_MIN_WAS,2017,10,2017-11-12,Sunday,13:00,MIN,38,WAS,30,Home,-8,68,57375,201711120was,8060
2017111208,2017_10_HOU_LAR,2017,10,2017-11-12,Sunday,16:05,HOU,7,LAR,33,Home,26,40,57376,201711120ram,8064
2017111209,2017_10_DAL_ATL,2017,10,2017-11-12,Sunday,16:25,DAL,7,ATL,27,Home,20,34,57377,201711120atl,8065
2017111210,2017_10_NYG_SF,2017,10,2017-11-12,Sunday,16:25,NYG,21,SF,31,Home,10,52,57378,201711120sfo,8066
2017111211,2017_10_NE_DEN,2017,10,2017-11-12,Sunday,20:30,NE,41,DEN,16,Home,-25,57,57379,201711120den,8067
2017111300,2017_10_MIA_CAR,2017,10,2017-11-13,Monday,20:30,MIA,21,CAR,45,Home,24,66,57380,201711130car,8068
2017111600,2017_11_TEN_PIT,2017,11,2017-11-16,Thursday,20:25,TEN,17,PIT,40,Home,23,57,57381,201711160pit,8069
2017111900,2017_11_DET_CHI,2017,11,2017-11-19,Sunday,13:00,DET,27,CHI,24,Home,-3,51,57382,201711190chi,8072
2017111901,2017_11_JAX_CLE,2017,11,2017-11-19,Sunday,13:00,JAX,19,CLE,7,Home,-12,26,57383,201711190cle,8073
2017111902,2017_11_BAL_GB,2017,11,2017-11-19,Sunday,13:00,BAL,23,GB,0,Home,-23,23,57384,201711190gnb,8071
2017111903,2017_11_ARI_HOU,2017,11,2017-11-19,Sunday,13:00,ARI,21,HOU,31,Home,10,52,57385,201711190htx,8070
2017111904,2017_11_LAR_MIN,2017,11,2017-11-19,Sunday,13:00,LAR,7,MIN,24,Home,17,31,57386,201711190min,8075
2017111905,2017_11_WAS_NO,2017,11,2017-11-19,Sunday,13:00,WAS,31,NO,34,Home,3,65,57387,201711190nor,8076
2017111906,2017_11_KC_NYG,2017,11,2017-11-19,Sunday,13:00,KC,9,NYG,12,Home,3,21,57388,201711190nyg,8074
2017111907,2017_11_BUF_LAC,2017,11,2017-11-19,Sunday,16:05,BUF,24,LAC,54,Home,30,78,57389,201711190sdg,8077
2017111908,2017_11_CIN_DEN,2017,11,2017-11-19,Sunday,16:25,CIN,20,DEN,17,Home,-3,37,57390,201711190den,8078
2017111909,2017_11_NE_OAK,2017,11,2017-11-19,Sunday,16:25,NE,33,OAK,8,Neutral,-25,41,57391,201711190rai,8079
2017111910,2017_11_PHI_DAL,2017,11,2017-11-19,Sunday,20:30,PHI,37,DAL,9,Home,-28,46,57392,201711190dal,8080
2017111911,2017_11_TB_MIA,2017,11,2017-11-19,Sunday,13:00,TB,30,MIA,20,Home,-10,50,57241,201711190mia,7931
2017112000,2017_11_ATL_SEA,2017,11,2017-11-20,Monday,20:30,ATL,34,SEA,31,Home,-3,65,57393,201711200sea,8081
2017112300,2017_12_MIN_DET,2017,12,2017-11-23,Thursday,12:30,MIN,30,DET,23,Home,-7,53,57394,201711230det,8082
2017112301,2017_12_LAC_DAL,2017,12,2017-11-23,Thursday,16:30,LAC,28,DAL,6,Home,-22,34,57395,201711230dal,8083
2017112302,2017_12_NYG_WAS,2017,12,2017-11-23,Thursday,20:30,NYG,10,WAS,20,Home,10,30,57396,201711230was,8084
2017112600,2017_12_TB_ATL,2017,12,2017-11-26,Sunday,13:00,TB,20,ATL,34,Home,14,54,57397,201711260atl,8090
2017112601,2017_12_CLE_CIN,2017,12,2017-11-26,Sunday,13:00,CLE,16,CIN,30,Home,14,46,57398,201711260cin,8088
2017112602,2017_12_TEN_IND,2017,12,2017-11-26,Sunday,13:00,TEN,20,IND,16,Home,-4,36,57399,201711260clt,8091
2017112603,2017_12_BUF_KC,2017,12,2017-11-26,Sunday,13:00,BUF,16,KC,10,Home,-6,26,57400,201711260kan,8085
2017112604,2017_12_MIA_NE,2017,12,2017-11-26,Sunday,13:00,MIA,17,NE,35,Home,18,52,57401,201711260nwe,8089
2017112605,2017_12_CAR_NYJ,2017,12,2017-11-26,Sunday,13:00,CAR,35,NYJ,27,Home,-8,62,57402,201711260nyj,8086
2017112606,2017_12_CHI_PHI,2017,12,2017-11-26,Sunday,13:00,CHI,3,PHI,31,Home,28,34,57403,201711260phi,8087
2017112607,2017_12_NO_LAR,2017,12,2017-11-26,Sunday,16:25,NO,20,LAR,26,Home,6,46,57404,201711260ram,8092
2017112608,2017_12_SEA_SF,2017,12,2017-11-26,Sunday,16:05,SEA,24,SF,13,Home,-11,37,57405,201711260sfo,8093
2017112609,2017_12_JAX_ARI,2017,12,2017-11-26,Sunday,16:25,JAX,24,ARI,27,Home,3,51,57406,201711260crd,8095
2017112610,2017_12_DEN_OAK,2017,12,2017-11-26,Sunday,16:25,DEN,14,OAK,21,Home,7,35,57407,201711260rai,8094
2017112611,2017_12_GB_PIT,2017,12,2017-11-26,Sunday,20:30,GB,28,PIT,31,Home,3,59,57408,201711260pit,8096
2017112700,2017_12_HOU_BAL,2017,12,2017-11-27,Monday,20:30,HOU,16,BAL,23,Home,7,39,57409,201711270rav,8097
2017113000,2017_13_WAS_DAL,2017,13,2017-11-30,Thursday,20:25,WAS,14,DAL,38,Home,24,52,57410,201711300dal,8098
2017120300,2017_13_MIN_ATL,2017,13,2017-12-03,Sunday,13:00,MIN,14,ATL,9,Home,-5,23,57411,201712030atl,8105
2017120301,2017_13_DET_BAL,2017,13,2017-12-03,Sunday,13:00,DET,20,BAL,44,Home,24,64,57412,201712030rav,8101
2017120302,2017_13_NE_BUF,2017,13,2017-12-03,Sunday,13:00,NE,23,BUF,3,Home,-20,26,57413,201712030buf,8106
2017120303,2017_13_SF_CHI,2017,13,2017-12-03,Sunday,13:00,SF,15,CHI,14,Home,-1,29,57414,201712030chi,8107
2017120304,2017_13_TB_GB,2017,13,2017-12-03,Sunday,13:00,TB,20,GB,26,Home,6,46,57415,201712030gnb,8108
2017120305,2017_13_IND_JAX,2017,13,2017-12-03,Sunday,13:00,IND,10,JAX,30,Home,20,40,57416,201712030jax,8103
2017120306,2017_13_DEN_MIA,2017,13,2017-12-03,Sunday,13:00,DEN,9,MIA,35,Home,26,44,57417,201712030mia,8100
2017120307,2017_13_CAR_NO,2017,13,2017-12-03,Sunday,16:25,CAR,21,NO,31,Home,10,52,57418,201712030nor,8099
2017120308,2017_13_KC_NYJ,2017,13,2017-12-03,Sunday,13:00,KC,31,NYJ,38,Home,7,69,57419,201712030nyj,8104
2017120309,2017_13_HOU_TEN,2017,13,2017-12-03,Sunday,13:00,HOU,13,TEN,24,Home,11,37,57420,201712030oti,8102
2017120310,2017_13_CLE_LAC,2017,13,2017-12-03,Sunday,16:05,CLE,10,LAC,19,Home,9,29,57421,201712030sdg,8109
2017120311,2017_13_LAR_ARI,2017,13,2017-12-03,Sunday,16:25,LAR,32,ARI,16,Home,-16,48,57422,201712030crd,8110
2017120312,2017_13_NYG_OAK,2017,13,2017-12-03,Sunday,16:25,NYG,17,OAK,24,Home,7,41,57423,201712030rai,8111
2017120313,2017_13_PHI_SEA,2017,13,2017-12-03,Sunday,20:30,PHI,10,SEA,24,Home,14,34,57424,201712030sea,8112
2017120400,2017_13_PIT_CIN,2017,13,2017-12-04,Monday,20:30,PIT,23,CIN,20,Home,-3,43,57425,201712040cin,8113
2017120700,2017_14_NO_ATL,2017,14,2017-12-07,Thursday,20:25,NO,17,ATL,20,Home,3,37,57426,201712070atl,8114
2017121000,2017_14_IND_BUF,2017,14,2017-12-10,Sunday,13:00,IND,7,BUF,13,Home,6,20,57427,201712100buf,8118
2017121001,2017_14_MIN_CAR,2017,14,2017-12-10,Sunday,13:00,MIN,24,CAR,31,Home,7,55,57428,201712100car,8119
2017121002,2017_14_CHI_CIN,2017,14,2017-12-10,Sunday,13:00,CHI,33,CIN,7,Home,-26,40,57429,201712100cin,8115
2017121003,2017_14_GB_CLE,2017,14,2017-12-10,Sunday,13:00,GB,27,CLE,21,Home,-6,48,57430,201712100cle,8117
2017121004,2017_14_SF_HOU,2017,14,2017-12-10,Sunday,13:00,SF,26,HOU,16,Home,-10,42,57431,201712100htx,8121
2017121005,2017_14_SEA_JAX,2017,14,2017-12-10,Sunday,16:25,SEA,24,JAX,30,Home,6,54,57432,201712100jax,8122
2017121006,2017_14_OAK_KC,2017,14,2017-12-10,Sunday,13:00,OAK,15,KC,26,Home,11,41,57433,201712100kan,8120
2017121007,2017_14_DET_TB,2017,14,2017-12-10,Sunday,13:00,DET,24,TB,21,Home,-3,45,57434,201712100tam,8116
2017121008,2017_14_TEN_ARI,2017,14,2017-12-10,Sunday,16:05,TEN,7,ARI,12,Home,5,19,57435,201712100crd,8124
2017121009,2017_14_NYJ_DEN,2017,14,2017-12-10,Sunday,16:05,NYJ,0,DEN,23,Home,23,23,57436,201712100den,8123
2017121010,2017_14_WAS_LAC,2017,14,2017-12-10,Sunday,16:05,WAS,13,LAC,30,Home,17,43,57437,201712100sdg,8125
2017121011,2017_14_PHI_LAR,2017,14,2017-12-10,Sunday,16:25,PHI,43,LAR,35,Home,-8,78,57438,201712100ram,8127
2017121012,2017_14_DAL_NYG,2017,14,2017-12-10,Sunday,13:00,DAL,30,NYG,10,Home,-20,40,57439,201712100nyg,8126
2017121013,2017_14_BAL_PIT,2017,14,2017-12-10,Sunday,20:30,BAL,38,PIT,39,Home,1,77,57440,201712100pit,8128
2017121100,2017_14_NE_MIA,2017,14,2017-12-11,Monday,20:30,NE,20,MIA,27,Home,7,47,57441,201712110mia,8129
2017121400,2017_15_DEN_IND,2017,15,2017-12-14,Thursday,20:25,DEN,25,IND,13,Home,-12,38,57442,201712140clt,8130
2017121600,2017_15_CHI_DET,2017,15,2017-12-16,Saturday,16:30,CHI,10,DET,20,Home,10,30,57443,201712160det,8131
2017121601,2017_15_LAC_KC,2017,15,2017-12-16,Saturday,20:25,LAC,13,KC,30,Home,17,43,57444,201712160kan,8132
2017121700,2017_15_MIA_BUF,2017,15,2017-12-17,Sunday,13:00,MIA,16,BUF,24,Home,8,40,57445,201712170buf,8138
2017121701,2017_15_GB_CAR,2017,15,2017-12-17,Sunday,13:00,GB,24,CAR,31,Home,7,55,57446,201712170car,8136
2017121702,2017_15_BAL_CLE,2017,15,2017-12-17,Sunday,13:00,BAL,27,CLE,10,Home,-17,37,57447,201712170cle,8134
2017121703,2017_15_HOU_JAX,2017,15,2017-12-17,Sunday,13:00,HOU,7,JAX,45,Home,38,52,57448,201712170jax,8137
2017121704,2017_15_CIN_MIN,2017,15,2017-12-17,Sunday,13:00,CIN,7,MIN,34,Home,27,41,57449,201712170min,8135
2017121705,2017_15_NYJ_NO,2017,15,2017-12-17,Sunday,13:00,NYJ,19,NO,31,Home,12,50,57450,201712170nor,8139
2017121706,2017_15_PHI_NYG,2017,15,2017-12-17,Sunday,13:00,PHI,34,NYG,29,Home,-5,63,57451,201712170nyg,8140
2017121707,2017_15_ARI_WAS,2017,15,2017-12-17,Sunday,13:00,ARI,15,WAS,20,Home,5,35,57452,201712170was,8133
2017121708,2017_15_LAR_SEA,2017,15,2017-12-17,Sunday,16:05,LAR,42,SEA,7,Home,-35,49,57453,201712170sea,8141
2017121709,2017_15_NE_PIT,2017,15,2017-12-17,Sunday,16:25,NE,27,PIT,24,Home,-3,51,57454,201712170pit,8142
2017121710,2017_15_TEN_SF,2017,15,2017-12-17,Sunday,16:25,TEN,23,SF,25,Home,2,48,57455,201712170sfo,8143
2017121711,2017_15_DAL_OAK,2017,15,2017-12-17,Sunday,20:30,DAL,20,OAK,17,Home,-3,37,57456,201712170rai,8144
2017121800,2017_15_ATL_TB,2017,15,2017-12-18,Monday,20:30,ATL,24,TB,21,Home,-3,45,57457,201712180tam,8145
2017122300,2017_16_IND_BAL,2017,16,2017-12-23,Saturday,16:30,IND,16,BAL,23,Home,7,39,57458,201712230rav,8146
2017122301,2017_16_MIN_GB,2017,16,2017-12-23,Saturday,20:30,MIN,16,GB,0,Home,-16,16,57459,201712230gnb,8147
2017122400,2017_16_TB_CAR,2017,16,2017-12-24,Sunday,13:00,TB,19,CAR,22,Home,3,41,57460,201712240car,8156
2017122401,2017_16_CLE_CHI,2017,16,2017-12-24,Sunday,13:00,CLE,3,CHI,20,Home,17,23,57461,201712240chi,8150
2017122402,2017_16_DET_CIN,2017,16,2017-12-24,Sunday,13:00,DET,17,CIN,26,Home,9,43,57462,201712240cin,8152
2017122403,2017_16_MIA_KC,2017,16,2017-12-24,Sunday,13:00,MIA,13,KC,29,Home,16,42,57463,201712240kan,8155
2017122404,2017_16_BUF_NE,2017,16,2017-12-24,Sunday,13:00,BUF,16,NE,37,Home,21,53,57464,201712240nwe,8149
2017122405,2017_16_ATL_NO,2017,16,2017-12-24,Sunday,13:00,ATL,13,NO,23,Home,10,36,57465,201712240nor,8148
2017122406,2017_16_LAC_NYJ,2017,16,2017-12-24,Sunday,13:00,LAC,14,NYJ,7,Home,-7,21,57466,201712240nyj,8153
2017122407,2017_16_LAR_TEN,2017,16,2017-12-24,Sunday,13:00,LAR,27,TEN,23,Home,-4,50,57467,201712240oti,8154
2017122408,2017_16_DEN_WAS,2017,16,2017-12-24,Sunday,13:00,DEN,11,WAS,27,Home,16,38,57468,201712240was,8151
2017122409,2017_16_JAX_SF,2017,16,2017-12-24,Sunday,16:05,JAX,33,SF,44,Home,11,77,57469,201712240sfo,8157
2017122410,2017_16_NYG_ARI,2017,16,2017-12-24,Sunday,16:25,NYG,0,ARI,23,Home,23,23,57470,201712240crd,8158
2017122411,2017_16_SEA_DAL,2017,16,2017-12-24,Sunday,16:25,SEA,21,DAL,12,Home,-9,33,57471,201712240dal,8159
2017122500,2017_16_PIT_HOU,2017,16,2017-12-25,Monday,16:30,PIT,34,HOU,6,Home,-28,40,57472,201712250htx,8160
2017122501,2017_16_OAK_PHI,2017,16,2017-12-25,Monday,20:30,OAK,10,PHI,19,Home,9,29,57473,201712250phi,8161
2017123100,2017_17_CAR_ATL,2017,17,2017-12-31,Sunday,16:25,CAR,10,ATL,22,Home,12,32,57474,201712310atl,8163
2017123101,2017_17_CIN_BAL,2017,17,2017-12-31,Sunday,16:25,CIN,31,BAL,27,Home,-4,58,57475,201712310rav,8165
2017123102,2017_17_GB_DET,2017,17,2017-12-31,Sunday,13:00,GB,11,DET,35,Home,24,46,57476,201712310det,8168
2017123103,2017_17_HOU_IND,2017,17,2017-12-31,Sunday,13:00,HOU,13,IND,22,Home,9,35,57477,201712310clt,8169
2017123104,2017_17_BUF_MIA,2017,17,2017-12-31,Sunday,16:25,BUF,22,MIA,16,Home,-6,38,57478,201712310mia,8162
2017123105,2017_17_CHI_MIN,2017,17,2017-12-31,Sunday,13:00,CHI,10,MIN,23,Home,13,33,57479,201712310min,8164
2017123106,2017_17_NYJ_NE,2017,17,2017-12-31,Sunday,13:00,NYJ,6,NE,26,Home,20,32,57480,201712310nwe,8172
2017123107,2017_17_WAS_NYG,2017,17,2017-12-31,Sunday,13:00,WAS,10,NYG,18,Home,8,28,57481,201712310nyg,8173
2017123108,2017_17_DAL_PHI,2017,17,2017-12-31,Sunday,13:00,DAL,6,PHI,0,Home,-6,6,57482,201712310phi,8167
2017123109,2017_17_CLE_PIT,2017,17,2017-12-31,Sunday,13:00,CLE,24,PIT,28,Home,4,52,57483,201712310pit,8166
2017123110,2017_17_NO_TB,2017,17,2017-12-31,Sunday,16:25,NO,24,TB,31,Home,7,55,57484,201712310tam,8171
2017123111,2017_17_JAX_TEN,2017,17,2017-12-31,Sunday,16:25,JAX,10,TEN,15,Home,5,25,57485,201712310oti,8170
2017123112,2017_17_KC_DEN,2017,17,2017-12-31,Sunday,16:25,KC,27,DEN,24,Home,-3,51,57486,201712310den,8175
2017123113,2017_17_OAK_LAC,2017,17,2017-12-31,Sunday,16:25,OAK,10,LAC,30,Home,20,40,57487,201712310sdg,8176
2017123114,2017_17_SF_LAR,2017,17,2017-12-31,Sunday,16:25,SF,34,LAR,13,Home,-21,47,57488,201712310ram,8177
2017123115,2017_17_ARI_SEA,2017,17,2017-12-31,Sunday,16:25,ARI,26,SEA,24,Home,-2,50,57489,201712310sea,8174
2018010600,2017_18_TEN_KC,2017,18,2018-01-06,Saturday,16:36,TEN,22,KC,21,Home,-1,43,57490,201801060kan,9297
2018010601,2017_18_ATL_LAR,2017,18,2018-01-06,Saturday,20:15,ATL,26,LAR,13,Home,-13,39,57491,201801060ram,9298
2018010700,2017_18_BUF_JAX,2017,18,2018-01-07,Sunday,13:05,BUF,3,JAX,10,Home,7,13,57492,201801070jax,9299
2018010701,2017_18_CAR_NO,2017,18,2018-01-07,Sunday,16:40,CAR,26,NO,31,Home,5,57,57493,201801070nor,9300
2018011300,2017_19_ATL_PHI,2017,19,2018-01-13,Saturday,16:35,ATL,10,PHI,15,Home,5,25,57494,201801130phi,9302
2018011301,2017_19_TEN_NE,2017,19,2018-01-13,Saturday,20:15,TEN,14,NE,35,Home,21,49,57495,201801130nwe,9303
2018011400,2017_19_JAX_PIT,2017,19,2018-01-14,Sunday,13:05,JAX,45,PIT,42,Home,-3,87,57496,201801140pit,9304
2018011401,2017_19_NO_MIN,2017,19,2018-01-14,Sunday,16:40,NO,24,MIN,29,Home,5,53,57497,201801140min,9305
2018012100,2017_20_JAX_NE,2017,20,2018-01-21,Sunday,15:05,JAX,20,NE,24,Home,4,44,57498,201801210nwe,9306
2018012101,2017_20_MIN_PHI,2017,20,2018-01-21,Sunday,18:41,MIN,7,PHI,38,Home,31,45,57499,201801210phi,9307
2018020400,2017_21_PHI_NE,2017,21,2018-02-04,Sunday,18:31,PHI,41,NE,33,Neutral,-8,74,57500,201802040nwe,9312
2018090600,2018_01_ATL_PHI,2018,1,2018-09-06,Thursday,20:20,ATL,12,PHI,18,Home,6,30,57567,201809060phi,9338
2018090900,2018_01_BUF_BAL,2018,1,2018-09-09,Sunday,13:00,BUF,3,BAL,47,Home,44,50,57568,201809090rav,9346
2018090901,2018_01_PIT_CLE,2018,1,2018-09-09,Sunday,13:00,PIT,21,CLE,21,Home,0,42,57569,201809090cle,9339
2018090902,2018_01_CIN_IND,2018,1,2018-09-09,Sunday,13:00,CIN,34,IND,23,Home,-11,57,57570,201809090clt,9340
2018090903,2018_01_TEN_MIA,2018,1,2018-09-09,Sunday,13:00,TEN,20,MIA,27,Home,7,47,57571,201809090mia,9341
2018090904,2018_01_SF_MIN,2018,1,2018-09-09,Sunday,13:00,SF,16,MIN,24,Home,8,40,57572,201809090min,9342
2018090905,2018_01_HOU_NE,2018,1,2018-09-09,Sunday,13:00,HOU,20,NE,27,Home,7,47,57573,201809090nwe,9344
2018090906,2018_01_TB_NO,2018,1,2018-09-09,Sunday,13:00,TB,48,NO,40,Home,-8,88,57574,201809090nor,9343
2018090907,2018_01_JAX_NYG,2018,1,2018-09-09,Sunday,13:00,JAX,20,NYG,15,Home,-5,35,57575,201809090nyg,9345
2018090908,2018_01_KC_LAC,2018,1,2018-09-09,Sunday,16:05,KC,38,LAC,28,Home,-10,66,57576,201809090sdg,9347
2018090909,2018_01_WAS_ARI,2018,1,2018-09-09,Sunday,16:25,WAS,24,ARI,6,Home,-18,30,57577,201809090crd,9349
2018090910,2018_01_DAL_CAR,2018,1,2018-09-09,Sunday,16:25,DAL,8,CAR,16,Home,8,24,57578,201809090car,9348
2018090911,2018_01_SEA_DEN,2018,1,2018-09-09,Sunday,16:25,SEA,24,DEN,27,Home,3,51,57579,201809090den,9350
2018090912,2018_01_CHI_GB,2018,1,2018-09-09,Sunday,20:20,CHI,23,GB,24,Home,1,47,57580,201809090gnb,9351
2018091000,2018_01_NYJ_DET,2018,1,2018-09-10,Monday,19:10,NYJ,48,DET,17,Home,-31,65,57581,201809100det,9352
2018091001,2018_01_LAR_OAK,2018,1,2018-09-10,Monday,22:20,LAR,33,OAK,13,Home,-20,46,57582,201809100rai,9353
2018091300,2018_02_BAL_CIN,2018,2,2018-09-13,Thursday,20:20,BAL,23,CIN,34,Home,11,57,57583,201809130cin,9354
2018091600,2018_02_CAR_ATL,2018,2,2018-09-16,Sunday,13:00,CAR,24,ATL,31,Home,7,55,57584,201809160atl,9355
2018091601,2018_02_LAC_BUF,2018,2,2018-09-16,Sunday,13:00,LAC,31,BUF,20,Home,-11,51,57585,201809160buf,9356
2018091602,2018_02_MIN_GB,2018,2,2018-09-16,Sunday,13:00,MIN,29,GB,29,Home,0,58,57586,201809160gnb,9357
2018091603,2018_02_CLE_NO,2018,2,2018-09-16,Sunday,13:00,CLE,18,NO,21,Home,3,39,57587,201809160nor,9358
2018091604,2018_02_MIA_NYJ,2018,2,2018-09-16,Sunday,13:00,MIA,20,NYJ,12,Home,-8,32,57588,201809160nyj,9359
2018091605,2018_02_KC_PIT,2018,2,2018-09-16,Sunday,13:00,KC,42,PIT,37,Home,-5,79,57589,201809160pit,9361
2018091606,2018_02_PHI_TB,2018,2,2018-09-16,Sunday,13:00,PHI,21,TB,27,Home,6,48,57590,201809160tam,9362
2018091607,2018_02_HOU_TEN,2018,2,2018-09-16,Sunday,13:00,HOU,17,TEN,20,Home,3,37,57591,201809160oti,9360
2018091608,2018_02_IND_WAS,2018,2,2018-09-16,Sunday,13:00,IND,21,WAS,9,Home,-12,30,57592,201809160was,9363
2018091609,2018_02_ARI_LAR,2018,2,2018-09-16,Sunday,16:05,ARI,0,LAR,34,Home,34,34,57593,201809160ram,9364
2018091610,2018_02_DET_SF,2018,2,2018-09-16,Sunday,16:05,DET,27,SF,30,Home,3,57,57594,201809160sfo,9365
2018091611,2018_02_OAK_DEN,2018,2,2018-09-16,Sunday,16:25,OAK,19,DEN,20,Home,1,39,57595,201809160den,9366
2018091612,2018_02_NE_JAX,2018,2,2018-09-16,Sunday,16:25,NE,20,JAX,31,Home,11,51,57596,201809160jax,9367
2018091613,2018_02_NYG_DAL,2018,2,2018-09-16,Sunday,20:20,NYG,13,DAL,20,Home,7,33,57597,201809160dal,9368
2018091700,2018_02_SEA_CHI,2018,2,2018-09-17,Monday,20:15,SEA,17,CHI,24,Home,7,41,57598,201809170chi,9369
2018092000,2018_03_NYJ_CLE,2018,3,2018-09-20,Thursday,20:20,NYJ,17,CLE,21,Home,4,38,57599,201809200cle,9370
2018092300,2018_03_NO_ATL,2018,3,2018-09-23,Sunday,13:00,NO,43,ATL,37,Home,-6,80,57600,201809230atl,9371
2018092301,2018_03_DEN_BAL,2018,3,2018-09-23,Sunday,13:00,DEN,14,BAL,27,Home,13,41,57601,201809230rav,9379
2018092302,2018_03_CIN_CAR,2018,3,2018-09-23,Sunday,13:00,CIN,21,CAR,31,Home,10,52,57602,201809230car,9372
2018092303,2018_03_NYG_HOU,2018,3,2018-09-23,Sunday,13:00,NYG,27,HOU,22,Home,-5,49,57603,201809230htx,9373
2018092304,2018_03_TEN_JAX,2018,3,2018-09-23,Sunday,13:00,TEN,9,JAX,6,Home,-3,15,57604,201809230jax,9374
2018092305,2018_03_SF_KC,2018,3,2018-09-23,Sunday,13:00,SF,27,KC,38,Home,11,65,57605,201809230kan,9375
2018092306,2018_03_OAK_MIA,2018,3,2018-09-23,Sunday,13:00,OAK,20,MIA,28,Home,8,48,57606,201809230mia,9376
2018092307,2018_03_BUF_MIN,2018,3,2018-09-23,Sunday,13:00,BUF,27,MIN,6,Home,-21,33,57607,201809230min,9377
2018092308,2018_03_IND_PHI,2018,3,2018-09-23,Sunday,13:00,IND,16,PHI,20,Home,4,36,57608,201809230phi,9378
2018092309,2018_03_GB_WAS,2018,3,2018-09-23,Sunday,13:00,GB,17,WAS,31,Home,14,48,57609,201809230was,9380
2018092310,2018_03_LAC_LAR,2018,3,2018-09-23,Sunday,16:05,LAC,23,LAR,35,Home,12,58,57610,201809230ram,9381
2018092311,2018_03_CHI_ARI,2018,3,2018-09-23,Sunday,16:25,CHI,16,ARI,14,Home,-2,30,57611,201809230crd,9382
2018092312,2018_03_DAL_SEA,2018,3,2018-09-23,Sunday,16:25,DAL,13,SEA,24,Home,11,37,57612,201809230sea,9383
2018092313,2018_03_NE_DET,2018,3,2018-09-23,Sunday,20:20,NE,10,DET,26,Home,16,36,57613,201809230det,9384
2018092400,2018_03_PIT_TB,2018,3,2018-09-24,Monday,20:15,PIT,30,TB,27,Home,-3,57,57614,201809240tam,9385
2018092700,2018_04_MIN_LAR,2018,4,2018-09-27,Thursday,20:20,MIN,31,LAR,38,Home,7,69,57615,201809270ram,9386
2018093000,2018_04_CIN_ATL,2018,4,2018-09-30,Sunday,13:00,CIN,37,ATL,36,Home,-1,73,57616,201809300atl,9387
2018093001,2018_04_TB_CHI,2018,4,2018-09-30,Sunday,13:00,TB,10,CHI,48,Home,38,58,57617,201809300chi,9388
2018093002,2018_04_DET_DAL,2018,4,2018-09-30,Sunday,13:00,DET,24,DAL,26,Home,2,50,57618,201809300dal,9390
2018093003,2018_04_BUF_GB,2018,4,2018-09-30,Sunday,13:00,BUF,0,GB,22,Home,22,22,57619,201809300gnb,9391
2018093004,2018_04_HOU_IND,2018,4,2018-09-30,Sunday,13:00,HOU,37,IND,34,Home,-3,71,57620,201809300clt,9389
2018093005,2018_04_NYJ_JAX,2018,4,2018-09-30,Sunday,13:00,NYJ,12,JAX,31,Home,19,43,57621,201809300jax,9392
2018093006,2018_04_MIA_NE,2018,4,2018-09-30,Sunday,13:00,MIA,7,NE,38,Home,31,45,57622,201809300nwe,9393
2018093007,2018_04_PHI_TEN,2018,4,2018-09-30,Sunday,13:00,PHI,23,TEN,26,Home,3,49,57623,201809300oti,9394
2018093008,2018_04_SEA_ARI,2018,4,2018-09-30,Sunday,16:05,SEA,20,ARI,17,Home,-3,37,57624,201809300crd,9395
2018093009,2018_04_CLE_OAK,2018,4,2018-09-30,Sunday,16:05,CLE,42,OAK,45,Home,3,87,57625,201809300rai,9396
2018093010,2018_04_SF_LAC,2018,4,2018-09-30,Sunday,16:25,SF,27,LAC,29,Home,2,56,57626,201809300sdg,9398
2018093011,2018_04_NO_NYG,2018,4,2018-09-30,Sunday,16:25,NO,33,NYG,18,Home,-15,51,57627,201809300nyg,9397
2018093012,2018_04_BAL_PIT,2018,4,2018-09-30,Sunday,20:20,BAL,26,PIT,14,Home,-12,40,57628,201809300pit,9399
2018100100,2018_04_KC_DEN,2018,4,2018-10-01,Monday,20:15,KC,27,DEN,23,Home,-4,50,57629,201810010den,9400
2018100400,2018_05_IND_NE,2018,5,2018-10-04,Thursday,20:20,IND,24,NE,38,Home,14,62,57630,201810040nwe,9401
2018100700,2018_05_TEN_BUF,2018,5,2018-10-07,Sunday,13:00,TEN,12,BUF,13,Home,1,25,57631,201810070buf,9402
2018100701,2018_05_NYG_CAR,2018,5,2018-10-07,Sunday,13:00,NYG,31,CAR,33,Home,2,64,57632,201810070car,9403
2018100702,2018_05_MIA_CIN,2018,5,2018-10-07,Sunday,13:00,MIA,17,CIN,27,Home,10,44,57633,201810070cin,9404
2018100703,2018_05_BAL_CLE,2018,5,2018-10-07,Sunday,13:00,BAL,9,CLE,12,Home,3,21,57634,201810070cle,9405
2018100704,2018_05_GB_DET,2018,5,2018-10-07,Sunday,13:00,GB,23,DET,31,Home,8,54,57635,201810070det,9406
2018100705,2018_05_JAX_KC,2018,5,2018-10-07,Sunday,13:00,JAX,14,KC,30,Home,16,44,57636,201810070kan,9407
2018100706,2018_05_DEN_NYJ,2018,5,2018-10-07,Sunday,13:00,DEN,16,NYJ,34,Home,18,50,57637,201810070nyj,9408
2018100707,2018_05_ATL_PIT,2018,5,2018-10-07,Sunday,13:00,ATL,17,PIT,41,Home,24,58,57638,201810070pit,9409
2018100708,2018_05_OAK_LAC,2018,5,2018-10-07,Sunday,16:05,OAK,10,LAC,26,Home,16,36,57639,201810070sdg,9410
2018100709,2018_05_MIN_PHI,2018,5,2018-10-07,Sunday,16:25,MIN,23,PHI,21,Home,-2,44,57640,201810070phi,9411
2018100710,2018_05_ARI_SF,2018,5,2018-10-07,Sunday,16:25,ARI,28,SF,18,Home,-10,46,57641,201810070sfo,9413
2018100711,2018_05_LAR_SEA,2018,5,2018-10-07,Sunday,16:25,LAR,33,SEA,31,Home,-2,64,57642,201810070sea,9412
2018100712,2018_05_DAL_HOU,2018,5,2018-10-07,Sunday,20:20,DAL,16,HOU,19,Home,3,35,57643,201810070htx,9414
2018100800,2018_05_WAS_NO,2018,5,2018-10-08,Monday,20:15,WAS,19,NO,43,Home,24,62,57644,201810080nor,9415
2018101100,2018_06_PHI_NYG,2018,6,2018-10-11,Thursday,20:20,PHI,34,NYG,13,Home,-21,47,57645,201810110nyg,9416
2018101400,2018_06_TB_ATL,2018,6,2018-10-14,Sunday,13:00,TB,29,ATL,34,Home,5,63,57646,201810140atl,9417
2018101401,2018_06_PIT_CIN,2018,6,2018-10-14,Sunday,13:00,PIT,28,CIN,21,Home,-7,49,57647,201810140cin,9418
2018101402,2018_06_LAC_CLE,2018,6,2018-10-14,Sunday,13:00,LAC,38,CLE,14,Home,-24,52,57648,201810140cle,9419
2018101403,2018_06_BUF_HOU,2018,6,2018-10-14,Sunday,13:00,BUF,13,HOU,20,Home,7,33,57649,201810140htx,9420
2018101404,2018_06_CHI_MIA,2018,6,2018-10-14,Sunday,13:00,CHI,28,MIA,31,Home,3,59,57650,201810140mia,9421
2018101405,2018_06_ARI_MIN,2018,6,2018-10-14,Sunday,13:00,ARI,17,MIN,27,Home,10,44,57651,201810140min,9422
2018101406,2018_06_IND_NYJ,2018,6,2018-10-14,Sunday,13:00,IND,34,NYJ,42,Home,8,76,57652,201810140nyj,9423
2018101407,2018_06_SEA_OAK,2018,6,2018-10-14,Sunday,13:00,SEA,27,OAK,3,Neutral,-24,30,57653,201810140rai,9424
2018101408,2018_06_CAR_WAS,2018,6,2018-10-14,Sunday,13:00,CAR,17,WAS,23,Home,6,40,57654,201810140was,9425
2018101409,2018_06_LAR_DEN,2018,6,2018-10-14,Sunday,16:05,LAR,23,DEN,20,Home,-3,43,57655,201810140den,9426
2018101410,2018_06_JAX_DAL,2018,6,2018-10-14,Sunday,16:25,JAX,7,DAL,40,Home,33,47,57656,201810140dal,9427
2018101411,2018_06_BAL_TEN,2018,6,2018-10-14,Sunday,16:25,BAL,21,TEN,0,Home,-21,21,57657,201810140oti,9428
2018101412,2018_06_KC_NE,2018,6,2018-10-14,Sunday,20:20,KC,40,NE,43,Home,3,83,57658,201810140nwe,9429
2018101500,2018_06_SF_GB,2018,6,2018-10-15,Monday,20:15,SF,30,GB,33,Home,3,63,57659,201810150gnb,9430
2018101800,2018_07_DEN_ARI,2018,7,2018-10-18,Thursday,20:20,DEN,45,ARI,10,Home,-35,55,57660,201810180crd,9431
2018102100,2018_07_TEN_LAC,2018,7,2018-10-21,Sunday,21:30,TEN,19,LAC,20,Neutral,1,39,57661,201810210sdg,9432
2018102101,2018_07_NO_BAL,2018,7,2018-10-21,Sunday,16:05,NO,24,BAL,23,Home,-1,47,57662,201810210rav,9441
2018102102,2018_07_NE_CHI,2018,7,2018-10-21,Sunday,13:00,NE,38,CHI,31,Home,-7,69,57663,201810210chi,9433
2018102103,2018_07_BUF_IND,2018,7,2018-10-21,Sunday,13:00,BUF,5,IND,37,Home,32,42,57664,201810210clt,9434
2018102104,2018_07_HOU_JAX,2018,7,2018-10-21,Sunday,13:00,HOU,20,JAX,7,Home,-13,27,57665,201810210jax,9435
2018102105,2018_07_CIN_KC,2018,7,2018-10-21,Sunday,20:20,CIN,10,KC,45,Home,35,55,57666,201810210kan,9436
2018102106,2018_07_DET_MIA,2018,7,2018-10-21,Sunday,13:00,DET,32,MIA,21,Home,-11,53,57667,201810210mia,9437
2018102107,2018_07_MIN_NYJ,2018,7,2018-10-21,Sunday,13:00,MIN,37,NYJ,17,Home,-20,54,57668,201810210nyj,9438
2018102108,2018_07_CAR_PHI,2018,7,2018-10-21,Sunday,13:00,CAR,21,PHI,17,Home,-4,38,57669,201810210phi,9439
2018102109,2018_07_CLE_TB,2018,7,2018-10-21,Sunday,13:00,CLE,23,TB,26,Home,3,49,57670,201810210tam,9440
2018102110,2018_07_DAL_WAS,2018,7,2018-10-21,Sunday,16:25,DAL,17,WAS,20,Home,3,37,57671,201810210was,9442
2018102111,2018_07_LAR_SF,2018,7,2018-10-21,Sunday,16:25,LAR,39,SF,10,Home,-29,49,57672,201810210sfo,9443
2018102200,2018_07_NYG_ATL,2018,7,2018-10-22,Monday,20:15,NYG,20,ATL,23,Home,3,43,57673,201810220atl,9444
2018102500,2018_08_MIA_HOU,2018,8,2018-10-25,Thursday,20:20,MIA,23,HOU,42,Home,19,65,57674,201810250htx,9445
2018102800,2018_08_PHI_JAX,2018,8,2018-10-28,Sunday,21:30,PHI,24,JAX,18,Neutral,-6,42,57675,201810280jax,9446
2018102801,2018_08_BAL_CAR,2018,8,2018-10-28,Sunday,13:00,BAL,21,CAR,36,Home,15,57,57676,201810280car,9447
2018102802,2018_08_NYJ_CHI,2018,8,2018-10-28,Sunday,13:00,NYJ,10,CHI,24,Home,14,34,57677,201810280chi,9448
2018102803,2018_08_TB_CIN,2018,8,2018-10-28,Sunday,13:00,TB,34,CIN,37,Home,3,71,57678,201810280cin,9449
2018102804,2018_08_SEA_DET,2018,8,2018-10-28,Sunday,13:00,SEA,28,DET,14,Home,-14,42,57679,201810280det,9450
2018102805,2018_08_DEN_KC,2018,8,2018-10-28,Sunday,13:00,DEN,23,KC,30,Home,7,53,57680,201810280kan,9451
2018102806,2018_08_WAS_NYG,2018,8,2018-10-28,Sunday,13:00,WAS,20,NYG,13,Home,-7,33,57681,201810280nyg,9452
2018102807,2018_08_CLE_PIT,2018,8,2018-10-28,Sunday,13:00,CLE,18,PIT,33,Home,15,51,57682,201810280pit,9453
2018102808,2018_08_IND_OAK,2018,8,2018-10-28,Sunday,16:05,IND,42,OAK,28,Home,-14,70,57683,201810280rai,9454
2018102809,2018_08_SF_ARI,2018,8,2018-10-28,Sunday,16:25,SF,15,ARI,18,Home,3,33,57684,201810280crd,9455
2018102810,2018_08_GB_LAR,2018,8,2018-10-28,Sunday,16:25,GB,27,LAR,29,Home,2,56,57685,201810280ram,9456
2018102811,2018_08_NO_MIN,2018,8,2018-10-28,Sunday,20:20,NO,30,MIN,20,Home,-10,50,57686,201810280min,9457
2018102900,2018_08_NE_BUF,2018,8,2018-10-29,Monday,20:15,NE,25,BUF,6,Home,-19,31,57687,201810290buf,9458
2018110100,2018_09_OAK_SF,2018,9,2018-11-01,Thursday,20:20,OAK,3,SF,34,Home,31,37,57688,201811010sfo,9459
2018110400,2018_09_PIT_BAL,2018,9,2018-11-04,Sunday,13:00,PIT,23,BAL,16,Home,-7,39,57689,201811040rav,9465
2018110401,2018_09_CHI_BUF,2018,9,2018-11-04,Sunday,13:00,CHI,41,BUF,9,Home,-32,50,57690,201811040buf,9460
2018110402,2018_09_TB_CAR,2018,9,2018-11-04,Sunday,13:00,TB,28,CAR,42,Home,14,70,57691,201811040car,9461
2018110403,2018_09_KC_CLE,2018,9,2018-11-04,Sunday,13:00,KC,37,CLE,21,Home,-16,58,57692,201811040cle,9462
2018110404,2018_09_NYJ_MIA,2018,9,2018-11-04,Sunday,13:00,NYJ,6,MIA,13,Home,7,19,57693,201811040mia,9463
2018110405,2018_09_DET_MIN,2018,9,2018-11-04,Sunday,13:00,DET,9,MIN,24,Home,15,33,57694,201811040min,9464
2018110406,2018_09_ATL_WAS,2018,9,2018-11-04,Sunday,13:00,ATL,38,WAS,14,Home,-24,52,57695,201811040was,9466
2018110407,2018_09_HOU_DEN,2018,9,2018-11-04,Sunday,16:05,HOU,19,DEN,17,Home,-2,36,57696,201811040den,9467
2018110408,2018_09_LAC_SEA,2018,9,2018-11-04,Sunday,16:05,LAC,25,SEA,17,Home,-8,42,57697,201811040sea,9468
2018110409,2018_09_LAR_NO,2018,9,2018-11-04,Sunday,16:25,LAR,35,NO,45,Home,10,80,57698,201811040nor,9469
2018110410,2018_09_GB_NE,2018,9,2018-11-04,Sunday,20:20,GB,17,NE,31,Home,14,48,57699,201811040nwe,9470
2018110500,2018_09_TEN_DAL,2018,9,2018-11-05,Monday,20:15,TEN,28,DAL,14,Home,-14,42,57700,201811050dal,9471
2018110800,2018_10_CAR_PIT,2018,10,2018-11-08,Thursday,20:20,CAR,21,PIT,52,Home,31,73,57701,201811080pit,9472
2018111100,2018_10_DET_CHI,2018,10,2018-11-11,Sunday,13:00,DET,22,CHI,34,Home,12,56,57702,201811110chi,9473
2018111101,2018_10_NO_CIN,2018,10,2018-11-11,Sunday,13:00,NO,51,CIN,14,Home,-37,65,57703,201811110cin,9474
2018111102,2018_10_ATL_CLE,2018,10,2018-11-11,Sunday,13:00,ATL,16,CLE,28,Home,12,44,57704,201811110cle,9475
2018111103,2018_10_MIA_GB,2018,10,2018-11-11,Sunday,16:25,MIA,12,GB,31,Home,19,43,57705,201811110gnb,9477
2018111104,2018_10_JAX_IND,2018,10,2018-11-11,Sunday,13:00,JAX,26,IND,29,Home,3,55,57706,201811110clt,9476
2018111105,2018_10_ARI_KC,2018,10,2018-11-11,Sunday,13:00,ARI,14,KC,26,Home,12,40,57707,201811110kan,9478
2018111106,2018_10_BUF_NYJ,2018,10,2018-11-11,Sunday,13:00,BUF,41,NYJ,10,Home,-31,51,57708,201811110nyj,9479
2018111107,2018_10_WAS_TB,2018,10,2018-11-11,Sunday,13:00,WAS,16,TB,3,Home,-13,19,57709,201811110tam,9481
2018111108,2018_10_NE_TEN,2018,10,2018-11-11,Sunday,13:00,NE,10,TEN,34,Home,24,44,57710,201811110oti,9480
2018111109,2018_10_LAC_OAK,2018,10,2018-11-11,Sunday,16:05,LAC,20,OAK,6,Home,-14,26,57711,201811110rai,9482
2018111110,2018_10_SEA_LAR,2018,10,2018-11-11,Sunday,16:25,SEA,31,LAR,36,Home,5,67,57712,201811110ram,9483
2018111111,2018_10_DAL_PHI,2018,10,2018-11-11,Sunday,20:20,DAL,27,PHI,20,Home,-7,47,57713,201811110phi,9484
2018111200,2018_10_NYG_SF,2018,10,2018-11-12,Monday,20:15,NYG,27,SF,23,Home,-4,50,57714,201811120sfo,9485
2018111500,2018_11_GB_SEA,2018,11,2018-11-15,Thursday,20:20,GB,24,SEA,27,Home,3,51,57715,201811150sea,9486
2018111800,2018_11_DAL_ATL,2018,11,2018-11-18,Sunday,13:00,DAL,22,ATL,19,Home,-3,41,57716,201811180atl,9487
2018111801,2018_11_CIN_BAL,2018,11,2018-11-18,Sunday,13:00,CIN,21,BAL,24,Home,3,45,57717,201811180rav,9493
2018111802,2018_11_MIN_CHI,2018,11,2018-11-18,Sunday,20:20,MIN,20,CHI,25,Home,5,45,57718,201811180chi,9488
2018111803,2018_11_CAR_DET,2018,11,2018-11-18,Sunday,13:00,CAR,19,DET,20,Home,1,39,57719,201811180det,9490
2018111804,2018_11_TEN_IND,2018,11,2018-11-18,Sunday,13:00,TEN,10,IND,38,Home,28,48,57720,201811180clt,9489
2018111805,2018_11_TB_NYG,2018,11,2018-11-18,Sunday,13:00,TB,35,NYG,38,Home,3,73,57721,201811180nyg,9492
2018111806,2018_11_HOU_WAS,2018,11,2018-11-18,Sunday,13:00,HOU,23,WAS,21,Home,-2,44,57722,201811180was,9494
2018111807,2018_11_OAK_ARI,2018,11,2018-11-18,Sunday,16:05,OAK,23,ARI,21,Home,-2,44,57723,201811180crd,9495
2018111808,2018_11_DEN_LAC,2018,11,2018-11-18,Sunday,16:05,DEN,23,LAC,22,Home,-1,45,57724,201811180sdg,9496
2018111809,2018_11_PHI_NO,2018,11,2018-11-18,Sunday,16:25,PHI,7,NO,48,Home,41,55,57725,201811180nor,9491
2018111810,2018_11_PIT_JAX,2018,11,2018-11-18,Sunday,13:00,PIT,20,JAX,16,Home,-4,36,57726,201811180jax,9497
2018111900,2018_11_KC_LAR,2018,11,2018-11-19,Monday,20:15,KC,51,LAR,54,Home,3,105,57727,201811190ram,9498
2018112200,2018_12_CHI_DET,2018,12,2018-11-22,Thursday,12:30,CHI,23,DET,16,Home,-7,39,57728,201811220det,9499
2018112201,2018_12_WAS_DAL,2018,12,2018-11-22,Thursday,16:30,WAS,23,DAL,31,Home,8,54,57729,201811220dal,9500
2018112202,2018_12_ATL_NO,2018,12,2018-11-22,Thursday,20:20,ATL,17,NO,31,Home,14,48,57730,201811220nor,9501
2018112500,2018_12_OAK_BAL,2018,12,2018-11-25,Sunday,13:00,OAK,17,BAL,34,Home,17,51,57731,201811250rav,9508
2018112501,2018_12_JAX_BUF,2018,12,2018-11-25,Sunday,13:00,JAX,21,BUF,24,Home,3,45,57732,201811250buf,9502
2018112502,2018_12_SEA_CAR,2018,12,2018-11-25,Sunday,13:00,SEA,30,CAR,27,Home,-3,57,57733,201811250car,9503
2018112503,2018_12_CLE_CIN,2018,12,2018-11-25,Sunday,13:00,CLE,35,CIN,20,Home,-15,55,57734,201811250cin,9504
2018112504,2018_12_MIA_IND,2018,12,2018-11-25,Sunday,16:25,MIA,24,IND,27,Home,3,51,57735,201811250clt,9505
2018112505,2018_12_NE_NYJ,2018,12,2018-11-25,Sunday,13:00,NE,27,NYJ,13,Home,-14,40,57736,201811250nyj,9506
2018112506,2018_12_NYG_PHI,2018,12,2018-11-25,Sunday,13:00,NYG,22,PHI,25,Home,3,47,57737,201811250phi,9507
2018112507,2018_12_SF_TB,2018,12,2018-11-25,Sunday,13:00,SF,9,TB,27,Home,18,36,57738,201811250tam,9509
2018112508,2018_12_ARI_LAC,2018,12,2018-11-25,Sunday,16:05,ARI,10,LAC,45,Home,35,55,57739,201811250sdg,9510
2018112509,2018_12_PIT_DEN,2018,12,2018-11-25,Sunday,16:25,PIT,17,DEN,24,Home,7,41,57740,201811250den,9511
2018112510,2018_12_GB_MIN,2018,12,2018-11-25,Sunday,20:20,GB,17,MIN,24,Home,7,41,57741,201811250min,9512
2018112600,2018_12_TEN_HOU,2018,12,2018-11-26,Monday,20:15,TEN,17,HOU,34,Home,17,51,57742,201811260htx,9513
2018112900,2018_13_NO_DAL,2018,13,2018-11-29,Thursday,20:20,NO,10,DAL,13,Home,3,23,57743,201811290dal,9514
2018120200,2018_13_BAL_ATL,2018,13,2018-12-02,Sunday,13:00,BAL,26,ATL,16,Home,-10,42,57744,201812020atl,9515
2018120201,2018_13_DEN_CIN,2018,13,2018-12-02,Sunday,13:00,DEN,24,CIN,10,Home,-14,34,57745,201812020cin,9516
2018120202,2018_13_LAR_DET,2018,13,2018-12-02,Sunday,13:00,LAR,30,DET,16,Home,-14,46,57746,201812020det,9517
2018120203,2018_13_ARI_GB,2018,13,2018-12-02,Sunday,13:00,ARI,20,GB,17,Home,-3,37,57747,201812020gnb,9518
2018120204,2018_13_CLE_HOU,2018,13,2018-12-02,Sunday,13:00,CLE,13,HOU,29,Home,16,42,57748,201812020htx,9519
2018120205,2018_13_IND_JAX,2018,13,2018-12-02,Sunday,13:00,IND,0,JAX,6,Home,6,6,57749,201812020jax,9520
2018120206,2018_13_BUF_MIA,2018,13,2018-12-02,Sunday,13:00,BUF,17,MIA,21,Home,4,38,57750,201812020mia,9521
2018120207,2018_13_CHI_NYG,2018,13,2018-12-02,Sunday,13:00,CHI,27,NYG,30,Home,3,57,57751,201812020nyg,9522
2018120208,2018_13_LAC_PIT,2018,13,2018-12-02,Sunday,20:20,LAC,33,PIT,30,Home,-3,63,57752,201812020pit,9523
2018120209,2018_13_CAR_TB,2018,13,2018-12-02,Sunday,13:00,CAR,17,TB,24,Home,7,41,57753,201812020tam,9524
2018120210,2018_13_KC_OAK,2018,13,2018-12-02,Sunday,16:05,KC,40,OAK,33,Home,-7,73,57754,201812020rai,9526
2018120211,2018_13_NYJ_TEN,2018,13,2018-12-02,Sunday,16:05,NYJ,22,TEN,26,Home,4,48,57755,201812020oti,9525
2018120212,2018_13_MIN_NE,2018,13,2018-12-02,Sunday,16:25,MIN,10,NE,24,Home,14,34,57756,201812020nwe,9527
2018120213,2018_13_SF_SEA,2018,13,2018-12-02,Sunday,16:25,SF,16,SEA,43,Home,27,59,57757,201812020sea,9528
2018120300,2018_13_WAS_PHI,2018,13,2018-12-03,Monday,20:15,WAS,13,PHI,28,Home,15,41,57758,201812030phi,9529
2018120600,2018_14_JAX_TEN,2018,14,2018-12-06,Thursday,20:20,JAX,9,TEN,30,Home,21,39,57759,201812060oti,9530
2018120900,2018_14_NYJ_BUF,2018,14,2018-12-09,Sunday,13:00,NYJ,27,BUF,23,Home,-4,50,57760,201812090buf,9531
2018120901,2018_14_LAR_CHI,2018,14,2018-12-09,Sunday,20:20,LAR,6,CHI,15,Home,9,21,57761,201812090chi,9532
2018120902,2018_14_CAR_CLE,2018,14,2018-12-09,Sunday,13:00,CAR,20,CLE,26,Home,6,46,57762,201812090cle,9533
2018120903,2018_14_ATL_GB,2018,14,2018-12-09,Sunday,13:00,ATL,20,GB,34,Home,14,54,57763,201812090gnb,9534
2018120904,2018_14_IND_HOU,2018,14,2018-12-09,Sunday,13:00,IND,24,HOU,21,Home,-3,45,57764,201812090htx,9535
2018120905,2018_14_BAL_KC,2018,14,2018-12-09,Sunday,13:00,BAL,24,KC,27,Home,3,51,57765,201812090kan,9536
2018120906,2018_14_NE_MIA,2018,14,2018-12-09,Sunday,13:00,NE,33,MIA,34,Home,1,67,57766,201812090mia,9537
2018120907,2018_14_NO_TB,2018,14,2018-12-09,Sunday,13:00,NO,28,TB,14,Home,-14,42,57767,201812090tam,9538
2018120908,2018_14_NYG_WAS,2018,14,2018-12-09,Sunday,13:00,NYG,40,WAS,16,Home,-24,56,57768,201812090was,9539
2018120909,2018_14_CIN_LAC,2018,14,2018-12-09,Sunday,16:05,CIN,21,LAC,26,Home,5,47,57769,201812090sdg,9540
2018120910,2018_14_DEN_SF,2018,14,2018-12-09,Sunday,16:05,DEN,14,SF,20,Home,6,34,57770,201812090sfo,9541
2018120911,2018_14_DET_ARI,2018,14,2018-12-09,Sunday,16:25,DET,17,ARI,3,Home,-14,20,57771,201812090crd,9542
2018120912,2018_14_PHI_DAL,2018,14,2018-12-09,Sunday,16:25,PHI,23,DAL,29,Home,6,52,57772,201812090dal,9543
2018120913,2018_14_PIT_OAK,2018,14,2018-12-09,Sunday,16:25,PIT,21,OAK,24,Home,3,45,57773,201812090rai,9544
2018121000,2018_14_MIN_SEA,2018,14,2018-12-10,Monday,20:15,MIN,7,SEA,21,Home,14,28,57774,201812100sea,9545
2018121300,2018_15_LAC_KC,2018,15,2018-12-13,Thursday,20:20,LAC,29,KC,28,Home,-1,57,57775,201812130kan,9546
2018121500,2018_15_HOU_NYJ,2018,15,2018-12-15,Saturday,16:30,HOU,29,NYJ,22,Home,-7,51,57776,201812150nyj,9548
2018121501,2018_15_CLE_DEN,2018,15,2018-12-15,Saturday,20:20,CLE,17,DEN,16,Home,-1,33,57777,201812150den,9547
2018121600,2018_15_ARI_ATL,2018,15,2018-12-16,Sunday,13:00,ARI,14,ATL,40,Home,26,54,57778,201812160atl,9549
2018121601,2018_15_TB_BAL,2018,15,2018-12-16,Sunday,13:00,TB,12,BAL,20,Home,8,32,57779,201812160rav,9557
2018121602,2018_15_DET_BUF,2018,15,2018-12-16,Sunday,13:00,DET,13,BUF,14,Home,1,27,57780,201812160buf,9550
2018121603,2018_15_GB_CHI,2018,15,2018-12-16,Sunday,13:00,GB,17,CHI,24,Home,7,41,57781,201812160chi,9551
2018121604,2018_15_OAK_CIN,2018,15,2018-12-16,Sunday,13:00,OAK,16,CIN,30,Home,14,46,57782,201812160cin,9552
2018121605,2018_15_DAL_IND,2018,15,2018-12-16,Sunday,13:00,DAL,0,IND,23,Home,23,23,57783,201812160clt,9553
2018121606,2018_15_WAS_JAX,2018,15,2018-12-16,Sunday,13:00,WAS,16,JAX,13,Home,-3,29,57784,201812160jax,9554
2018121607,2018_15_MIA_MIN,2018,15,2018-12-16,Sunday,13:00,MIA,17,MIN,41,Home,24,58,57785,201812160min,9555
2018121608,2018_15_TEN_NYG,2018,15,2018-12-16,Sunday,13:00,TEN,17,NYG,0,Home,-17,17,57786,201812160nyg,9556
2018121609,2018_15_SEA_SF,2018,15,2018-12-16,Sunday,16:05,SEA,23,SF,26,Home,3,49,57787,201812160sfo,9558
2018121610,2018_15_NE_PIT,2018,15,2018-12-16,Sunday,16:25,NE,10,PIT,17,Home,7,27,57788,201812160pit,9559
2018121611,2018_15_PHI_LAR,2018,15,2018-12-16,Sunday,20:20,PHI,30,LAR,23,Home,-7,53,57789,201812160ram,9560
2018121700,2018_15_NO_CAR,2018,15,2018-12-17,Monday,20:15,NO,12,CAR,9,Home,-3,21,57790,201812170car,9561
2018122200,2018_16_WAS_TEN,2018,16,2018-12-22,Saturday,16:30,WAS,16,TEN,25,Home,9,41,57794,201812220oti,9570
2018122201,2018_16_BAL_LAC,2018,16,2018-12-22,Saturday,20:20,BAL,22,LAC,10,Home,-12,32,57792,201812220sdg,9573
2018122300,2018_16_NYG_IND,2018,16,2018-12-23,Sunday,13:00,NYG,27,IND,28,Home,1,55,57791,201812230clt,9564
2018122302,2018_16_JAX_MIA,2018,16,2018-12-23,Sunday,13:00,JAX,17,MIA,7,Home,-10,24,57793,201812230mia,9567
2018122304,2018_16_ATL_CAR,2018,16,2018-12-23,Sunday,13:00,ATL,24,CAR,10,Home,-14,34,57795,201812230car,9562
2018122305,2018_16_CIN_CLE,2018,16,2018-12-23,Sunday,13:00,CIN,18,CLE,26,Home,8,44,57796,201812230cle,9563
2018122306,2018_16_TB_DAL,2018,16,2018-12-23,Sunday,13:00,TB,20,DAL,27,Home,7,47,57797,201812230dal,9565
2018122307,2018_16_MIN_DET,2018,16,2018-12-23,Sunday,13:00,MIN,27,DET,9,Home,-18,36,57798,201812230det,9566
2018122308,2018_16_BUF_NE,2018,16,2018-12-23,Sunday,13:00,BUF,12,NE,24,Home,12,36,57799,201812230nwe,9568
2018122309,2018_16_GB_NYJ,2018,16,2018-12-23,Sunday,13:00,GB,44,NYJ,38,Home,-6,82,57800,201812230nyj,9569
2018122310,2018_16_HOU_PHI,2018,16,2018-12-23,Sunday,13:00,HOU,30,PHI,32,Home,2,62,57801,201812230phi,9571
2018122311,2018_16_LAR_ARI,2018,16,2018-12-23,Sunday,16:05,LAR,31,ARI,9,Home,-22,40,57802,201812230crd,9572
2018122312,2018_16_CHI_SF,2018,16,2018-12-23,Sunday,16:05,CHI,14,SF,9,Home,-5,23,57803,201812230sfo,9574
2018122313,2018_16_PIT_NO,2018,16,2018-12-23,Sunday,16:25,PIT,28,NO,31,Home,3,59,57804,201812230nor,9575
2018122314,2018_16_KC_SEA,2018,16,2018-12-23,Sunday,20:20,KC,31,SEA,38,Home,7,69,57805,201812230sea,9576
2018122400,2018_16_DEN_OAK,2018,16,2018-12-24,Monday,20:15,DEN,14,OAK,27,Home,13,41,57806,201812240rai,9577
2018123000,2018_17_CLE_BAL,2018,17,2018-12-30,Sunday,16:25,CLE,24,BAL,26,Home,2,50,57807,201812300rav,9588
2018123001,2018_17_MIA_BUF,2018,17,2018-12-30,Sunday,13:00,MIA,17,BUF,42,Home,25,59,57808,201812300buf,9578
2018123002,2018_17_DET_GB,2018,17,2018-12-30,Sunday,13:00,DET,31,GB,0,Home,-31,31,57809,201812300gnb,9579
2018123003,2018_17_JAX_HOU,2018,17,2018-12-30,Sunday,13:00,JAX,3,HOU,20,Home,17,23,57810,201812300htx,9580
2018123004,2018_17_OAK_KC,2018,17,2018-12-30,Sunday,16:25,OAK,3,KC,35,Home,32,38,57811,201812300kan,9581
2018123005,2018_17_CHI_MIN,2018,17,2018-12-30,Sunday,16:25,CHI,24,MIN,10,Home,-14,34,57812,201812300min,9582
2018123006,2018_17_NYJ_NE,2018,17,2018-12-30,Sunday,13:00,NYJ,3,NE,38,Home,35,41,57813,201812300nwe,9584
2018123007,2018_17_CAR_NO,2018,17,2018-12-30,Sunday,13:00,CAR,33,NO,14,Home,-19,47,57814,201812300nor,9583
2018123008,2018_17_DAL_NYG,2018,17,2018-12-30,Sunday,13:00,DAL,36,NYG,35,Home,-1,71,57815,201812300nyg,9585
2018123009,2018_17_CIN_PIT,2018,17,2018-12-30,Sunday,16:25,CIN,13,PIT,16,Home,3,29,57816,201812300pit,9587
2018123010,2018_17_ATL_TB,2018,17,2018-12-30,Sunday,13:00,ATL,34,TB,32,Home,-2,66,57817,201812300tam,9589
2018123011,2018_17_IND_TEN,2018,17,2018-12-30,Sunday,20:20,IND,33,TEN,17,Home,-16,50,57818,201812300oti,9586
2018123012,2018_17_PHI_WAS,2018,17,2018-12-30,Sunday,16:25,PHI,24,WAS,0,Home,-24,24,57819,201812300was,9590
2018123013,2018_17_LAC_DEN,2018,17,2018-12-30,Sunday,16:25,LAC,23,DEN,9,Home,-14,32,57820,201812300den,9591
2018123014,2018_17_SF_LAR,2018,17,2018-12-30,Sunday,16:25,SF,32,LAR,48,Home,16,80,57821,201812300ram,9592
2018123015,2018_17_ARI_SEA,2018,17,2018-12-30,Sunday,16:25,ARI,24,SEA,27,Home,3,51,57822,201812300sea,9593
2019010500,2018_18_IND_HOU,2018,18,2019-01-05,Saturday,16:35,IND,21,HOU,7,Home,-14,28,57823,201901050htx,13606
2019010501,2018_18_SEA_DAL,2018,18,2019-01-05,Saturday,20:15,SEA,22,DAL,24,Home,2,46,57824,201901050dal,13607
2019010600,2018_18_LAC_BAL,2018,18,2019-01-06,Sunday,13:05,LAC,23,BAL,17,Home,-6,40,57825,201901060rav,13608
2019010601,2018_18_PHI_CHI,2018,18,2019-01-06,Sunday,16:40,PHI,16,CHI,15,Home,-1,31,57826,201901060chi,13609
2019011200,2018_19_IND_KC,2018,19,2019-01-12,Saturday,16:35,IND,13,KC,31,Home,18,44,57827,201901120kan,13611
2019011201,2018_19_DAL_LAR,2018,19,2019-01-12,Saturday,20:15,DAL,22,LAR,30,Home,8,52,57828,201901120ram,13612
2019011300,2018_19_LAC_NE,2018,19,2019-01-13,Sunday,13:05,LAC,28,NE,41,Home,13,69,57829,201901130nwe,13613
2019011301,2018_19_PHI_NO,2018,19,2019-01-13,Sunday,16:40,PHI,14,NO,20,Home,6,34,57830,201901130nor,13614
2019012000,2018_20_LAR_NO,2018,20,2019-01-20,Sunday,15:05,LAR,26,NO,23,Home,-3,49,57831,201901200nor,13615
2019012001,2018_20_NE_KC,2018,20,2019-01-20,Sunday,18:40,NE,37,KC,31,Home,-6,68,57832,201901200kan,13616
2019020300,2018_21_NE_LAR,2018,21,2019-02-03,Sunday,18:30,NE,13,LAR,3,Neutral,-10,16,57833,201901200ram,13635
2019090500,2019_01_GB_CHI,2019,1,2019-09-05,Thursday,20:20,GB,,CHI,,Home,,,57900,201909050chi,13762
2019090800,2019_01_LAR_CAR,2019,1,2019-09-08,Sunday,13:00,LAR,,CAR,,Home,,,57901,201909080car,13768
2019090801,2019_01_TEN_CLE,2019,1,2019-09-08,Sunday,13:00,TEN,,CLE,,Home,,,57902,201909080cle,13763
2019090802,2019_01_KC_JAX,2019,1,2019-09-08,Sunday,13:00,KC,,JAX,,Home,,,57903,201909080jax,13769
2019090803,2019_01_BAL_MIA,2019,1,2019-09-08,Sunday,13:00,BAL,,MIA,,Home,,,57904,201909080mia,13764
2019090804,2019_01_ATL_MIN,2019,1,2019-09-08,Sunday,13:00,ATL,,MIN,,Home,,,57905,201909080min,13765
2019090805,2019_01_BUF_NYJ,2019,1,2019-09-08,Sunday,13:00,BUF,,NYJ,,Home,,,57906,201909080nyj,13766
2019090806,2019_01_WAS_PHI,2019,1,2019-09-08,Sunday,13:00,WAS,,PHI,,Home,,,57907,201909080phi,13767
2019090807,2019_01_IND_LAC,2019,1,2019-09-08,Sunday,16:05,IND,,LAC,,Home,,,57908,201909080sdg,13770
2019090808,2019_01_CIN_SEA,2019,1,2019-09-08,Sunday,16:05,CIN,,SEA,,Home,,,57909,201909080sea,13771
2019090809,2019_01_DET_ARI,2019,1,2019-09-08,Sunday,16:25,DET,,ARI,,Home,,,57910,201909080crd,13773
2019090810,2019_01_NYG_DAL,2019,1,2019-09-08,Sunday,16:25,NYG,,DAL,,Home,,,57911,201909080dal,13772
2019090811,2019_01_SF_TB,2019,1,2019-09-08,Sunday,16:25,SF,,TB,,Home,,,57912,201909080tam,13774
2019090812,2019_01_PIT_NE,2019,1,2019-09-08,Sunday,20:20,PIT,,NE,,Home,,,57913,201909080nwe,13775
2019090900,2019_01_HOU_NO,2019,1,2019-09-09,Monday,19:10,HOU,,NO,,Home,,,57914,201909090nor,13776
2019090901,2019_01_DEN_OAK,2019,1,2019-09-09,Monday,22:20,DEN,,OAK,,Home,,,57915,201909090rai,13777
2019091200,2019_02_TB_CAR,2019,2,2019-09-12,Thursday,20:20,TB,,CAR,,Home,,,57916,201909120car,
2019091500,2019_02_ARI_BAL,2019,2,2019-09-15,Sunday,13:00,ARI,,BAL,,Home,,,57917,201909150rav,
2019091501,2019_02_SF_CIN,2019,2,2019-09-15,Sunday,13:00,SF,,CIN,,Home,,,57918,201909150cin,
2019091502,2019_02_LAC_DET,2019,2,2019-09-15,Sunday,13:00,LAC,,DET,,Home,,,57919,201909150det,
2019091503,2019_02_MIN_GB,2019,2,2019-09-15,Sunday,13:00,MIN,,GB,,Home,,,57920,201909150gnb,
2019091504,2019_02_JAX_HOU,2019,2,2019-09-15,Sunday,13:00,JAX,,HOU,,Home,,,57921,201909150htx,
2019091505,2019_02_NE_MIA,2019,2,2019-09-15,Sunday,13:00,NE,,MIA,,Home,,,57922,201909150mia,
2019091506,2019_02_BUF_NYG,2019,2,2019-09-15,Sunday,13:00,BUF,,NYG,,Home,,,57923,201909150nyg,
2019091507,2019_02_SEA_PIT,2019,2,2019-09-15,Sunday,13:00,SEA,,PIT,,Home,,,57924,201909150pit,
2019091508,2019_02_IND_TEN,2019,2,2019-09-15,Sunday,13:00,IND,,TEN,,Home,,,57925,201909150oti,
2019091509,2019_02_DAL_WAS,2019,2,2019-09-15,Sunday,13:00,DAL,,WAS,,Home,,,57926,201909150was,
2019091510,2019_02_KC_OAK,2019,2,2019-09-15,Sunday,16:05,KC,,OAK,,Home,,,57927,201909150rai,
2019091511,2019_02_CHI_DEN,2019,2,2019-09-15,Sunday,16:25,CHI,,DEN,,Home,,,57928,201909150den,
2019091512,2019_02_NO_LAR,2019,2,2019-09-15,Sunday,16:25,NO,,LAR,,Home,,,57929,201909150ram,
2019091513,2019_02_PHI_ATL,2019,2,2019-09-15,Sunday,20:20,PHI,,ATL,,Home,,,57930,201909150atl,
2019091600,2019_02_CLE_NYJ,2019,2,2019-09-16,Monday,20:15,CLE,,NYJ,,Home,,,57931,201909160nyj,
2019091900,2019_03_TEN_JAX,2019,3,2019-09-19,Thursday,20:20,TEN,,JAX,,Home,,,57932,201909190jax,
2019092200,2019_03_CIN_BUF,2019,3,2019-09-22,Sunday,13:00,CIN,,BUF,,Home,,,57933,201909220buf,
2019092201,2019_03_MIA_DAL,2019,3,2019-09-22,Sunday,13:00,MIA,,DAL,,Home,,,57934,201909220dal,
2019092202,2019_03_DEN_GB,2019,3,2019-09-22,Sunday,13:00,DEN,,GB,,Home,,,57935,201909220gnb,
2019092203,2019_03_ATL_IND,2019,3,2019-09-22,Sunday,13:00,ATL,,IND,,Home,,,57936,201909220clt,
2019092204,2019_03_BAL_KC,2019,3,2019-09-22,Sunday,13:00,BAL,,KC,,Home,,,57937,201909220kan,
2019092205,2019_03_OAK_MIN,2019,3,2019-09-22,Sunday,13:00,OAK,,MIN,,Home,,,57938,201909220min,
2019092206,2019_03_NYJ_NE,2019,3,2019-09-22,Sunday,13:00,NYJ,,NE,,Home,,,57939,201909220nwe,
2019092207,2019_03_DET_PHI,2019,3,2019-09-22,Sunday,13:00,DET,,PHI,,Home,,,57940,201909220phi,
2019092208,2019_03_CAR_ARI,2019,3,2019-09-22,Sunday,16:05,CAR,,ARI,,Home,,,57941,201909220crd,
2019092209,2019_03_NYG_TB,2019,3,2019-09-22,Sunday,16:05,NYG,,TB,,Home,,,57942,201909220tam,
2019092210,2019_03_HOU_LAC,2019,3,2019-09-22,Sunday,16:25,HOU,,LAC,,Home,,,57943,201909220sdg,
2019092211,2019_03_NO_SEA,2019,3,2019-09-22,Sunday,16:25,NO,,SEA,,Home,,,57944,201909220sea,
2019092212,2019_03_PIT_SF,2019,3,2019-09-22,Sunday,16:25,PIT,,SF,,Home,,,57945,201909220sfo,
2019092213,2019_03_LAR_CLE,2019,3,2019-09-22,Sunday,20:20,LAR,,CLE,,Home,,,57946,201909220cle,
2019092300,2019_03_CHI_WAS,2019,3,2019-09-23,Monday,20:15,CHI,,WAS,,Home,,,57947,201909230was,
2019092600,2019_04_PHI_GB,2019,4,2019-09-26,Thursday,20:20,PHI,,GB,,Home,,,57948,201909260gnb,
2019092900,2019_04_TEN_ATL,2019,4,2019-09-29,Sunday,13:00,TEN,,ATL,,Home,,,57949,201909290atl,
2019092901,2019_04_CLE_BAL,2019,4,2019-09-29,Sunday,13:00,CLE,,BAL,,Home,,,57950,201909290rav,
2019092902,2019_04_NE_BUF,2019,4,2019-09-29,Sunday,13:00,NE,,BUF,,Home,,,57951,201909290buf,
2019092903,2019_04_KC_DET,2019,4,2019-09-29,Sunday,13:00,KC,,DET,,Home,,,57952,201909290det,
2019092904,2019_04_CAR_HOU,2019,4,2019-09-29,Sunday,13:00,CAR,,HOU,,Home,,,57953,201909290htx,
2019092905,2019_04_OAK_IND,2019,4,2019-09-29,Sunday,13:00,OAK,,IND,,Home,,,57954,201909290clt,
2019092906,2019_04_LAC_MIA,2019,4,2019-09-29,Sunday,13:00,LAC,,MIA,,Home,,,57955,201909290mia,
2019092907,2019_04_WAS_NYG,2019,4,2019-09-29,Sunday,13:00,WAS,,NYG,,Home,,,57956,201909290nyg,
2019092908,2019_04_SEA_ARI,2019,4,2019-09-29,Sunday,16:05,SEA,,ARI,,Home,,,57957,201909290crd,
2019092909,2019_04_TB_LAR,2019,4,2019-09-29,Sunday,16:05,TB,,LAR,,Home,,,57958,201909290ram,
2019092910,2019_04_MIN_CHI,2019,4,2019-09-29,Sunday,16:25,MIN,,CHI,,Home,,,57959,201909290chi,
2019092911,2019_04_JAX_DEN,2019,4,2019-09-29,Sunday,16:25,JAX,,DEN,,Home,,,57960,201909290den,
2019092912,2019_04_DAL_NO,2019,4,2019-09-29,Sunday,20:20,DAL,,NO,,Home,,,57961,201909290nor,
2019093000,2019_04_CIN_PIT,2019,4,2019-09-30,Monday,20:15,CIN,,PIT,,Home,,,57962,201909300pit,
2019100300,2019_05_LAR_SEA,2019,5,2019-10-03,Thursday,20:20,LAR,,SEA,,Home,,,57963,201910030sea,
2019100600,2019_05_JAX_CAR,2019,5,2019-10-06,Sunday,13:00,JAX,,CAR,,Home,,,57964,201910060car,
2019100601,2019_05_ARI_CIN,2019,5,2019-10-06,Sunday,13:00,ARI,,CIN,,Home,,,57965,201910060cin,
2019100602,2019_05_ATL_HOU,2019,5,2019-10-06,Sunday,13:00,ATL,,HOU,,Home,,,57966,201910060htx,
2019100603,2019_05_TB_NO,2019,5,2019-10-06,Sunday,13:00,TB,,NO,,Home,,,57967,201910060nor,
2019100604,2019_05_MIN_NYG,2019,5,2019-10-06,Sunday,13:00,MIN,,NYG,,Home,,,57968,201910060nyg,
2019100605,2019_05_CHI_OAK,2019,5,2019-10-06,Sunday,13:00,CHI,,OAK,,Neutral,,,57969,201910060rai,
2019100606,2019_05_NYJ_PHI,2019,5,2019-10-06,Sunday,13:00,NYJ,,PHI,,Home,,,57970,201910060phi,
2019100607,2019_05_BAL_PIT,2019,5,2019-10-06,Sunday,13:00,BAL,,PIT,,Home,,,57971,201910060pit,
2019100608,2019_05_BUF_TEN,2019,5,2019-10-06,Sunday,13:00,BUF,,TEN,,Home,,,57972,201910060oti,
2019100609,2019_05_NE_WAS,2019,5,2019-10-06,Sunday,13:00,NE,,WAS,,Home,,,57973,201910060was,
2019100610,2019_05_DEN_LAC,2019,5,2019-10-06,Sunday,16:05,DEN,,LAC,,Home,,,57974,201910060sdg,
2019100611,2019_05_GB_DAL,2019,5,2019-10-06,Sunday,16:25,GB,,DAL,,Home,,,57975,201910060dal,
2019100612,2019_05_IND_KC,2019,5,2019-10-06,Sunday,20:20,IND,,KC,,Home,,,57976,201910060kan,
2019100700,2019_05_CLE_SF,2019,5,2019-10-07,Monday,20:15,CLE,,SF,,Home,,,57977,201910070sfo,
2019101000,2019_06_NYG_NE,2019,6,2019-10-10,Thursday,20:20,NYG,,NE,,Home,,,57978,201910100nwe,
2019101300,2019_06_CAR_TB,2019,6,2019-10-13,Sunday,09:30,CAR,,TB,,Neutral,,,57979,201910130tam,
2019101301,2019_06_CIN_BAL,2019,6,2019-10-13,Sunday,13:00,CIN,,BAL,,Home,,,57980,201910130rav,
2019101302,2019_06_SEA_CLE,2019,6,2019-10-13,Sunday,13:00,SEA,,CLE,,Home,,,57981,201910130cle,
2019101303,2019_06_NO_JAX,2019,6,2019-10-13,Sunday,13:00,NO,,JAX,,Home,,,57982,201910130jax,
2019101304,2019_06_HOU_KC,2019,6,2019-10-13,Sunday,13:00,HOU,,KC,,Home,,,57983,201910130kan,
2019101305,2019_06_WAS_MIA,2019,6,2019-10-13,Sunday,13:00,WAS,,MIA,,Home,,,57984,201910130mia,
2019101306,2019_06_PHI_MIN,2019,6,2019-10-13,Sunday,13:00,PHI,,MIN,,Home,,,57985,201910130min,
2019101307,2019_06_ATL_ARI,2019,6,2019-10-13,Sunday,16:05,ATL,,ARI,,Home,,,57986,201910130crd,
2019101308,2019_06_SF_LAR,2019,6,2019-10-13,Sunday,16:05,SF,,LAR,,Home,,,57987,201910130ram,
2019101309,2019_06_TEN_DEN,2019,6,2019-10-13,Sunday,16:25,TEN,,DEN,,Home,,,57988,201910130den,
2019101310,2019_06_DAL_NYJ,2019,6,2019-10-13,Sunday,16:25,DAL,,NYJ,,Home,,,57989,201910130nyj,
2019101311,2019_06_PIT_LAC,2019,6,2019-10-13,Sunday,20:20,PIT,,LAC,,Home,,,57990,201910130sdg,
2019101400,2019_06_DET_GB,2019,6,2019-10-14,Monday,20:15,DET,,GB,,Home,,,57991,201910140gnb,
2019101700,2019_07_KC_DEN,2019,7,2019-10-17,Thursday,20:20,KC,,DEN,,Home,,,57992,201910170den,
2019102000,2019_07_LAR_ATL,2019,7,2019-10-20,Sunday,13:00,LAR,,ATL,,Home,,,57993,201910200atl,
2019102001,2019_07_MIA_BUF,2019,7,2019-10-20,Sunday,13:00,MIA,,BUF,,Home,,,57994,201910200buf,
2019102002,2019_07_JAX_CIN,2019,7,2019-10-20,Sunday,13:00,JAX,,CIN,,Home,,,57995,201910200cin,
2019102003,2019_07_MIN_DET,2019,7,2019-10-20,Sunday,13:00,MIN,,DET,,Home,,,57996,201910200det,
2019102004,2019_07_OAK_GB,2019,7,2019-10-20,Sunday,13:00,OAK,,GB,,Home,,,57997,201910200gnb,
2019102005,2019_07_HOU_IND,2019,7,2019-10-20,Sunday,13:00,HOU,,IND,,Home,,,57998,201910200clt,
2019102006,2019_07_ARI_NYG,2019,7,2019-10-20,Sunday,13:00,ARI,,NYG,,Home,,,57999,201910200nyg,
2019102007,2019_07_SF_WAS,2019,7,2019-10-20,Sunday,13:00,SF,,WAS,,Home,,,58000,201910200was,
2019102008,2019_07_LAC_TEN,2019,7,2019-10-20,Sunday,16:05,LAC,,TEN,,Home,,,58001,201910200oti,
2019102009,2019_07_NO_CHI,2019,7,2019-10-20,Sunday,16:25,NO,,CHI,,Home,,,58002,201910200chi,
2019102010,2019_07_BAL_SEA,2019,7,2019-10-20,Sunday,16:25,BAL,,SEA,,Home,,,58003,201910200sea,
2019102011,2019_07_PHI_DAL,2019,7,2019-10-20,Sunday,20:20,PHI,,DAL,,Home,,,58004,201910200dal,
2019102100,2019_07_NE_NYJ,2019,7,2019-10-21,Monday,20:15,NE,,NYJ,,Home,,,58005,201910210nyj,
2019102400,2019_08_WAS_MIN,2019,8,2019-10-24,Thursday,20:20,WAS,,MIN,,Home,,,58006,201910240min,
2019102700,2019_08_SEA_ATL,2019,8,2019-10-27,Sunday,13:00,SEA,,ATL,,Home,,,58007,201910270atl,
2019102701,2019_08_PHI_BUF,2019,8,2019-10-27,Sunday,13:00,PHI,,BUF,,Home,,,58008,201910270buf,
2019102702,2019_08_LAC_CHI,2019,8,2019-10-27,Sunday,13:00,LAC,,CHI,,Home,,,58009,201910270chi,
2019102703,2019_08_NYG_DET,2019,8,2019-10-27,Sunday,13:00,NYG,,DET,,Home,,,58010,201910270det,
2019102704,2019_08_OAK_HOU,2019,8,2019-10-27,Sunday,13:00,OAK,,HOU,,Home,,,58011,201910270htx,
2019102705,2019_08_NYJ_JAX,2019,8,2019-10-27,Sunday,13:00,NYJ,,JAX,,Home,,,58012,201910270jax,
2019102706,2019_08_CIN_LAR,2019,8,2019-10-27,Sunday,13:00,CIN,,LAR,,Neutral,,,58013,201910270ram,
2019102707,2019_08_ARI_NO,2019,8,2019-10-27,Sunday,13:00,ARI,,NO,,Home,,,58014,201910270nor,
2019102708,2019_08_TB_TEN,2019,8,2019-10-27,Sunday,13:00,TB,,TEN,,Home,,,58015,201910270oti,
2019102709,2019_08_CAR_SF,2019,8,2019-10-27,Sunday,16:05,CAR,,SF,,Home,,,58016,201910270sfo,
2019102710,2019_08_DEN_IND,2019,8,2019-10-27,Sunday,16:25,DEN,,IND,,Home,,,58017,201910270clt,
2019102711,2019_08_CLE_NE,2019,8,2019-10-27,Sunday,16:25,CLE,,NE,,Home,,,58018,201910270nwe,
2019102712,2019_08_GB_KC,2019,8,2019-10-27,Sunday,20:20,GB,,KC,,Home,,,58019,201910270kan,
2019102800,2019_08_MIA_PIT,2019,8,2019-10-28,Monday,20:15,MIA,,PIT,,Home,,,58020,201910280pit,
2019103100,2019_09_SF_ARI,2019,9,2019-10-31,Thursday,20:20,SF,,ARI,,Home,,,58021,201910310crd,
2019110300,2019_09_HOU_JAX,2019,9,2019-11-03,Sunday,09:30,HOU,,JAX,,Neutral,,,58022,201911030jax,
2019110301,2019_09_WAS_BUF,2019,9,2019-11-03,Sunday,13:00,WAS,,BUF,,Home,,,58023,201911030buf,
2019110302,2019_09_TEN_CAR,2019,9,2019-11-03,Sunday,13:00,TEN,,CAR,,Home,,,58024,201911030car,
2019110303,2019_09_MIN_KC,2019,9,2019-11-03,Sunday,13:00,MIN,,KC,,Home,,,58025,201911030kan,
2019110304,2019_09_NYJ_MIA,2019,9,2019-11-03,Sunday,13:00,NYJ,,MIA,,Home,,,58026,201911030mia,
2019110305,2019_09_CHI_PHI,2019,9,2019-11-03,Sunday,13:00,CHI,,PHI,,Home,,,58027,201911030phi,
2019110306,2019_09_IND_PIT,2019,9,2019-11-03,Sunday,13:00,IND,,PIT,,Home,,,58028,201911030pit,
2019110307,2019_09_DET_OAK,2019,9,2019-11-03,Sunday,16:05,DET,,OAK,,Home,,,58029,201911030rai,
2019110308,2019_09_TB_SEA,2019,9,2019-11-03,Sunday,16:05,TB,,SEA,,Home,,,58030,201911030sea,
2019110309,2019_09_CLE_DEN,2019,9,2019-11-03,Sunday,16:25,CLE,,DEN,,Home,,,58031,201911030den,
2019110310,2019_09_GB_LAC,2019,9,2019-11-03,Sunday,16:25,GB,,LAC,,Home,,,58032,201911030sdg,
2019110311,2019_09_NE_BAL,2019,9,2019-11-03,Sunday,20:20,NE,,BAL,,Home,,,58033,201911030rav,
2019110400,2019_09_DAL_NYG,2019,9,2019-11-04,Monday,20:15,DAL,,NYG,,Home,,,58034,201911040nyg,
2019110700,2019_10_LAC_OAK,2019,10,2019-11-07,Thursday,20:20,LAC,,OAK,,Home,,,58035,201911070rai,
2019111000,2019_10_DET_CHI,2019,10,2019-11-10,Sunday,13:00,DET,,CHI,,Home,,,58036,201911100chi,
2019111001,2019_10_BAL_CIN,2019,10,2019-11-10,Sunday,13:00,BAL,,CIN,,Home,,,58037,201911100cin,
2019111002,2019_10_BUF_CLE,2019,10,2019-11-10,Sunday,13:00,BUF,,CLE,,Home,,,58038,201911100cle,
2019111003,2019_10_CAR_GB,2019,10,2019-11-10,Sunday,13:00,CAR,,GB,,Home,,,58039,201911100gnb,
2019111004,2019_10_ATL_NO,2019,10,2019-11-10,Sunday,13:00,ATL,,NO,,Home,,,58040,201911100nor,
2019111005,2019_10_NYG_NYJ,2019,10,2019-11-10,Sunday,13:00,NYG,,NYJ,,Home,,,58041,201911100nyj,
2019111006,2019_10_ARI_TB,2019,10,2019-11-10,Sunday,13:00,ARI,,TB,,Home,,,58042,201911100tam,
2019111007,2019_10_KC_TEN,2019,10,2019-11-10,Sunday,13:00,KC,,TEN,,Home,,,58043,201911100oti,
2019111008,2019_10_MIA_IND,2019,10,2019-11-10,Sunday,16:05,MIA,,IND,,Home,,,58044,201911100clt,
2019111009,2019_10_LAR_PIT,2019,10,2019-11-10,Sunday,16:25,LAR,,PIT,,Home,,,58045,201911100pit,
2019111010,2019_10_MIN_DAL,2019,10,2019-11-10,Sunday,20:20,MIN,,DAL,,Home,,,58046,201911100dal,
2019111100,2019_10_SEA_SF,2019,10,2019-11-11,Monday,20:15,SEA,,SF,,Home,,,58047,201911110sfo,
2019111400,2019_11_PIT_CLE,2019,11,2019-11-14,Thursday,20:20,PIT,,CLE,,Home,,,58048,201911140cle,
2019111700,2019_11_HOU_BAL,2019,11,2019-11-17,Sunday,13:00,HOU,,BAL,,Home,,,58049,201911170rav,
2019111701,2019_11_ATL_CAR,2019,11,2019-11-17,Sunday,13:00,ATL,,CAR,,Home,,,58050,201911170car,
2019111702,2019_11_DAL_DET,2019,11,2019-11-17,Sunday,13:00,DAL,,DET,,Home,,,58051,201911170det,
2019111703,2019_11_JAX_IND,2019,11,2019-11-17,Sunday,13:00,JAX,,IND,,Home,,,58052,201911170clt,
2019111704,2019_11_BUF_MIA,2019,11,2019-11-17,Sunday,13:00,BUF,,MIA,,Home,,,58053,201911170mia,
2019111705,2019_11_DEN_MIN,2019,11,2019-11-17,Sunday,13:00,DEN,,MIN,,Home,,,58054,201911170min,
2019111706,2019_11_NO_TB,2019,11,2019-11-17,Sunday,13:00,NO,,TB,,Home,,,58055,201911170tam,
2019111707,2019_11_NYJ_WAS,2019,11,2019-11-17,Sunday,13:00,NYJ,,WAS,,Home,,,58056,201911170was,
2019111708,2019_11_ARI_SF,2019,11,2019-11-17,Sunday,16:05,ARI,,SF,,Home,,,58057,201911170sfo,
2019111709,2019_11_CIN_OAK,2019,11,2019-11-17,Sunday,16:25,CIN,,OAK,,Home,,,58058,201911170rai,
2019111710,2019_11_NE_PHI,2019,11,2019-11-17,Sunday,16:25,NE,,PHI,,Home,,,58059,201911170phi,
2019111711,2019_11_CHI_LAR,2019,11,2019-11-17,Sunday,20:20,CHI,,LAR,,Home,,,58060,201911170ram,
2019111800,2019_11_KC_LAC,2019,11,2019-11-18,Monday,20:15,KC,,LAC,,Neutral,,,58061,201911180sdg,
2019112100,2019_12_IND_HOU,2019,12,2019-11-21,Thursday,20:20,IND,,HOU,,Home,,,58062,201911210htx,
2019112400,2019_12_TB_ATL,2019,12,2019-11-24,Sunday,13:00,TB,,ATL,,Home,,,58063,201911240atl,
2019112401,2019_12_DEN_BUF,2019,12,2019-11-24,Sunday,13:00,DEN,,BUF,,Home,,,58064,201911240buf,
2019112402,2019_12_NYG_CHI,2019,12,2019-11-24,Sunday,13:00,NYG,,CHI,,Home,,,58065,201911240chi,
2019112403,2019_12_PIT_CIN,2019,12,2019-11-24,Sunday,13:00,PIT,,CIN,,Home,,,58066,201911240cin,
2019112404,2019_12_MIA_CLE,2019,12,2019-11-24,Sunday,13:00,MIA,,CLE,,Home,,,58067,201911240cle,
2019112405,2019_12_CAR_NO,2019,12,2019-11-24,Sunday,13:00,CAR,,NO,,Home,,,58068,201911240nor,
2019112406,2019_12_OAK_NYJ,2019,12,2019-11-24,Sunday,13:00,OAK,,NYJ,,Home,,,58069,201911240nyj,
2019112407,2019_12_DET_WAS,2019,12,2019-11-24,Sunday,13:00,DET,,WAS,,Home,,,58070,201911240was,
2019112408,2019_12_JAX_TEN,2019,12,2019-11-24,Sunday,16:05,JAX,,TEN,,Home,,,58071,201911240oti,
2019112409,2019_12_DAL_NE,2019,12,2019-11-24,Sunday,16:25,DAL,,NE,,Home,,,58072,201911240nwe,
2019112410,2019_12_GB_SF,2019,12,2019-11-24,Sunday,16:25,GB,,SF,,Home,,,58073,201911240sfo,
2019112411,2019_12_SEA_PHI,2019,12,2019-11-24,Sunday,20:20,SEA,,PHI,,Home,,,58074,201911240phi,
2019112500,2019_12_BAL_LAR,2019,12,2019-11-25,Monday,20:15,BAL,,LAR,,Home,,,58075,201911250ram,
2019112800,2019_13_CHI_DET,2019,13,2019-11-28,Thursday,12:30,CHI,,DET,,Home,,,58076,201911280det,
2019112801,2019_13_BUF_DAL,2019,13,2019-11-28,Thursday,16:30,BUF,,DAL,,Home,,,58077,201911280dal,
2019112802,2019_13_NO_ATL,2019,13,2019-11-28,Thursday,20:20,NO,,ATL,,Home,,,58078,201911280atl,
2019120100,2019_13_SF_BAL,2019,13,2019-12-01,Sunday,13:00,SF,,BAL,,Home,,,58079,201912010rav,
2019120101,2019_13_WAS_CAR,2019,13,2019-12-01,Sunday,13:00,WAS,,CAR,,Home,,,58080,201912010car,
2019120102,2019_13_NYJ_CIN,2019,13,2019-12-01,Sunday,13:00,NYJ,,CIN,,Home,,,58081,201912010cin,
2019120103,2019_13_TEN_IND,2019,13,2019-12-01,Sunday,13:00,TEN,,IND,,Home,,,58082,201912010clt,
2019120104,2019_13_TB_JAX,2019,13,2019-12-01,Sunday,13:00,TB,,JAX,,Home,,,58083,201912010jax,
2019120105,2019_13_OAK_KC,2019,13,2019-12-01,Sunday,13:00,OAK,,KC,,Home,,,58084,201912010kan,
2019120106,2019_13_PHI_MIA,2019,13,2019-12-01,Sunday,13:00,PHI,,MIA,,Home,,,58085,201912010mia,
2019120107,2019_13_GB_NYG,2019,13,2019-12-01,Sunday,13:00,GB,,NYG,,Home,,,58086,201912010nyg,
2019120108,2019_13_LAR_ARI,2019,13,2019-12-01,Sunday,16:05,LAR,,ARI,,Home,,,58087,201912010crd,
2019120109,2019_13_LAC_DEN,2019,13,2019-12-01,Sunday,16:25,LAC,,DEN,,Home,,,58088,201912010den,
2019120110,2019_13_CLE_PIT,2019,13,2019-12-01,Sunday,16:25,CLE,,PIT,,Home,,,58089,201912010pit,
2019120111,2019_13_NE_HOU,2019,13,2019-12-01,Sunday,20:20,NE,,HOU,,Home,,,58090,201912010htx,
2019120200,2019_13_MIN_SEA,2019,13,2019-12-02,Monday,20:15,MIN,,SEA,,Home,,,58091,201912020sea,
2019120500,2019_14_DAL_CHI,2019,14,2019-12-05,Thursday,20:20,DAL,,CHI,,Home,,,58092,201912050chi,
2019120800,2019_14_CAR_ATL,2019,14,2019-12-08,Sunday,13:00,CAR,,ATL,,Home,,,58093,201912080atl,
2019120801,2019_14_BAL_BUF,2019,14,2019-12-08,Sunday,13:00,BAL,,BUF,,Home,,,58094,201912080buf,
2019120802,2019_14_CIN_CLE,2019,14,2019-12-08,Sunday,13:00,CIN,,CLE,,Home,,,58095,201912080cle,
2019120803,2019_14_WAS_GB,2019,14,2019-12-08,Sunday,13:00,WAS,,GB,,Home,,,58096,201912080gnb,
2019120804,2019_14_DEN_HOU,2019,14,2019-12-08,Sunday,13:00,DEN,,HOU,,Home,,,58097,201912080htx,
2019120805,2019_14_DET_MIN,2019,14,2019-12-08,Sunday,13:00,DET,,MIN,,Home,,,58098,201912080min,
2019120806,2019_14_SF_NO,2019,14,2019-12-08,Sunday,13:00,SF,,NO,,Home,,,58099,201912080nor,
2019120807,2019_14_MIA_NYJ,2019,14,2019-12-08,Sunday,13:00,MIA,,NYJ,,Home,,,58100,201912080nyj,
2019120808,2019_14_IND_TB,2019,14,2019-12-08,Sunday,13:00,IND,,TB,,Home,,,58101,201912080tam,
2019120809,2019_14_LAC_JAX,2019,14,2019-12-08,Sunday,16:05,LAC,,JAX,,Home,,,58102,201912080jax,
2019120810,2019_14_PIT_ARI,2019,14,2019-12-08,Sunday,16:25,PIT,,ARI,,Home,,,58103,201912080crd,
2019120811,2019_14_KC_NE,2019,14,2019-12-08,Sunday,16:25,KC,,NE,,Home,,,58104,201912080nwe,
2019120812,2019_14_TEN_OAK,2019,14,2019-12-08,Sunday,16:25,TEN,,OAK,,Home,,,58105,201912080rai,
2019120813,2019_14_SEA_LAR,2019,14,2019-12-08,Sunday,20:20,SEA,,LAR,,Home,,,58106,201912080ram,
2019120900,2019_14_NYG_PHI,2019,14,2019-12-09,Monday,20:15,NYG,,PHI,,Home,,,58107,201912090phi,
2019121200,2019_15_NYJ_BAL,2019,15,2019-12-12,Thursday,20:20,NYJ,,BAL,,Home,,,58108,201912120rav,
2019121500,2019_15_SEA_CAR,2019,15,2019-12-15,Sunday,13:00,SEA,,CAR,,Home,,,58109,201912150car,
2019121501,2019_15_NE_CIN,2019,15,2019-12-15,Sunday,13:00,NE,,CIN,,Home,,,58110,201912150cin,
2019121502,2019_15_TB_DET,2019,15,2019-12-15,Sunday,13:00,TB,,DET,,Home,,,58111,201912150det,
2019121503,2019_15_CHI_GB,2019,15,2019-12-15,Sunday,13:00,CHI,,GB,,Home,,,58112,201912150gnb,
2019121504,2019_15_DEN_KC,2019,15,2019-12-15,Sunday,13:00,DEN,,KC,,Home,,,58113,201912150kan,
2019121505,2019_15_MIA_NYG,2019,15,2019-12-15,Sunday,13:00,MIA,,NYG,,Home,,,58114,201912150nyg,
2019121506,2019_15_BUF_PIT,2019,15,2019-12-15,Sunday,13:00,BUF,,PIT,,Home,,,58115,201912150pit,
2019121507,2019_15_HOU_TEN,2019,15,2019-12-15,Sunday,13:00,HOU,,TEN,,Home,,,58116,201912150oti,
2019121508,2019_15_PHI_WAS,2019,15,2019-12-15,Sunday,13:00,PHI,,WAS,,Home,,,58117,201912150was,
2019121509,2019_15_CLE_ARI,2019,15,2019-12-15,Sunday,16:05,CLE,,ARI,,Home,,,58118,201912150crd,
2019121510,2019_15_JAX_OAK,2019,15,2019-12-15,Sunday,16:05,JAX,,OAK,,Home,,,58119,201912150rai,
2019121511,2019_15_LAR_DAL,2019,15,2019-12-15,Sunday,16:25,LAR,,DAL,,Home,,,58120,201912150dal,
2019121512,2019_15_ATL_SF,2019,15,2019-12-15,Sunday,16:25,ATL,,SF,,Home,,,58121,201912150sfo,
2019121513,2019_15_MIN_LAC,2019,15,2019-12-15,Sunday,20:20,MIN,,LAC,,Home,,,58122,201912150sdg,
2019121600,2019_15_IND_NO,2019,15,2019-12-16,Monday,20:15,IND,,NO,,Home,,,58123,201912160nor,
2019122200,2019_16_DET_DEN,2019,16,2019-12-22,Sunday,13:00,DET,,DEN,,Home,,,58124,201912220den,
2019122201,2019_16_OAK_LAC,2019,16,2019-12-22,Sunday,13:00,OAK,,LAC,,Home,,,58125,201912220sdg,
2019122202,2019_16_BUF_NE,2019,16,2019-12-22,Sunday,13:00,BUF,,NE,,Home,,,58126,201912220nwe,
2019122203,2019_16_LAR_SF,2019,16,2019-12-22,Sunday,13:00,LAR,,SF,,Home,,,58127,201912220sfo,
2019122204,2019_16_HOU_TB,2019,16,2019-12-22,Sunday,13:00,HOU,,TB,,Home,,,58128,201912220tam,
2019122205,2019_16_JAX_ATL,2019,16,2019-12-22,Sunday,13:00,JAX,,ATL,,Home,,,58129,201912220atl,
2019122206,2019_16_BAL_CLE,2019,16,2019-12-22,Sunday,13:00,BAL,,CLE,,Home,,,58130,201912220cle,
2019122207,2019_16_CAR_IND,2019,16,2019-12-22,Sunday,13:00,CAR,,IND,,Home,,,58131,201912220clt,
2019122208,2019_16_CIN_MIA,2019,16,2019-12-22,Sunday,13:00,CIN,,MIA,,Home,,,58132,201912220mia,
2019122209,2019_16_PIT_NYJ,2019,16,2019-12-22,Sunday,13:00,PIT,,NYJ,,Home,,,58133,201912220nyj,
2019122210,2019_16_NO_TEN,2019,16,2019-12-22,Sunday,13:00,NO,,TEN,,Home,,,58134,201912220oti,
2019122211,2019_16_NYG_WAS,2019,16,2019-12-22,Sunday,13:00,NYG,,WAS,,Home,,,58135,201912220was,
2019122212,2019_16_DAL_PHI,2019,16,2019-12-22,Sunday,16:25,DAL,,PHI,,Home,,,58136,201912220phi,
2019122213,2019_16_ARI_SEA,2019,16,2019-12-22,Sunday,16:25,ARI,,SEA,,Home,,,58137,201912220sea,
2019122214,2019_16_KC_CHI,2019,16,2019-12-22,Sunday,20:20,KC,,CHI,,Home,,,58138,201912220chi,
2019122300,2019_16_GB_MIN,2019,16,2019-12-23,Monday,20:15,GB,,MIN,,Home,,,58139,201912230min,
2019122900,2019_17_PIT_BAL,2019,17,2019-12-29,Sunday,13:00,PIT,,BAL,,Home,,,58140,201912290rav,
2019122901,2019_17_NYJ_BUF,2019,17,2019-12-29,Sunday,13:00,NYJ,,BUF,,Home,,,58141,201912290buf,
2019122902,2019_17_NO_CAR,2019,17,2019-12-29,Sunday,13:00,NO,,CAR,,Home,,,58142,201912290car,
2019122903,2019_17_CLE_CIN,2019,17,2019-12-29,Sunday,13:00,CLE,,CIN,,Home,,,58143,201912290cin,
2019122904,2019_17_WAS_DAL,2019,17,2019-12-29,Sunday,13:00,WAS,,DAL,,Home,,,58144,201912290dal,
2019122905,2019_17_GB_DET,2019,17,2019-12-29,Sunday,13:00,GB,,DET,,Home,,,58145,201912290det,
2019122906,2019_17_TEN_HOU,2019,17,2019-12-29,Sunday,13:00,TEN,,HOU,,Home,,,58146,201912290htx,
2019122907,2019_17_IND_JAX,2019,17,2019-12-29,Sunday,13:00,IND,,JAX,,Home,,,58147,201912290jax,
2019122908,2019_17_LAC_KC,2019,17,2019-12-29,Sunday,13:00,LAC,,KC,,Home,,,58148,201912290kan,
2019122909,2019_17_CHI_MIN,2019,17,2019-12-29,Sunday,13:00,CHI,,MIN,,Home,,,58149,201912290min,
2019122910,2019_17_MIA_NE,2019,17,2019-12-29,Sunday,13:00,MIA,,NE,,Home,,,58150,201912290nwe,
2019122911,2019_17_PHI_NYG,2019,17,2019-12-29,Sunday,13:00,PHI,,NYG,,Home,,,58151,201912290nyg,
2019122912,2019_17_ATL_TB,2019,17,2019-12-29,Sunday,13:00,ATL,,TB,,Home,,,58152,201912290tam,
2019122913,2019_17_OAK_DEN,2019,17,2019-12-29,Sunday,16:25,OAK,,DEN,,Home,,,58153,201912290den,
2019122914,2019_17_ARI_LAR,2019,17,2019-12-29,Sunday,16:25,ARI,,LAR,,Home,,,58154,201912290ram,
2019122915,2019_17_SF_SEA,2019,17,2019-12-29,Sunday,16:25,SF,,SEA,,Home,,,58155,201912290sea,
