game_id,season,week,gameday,weekday,gametime,away_team,away_score,home_team,home_score,location,result,total
2006090700,2006,1,2006-09-07,Thursday,20:30,MIA,17,PIT,28,Home,11,45
2006091000,2006,1,2006-09-10,Sunday,13:00,ATL,20,CAR,6,Home,-14,26
2006091001,2006,1,2006-09-10,Sunday,13:00,NO,19,CLE,14,Home,-5,33
2006091002,2006,1,2006-09-10,Sunday,13:00,SEA,9,DET,6,Home,-3,15
2006091003,2006,1,2006-09-10,Sunday,13:00,PHI,24,HOU,10,Home,-14,34
2006091004,2006,1,2006-09-10,Sunday,13:00,CIN,23,KC,10,Home,-13,33
2006091005,2006,1,2006-09-10,Sunday,13:00,BUF,17,NE,19,Home,2,36
2006091006,2006,1,2006-09-10,Sunday,13:00,DEN,10,STL,18,Home,8,28
2006091007,2006,1,2006-09-10,Sunday,13:00,BAL,27,TB,0,Home,-27,27
2006091008,2006,1,2006-09-10,Sunday,13:00,NYJ,23,TEN,16,Home,-7,39
2006091009,2006,1,2006-09-10,Sunday,16:15,SF,27,ARI,34,Home,7,61
2006091010,2006,1,2006-09-10,Sunday,16:15,CHI,26,GB,0,Home,-26,26
2006091011,2006,1,2006-09-10,Sunday,16:15,DAL,17,JAX,24,Home,7,41
2006091012,2006,1,2006-09-10,Sunday,20:15,IND,26,NYG,21,Home,-5,47
2006091100,2006,1,2006-09-11,Monday,19:00,MIN,19,WAS,16,Home,-3,35
2006091101,2006,1,2006-09-11,Monday,22:15,SD,27,OAK,0,Home,-27,27
2006091700,2006,2,2006-09-17,Sunday,13:00,TB,3,ATL,14,Home,11,17
2006091701,2006,2,2006-09-17,Sunday,13:00,OAK,6,BAL,28,Home,22,34
2006091702,2006,2,2006-09-17,Sunday,13:00,DET,7,CHI,34,Home,27,41
2006091703,2006,2,2006-09-17,Sunday,13:00,CLE,17,CIN,34,Home,17,51
2006091704,2006,2,2006-09-17,Sunday,13:00,NO,34,GB,27,Home,-7,61
2006091705,2006,2,2006-09-17,Sunday,13:00,HOU,24,IND,43,Home,19,67
2006091706,2006,2,2006-09-17,Sunday,13:00,BUF,16,MIA,6,Home,-10,22
2006091707,2006,2,2006-09-17,Sunday,13:00,CAR,13,MIN,16,Home,3,29
2006091708,2006,2,2006-09-17,Sunday,13:00,NYG,30,PHI,24,Home,-6,54
2006091709,2006,2,2006-09-17,Sunday,16:05,STL,13,SF,20,Home,7,33
2006091710,2006,2,2006-09-17,Sunday,16:05,ARI,10,SEA,21,Home,11,31
2006091711,2006,2,2006-09-17,Sunday,16:15,KC,6,DEN,9,Home,3,15
2006091712,2006,2,2006-09-17,Sunday,16:15,NE,24,NYJ,17,Home,-7,41
2006091713,2006,2,2006-09-17,Sunday,16:15,TEN,7,SD,40,Home,33,47
2006091714,2006,2,2006-09-17,Sunday,20:15,WAS,10,DAL,27,Home,17,37
2006091800,2006,2,2006-09-18,Monday,20:30,PIT,0,JAX,9,Home,9,9
2006092400,2006,3,2006-09-24,Sunday,13:00,NYJ,28,BUF,20,Home,-8,48
2006092401,2006,3,2006-09-24,Sunday,13:00,GB,31,DET,24,Home,-7,55
2006092402,2006,3,2006-09-24,Sunday,13:00,WAS,31,HOU,15,Home,-16,46
2006092403,2006,3,2006-09-24,Sunday,13:00,JAX,14,IND,21,Home,7,35
2006092404,2006,3,2006-09-24,Sunday,13:00,TEN,10,MIA,13,Home,3,23
2006092405,2006,3,2006-09-24,Sunday,13:00,CHI,19,MIN,16,Home,-3,35
2006092406,2006,3,2006-09-24,Sunday,13:00,CIN,28,PIT,20,Home,-8,48
2006092407,2006,3,2006-09-24,Sunday,13:00,CAR,26,TB,24,Home,-2,50
2006092408,2006,3,2006-09-24,Sunday,16:05,BAL,15,CLE,14,Home,-1,29
2006092409,2006,3,2006-09-24,Sunday,16:15,STL,16,ARI,14,Home,-2,30
2006092410,2006,3,2006-09-24,Sunday,16:15,PHI,38,SF,24,Home,-14,62
2006092411,2006,3,2006-09-24,Sunday,16:15,NYG,30,SEA,42,Home,12,72
2006092412,2006,3,2006-09-24,Sunday,20:15,DEN,17,NE,7,Home,-10,24
2006092500,2006,3,2006-09-25,Monday,20:30,ATL,3,NO,23,Home,20,26
2006100100,2006,4,2006-10-01,Sunday,13:00,ARI,10,ATL,32,Home,22,42
2006100101,2006,4,2006-10-01,Sunday,13:00,SD,13,BAL,16,Home,3,29
2006100102,2006,4,2006-10-01,Sunday,13:00,MIN,12,BUF,17,Home,5,29
2006100103,2006,4,2006-10-01,Sunday,13:00,NO,18,CAR,21,Home,3,39
2006100104,2006,4,2006-10-01,Sunday,13:00,MIA,15,HOU,17,Home,2,32
2006100105,2006,4,2006-10-01,Sunday,13:00,SF,0,KC,41,Home,41,41
2006100106,2006,4,2006-10-01,Sunday,13:00,IND,31,NYJ,28,Home,-3,59
2006100107,2006,4,2006-10-01,Sunday,13:00,DAL,45,TEN,14,Home,-31,59
2006100108,2006,4,2006-10-01,Sunday,16:05,DET,34,STL,41,Home,7,75
2006100109,2006,4,2006-10-01,Sunday,16:15,NE,38,CIN,13,Home,-25,51
2006100110,2006,4,2006-10-01,Sunday,16:15,CLE,24,OAK,21,Home,-3,45
2006100111,2006,4,2006-10-01,Sunday,16:15,JAX,30,WAS,36,Home,6,66
2006100112,2006,4,2006-10-01,Sunday,20:15,SEA,6,CHI,37,Home,31,43
2006100200,2006,4,2006-10-02,Monday,20:30,GB,9,PHI,31,Home,22,40
2006100800,2006,5,2006-10-08,Sunday,13:00,CLE,12,CAR,20,Home,8,32
2006100801,2006,5,2006-10-08,Sunday,13:00,BUF,7,CHI,40,Home,33,47
2006100802,2006,5,2006-10-08,Sunday,13:00,STL,24,GB,21,Home,-3,45
2006100803,2006,5,2006-10-08,Sunday,13:00,TEN,13,IND,14,Home,1,27
2006100804,2006,5,2006-10-08,Sunday,13:00,DET,17,MIN,26,Home,9,43
2006100805,2006,5,2006-10-08,Sunday,13:00,MIA,10,NE,20,Home,10,30
2006100806,2006,5,2006-10-08,Sunday,13:00,TB,21,NO,24,Home,3,45
2006100807,2006,5,2006-10-08,Sunday,13:00,WAS,3,NYG,19,Home,16,22
2006100808,2006,5,2006-10-08,Sunday,16:05,KC,23,ARI,20,Home,-3,43
2006100809,2006,5,2006-10-08,Sunday,16:05,NYJ,0,JAX,41,Home,41,41
2006100810,2006,5,2006-10-08,Sunday,16:05,OAK,20,SF,34,Home,14,54
2006100811,2006,5,2006-10-08,Sunday,16:15,DAL,24,PHI,38,Home,14,62
2006100812,2006,5,2006-10-08,Sunday,20:15,PIT,13,SD,23,Home,10,36
2006100900,2006,5,2006-10-09,Monday,20:30,BAL,3,DEN,13,Home,10,16
2006101500,2006,6,2006-10-15,Sunday,13:00,NYG,27,ATL,14,Home,-13,41
2006101501,2006,6,2006-10-15,Sunday,13:00,CAR,23,BAL,21,Home,-2,44
2006101502,2006,6,2006-10-15,Sunday,13:00,HOU,6,DAL,34,Home,28,40
2006101503,2006,6,2006-10-15,Sunday,13:00,BUF,17,DET,20,Home,3,37
2006101504,2006,6,2006-10-15,Sunday,13:00,PHI,24,NO,27,Home,3,51
2006101505,2006,6,2006-10-15,Sunday,13:00,SEA,30,STL,28,Home,-2,58
2006101506,2006,6,2006-10-15,Sunday,13:00,CIN,13,TB,14,Home,1,27
2006101507,2006,6,2006-10-15,Sunday,13:00,TEN,25,WAS,22,Home,-3,47
2006101508,2006,6,2006-10-15,Sunday,16:15,MIA,17,NYJ,20,Home,3,37
2006101509,2006,6,2006-10-15,Sunday,16:15,KC,7,PIT,45,Home,38,52
2006101510,2006,6,2006-10-15,Sunday,16:15,SD,48,SF,19,Home,-29,67
2006101511,2006,6,2006-10-15,Sunday,20:15,OAK,3,DEN,13,Home,10,16
2006101600,2006,6,2006-10-16,Monday,20:30,CHI,24,ARI,23,Home,-1,47
2006102200,2006,7,2006-10-22,Sunday,13:00,PIT,38,ATL,41,Home,3,79
2006102201,2006,7,2006-10-22,Sunday,13:00,NE,28,BUF,6,Home,-22,34
2006102202,2006,7,2006-10-22,Sunday,13:00,CAR,14,CIN,17,Home,3,31
2006102203,2006,7,2006-10-22,Sunday,13:00,JAX,7,HOU,27,Home,20,34
2006102204,2006,7,2006-10-22,Sunday,13:00,SD,27,KC,30,Home,3,57
2006102205,2006,7,2006-10-22,Sunday,13:00,GB,34,MIA,24,Home,-10,58
2006102206,2006,7,2006-10-22,Sunday,13:00,DET,24,NYJ,31,Home,7,55
2006102207,2006,7,2006-10-22,Sunday,13:00,PHI,21,TB,23,Home,2,44
2006102208,2006,7,2006-10-22,Sunday,16:05,DEN,17,CLE,7,Home,-10,24
2006102209,2006,7,2006-10-22,Sunday,16:15,WAS,22,IND,36,Home,14,58
2006102210,2006,7,2006-10-22,Sunday,16:15,ARI,9,OAK,22,Home,13,31
2006102211,2006,7,2006-10-22,Sunday,16:15,MIN,31,SEA,13,Home,-18,44
2006102300,2006,7,2006-10-23,Monday,20:30,NYG,36,DAL,22,Home,-14,58
2006102900,2006,8,2006-10-29,Sunday,13:00,SF,10,CHI,41,Home,31,51
2006102901,2006,8,2006-10-29,Sunday,13:00,ATL,29,CIN,27,Home,-2,56
2006102902,2006,8,2006-10-29,Sunday,13:00,ARI,14,GB,31,Home,17,45
2006102903,2006,8,2006-10-29,Sunday,13:00,SEA,28,KC,35,Home,7,63
2006102904,2006,8,2006-10-29,Sunday,13:00,BAL,35,NO,22,Home,-13,57
2006102905,2006,8,2006-10-29,Sunday,13:00,TB,3,NYG,17,Home,14,20
2006102906,2006,8,2006-10-29,Sunday,13:00,JAX,13,PHI,6,Home,-7,19
2006102907,2006,8,2006-10-29,Sunday,13:00,HOU,22,TEN,28,Home,6,50
2006102908,2006,8,2006-10-29,Sunday,16:05,STL,24,SD,38,Home,14,62
2006102909,2006,8,2006-10-29,Sunday,16:15,NYJ,13,CLE,20,Home,7,33
2006102910,2006,8,2006-10-29,Sunday,16:15,IND,34,DEN,31,Home,-3,65
2006102911,2006,8,2006-10-29,Sunday,16:15,PIT,13,OAK,20,Home,7,33
2006102912,2006,8,2006-10-29,Sunday,20:15,DAL,35,CAR,14,Home,-21,49
2006103000,2006,8,2006-10-30,Monday,20:30,NE,31,MIN,7,Home,-24,38
2006110500,2006,9,2006-11-05,Sunday,13:00,CIN,20,BAL,26,Home,6,46
2006110501,2006,9,2006-11-05,Sunday,13:00,GB,10,BUF,24,Home,14,34
2006110502,2006,9,2006-11-05,Sunday,13:00,MIA,31,CHI,13,Home,-18,44
2006110503,2006,9,2006-11-05,Sunday,13:00,ATL,14,DET,30,Home,16,44
2006110504,2006,9,2006-11-05,Sunday,13:00,TEN,7,JAX,37,Home,30,44
2006110505,2006,9,2006-11-05,Sunday,13:00,HOU,10,NYG,14,Home,4,24
2006110506,2006,9,2006-11-05,Sunday,13:00,KC,31,STL,17,Home,-14,48
2006110507,2006,9,2006-11-05,Sunday,13:00,NO,31,TB,14,Home,-17,45
2006110508,2006,9,2006-11-05,Sunday,13:00,DAL,19,WAS,22,Home,3,41
2006110509,2006,9,2006-11-05,Sunday,16:05,MIN,3,SF,9,Home,6,12
2006110510,2006,9,2006-11-05,Sunday,16:15,DEN,31,PIT,20,Home,-11,51
2006110511,2006,9,2006-11-05,Sunday,16:15,CLE,25,SD,32,Home,7,57
2006110512,2006,9,2006-11-05,Sunday,20:15,IND,27,NE,20,Home,-7,47
2006110600,2006,9,2006-11-06,Monday,20:30,OAK,0,SEA,16,Home,16,16
2006111200,2006,10,2006-11-12,Sunday,13:00,CLE,17,ATL,13,Home,-4,30
2006111201,2006,10,2006-11-12,Sunday,13:00,SD,49,CIN,41,Home,-8,90
2006111202,2006,10,2006-11-12,Sunday,13:00,SF,19,DET,13,Home,-6,32
2006111203,2006,10,2006-11-12,Sunday,13:00,BUF,16,IND,17,Home,1,33
2006111204,2006,10,2006-11-12,Sunday,13:00,HOU,13,JAX,10,Home,-3,23
2006111205,2006,10,2006-11-12,Sunday,13:00,KC,10,MIA,13,Home,3,23
2006111206,2006,10,2006-11-12,Sunday,13:00,GB,23,MIN,17,Home,-6,40
2006111207,2006,10,2006-11-12,Sunday,13:00,NYJ,17,NE,14,Home,-3,31
2006111208,2006,10,2006-11-12,Sunday,20:15,CHI,38,NYG,20,Home,-18,58
2006111209,2006,10,2006-11-12,Sunday,13:00,WAS,3,PHI,27,Home,24,30
2006111210,2006,10,2006-11-12,Sunday,16:15,NO,31,PIT,38,Home,7,69
2006111211,2006,10,2006-11-12,Sunday,13:00,BAL,27,TEN,26,Home,-1,53
2006111212,2006,10,2006-11-12,Sunday,16:05,DEN,17,OAK,13,Home,-4,30
2006111213,2006,10,2006-11-12,Sunday,16:15,DAL,27,ARI,10,Home,-17,37
2006111214,2006,10,2006-11-12,Sunday,16:15,STL,22,SEA,24,Home,2,46
2006111300,2006,10,2006-11-13,Monday,20:30,TB,10,CAR,24,Home,14,34
2006111900,2006,11,2006-11-19,Sunday,13:00,ATL,10,BAL,24,Home,14,34
2006111901,2006,11,2006-11-19,Sunday,13:00,STL,0,CAR,15,Home,15,15
2006111902,2006,11,2006-11-19,Sunday,13:00,PIT,24,CLE,20,Home,-4,44
2006111903,2006,11,2006-11-19,Sunday,16:15,IND,14,DAL,21,Home,7,35
2006111904,2006,11,2006-11-19,Sunday,13:00,NE,35,GB,0,Home,-35,35
2006111905,2006,11,2006-11-19,Sunday,13:00,BUF,24,HOU,21,Home,-3,45
2006111906,2006,11,2006-11-19,Sunday,13:00,OAK,13,KC,17,Home,4,30
2006111907,2006,11,2006-11-19,Sunday,13:00,MIN,20,MIA,24,Home,4,44
2006111908,2006,11,2006-11-19,Sunday,13:00,CIN,31,NO,16,Home,-15,47
2006111909,2006,11,2006-11-19,Sunday,13:00,CHI,10,NYJ,0,Home,-10,10
2006111910,2006,11,2006-11-19,Sunday,13:00,TEN,31,PHI,13,Home,-18,44
2006111911,2006,11,2006-11-19,Sunday,13:00,WAS,17,TB,20,Home,3,37
2006111912,2006,11,2006-11-19,Sunday,16:05,DET,10,ARI,17,Home,7,27
2006111913,2006,11,2006-11-19,Sunday,16:05,SEA,14,SF,20,Home,6,34
2006111914,2006,11,2006-11-19,Sunday,20:15,SD,35,DEN,27,Home,-8,62
2006112000,2006,11,2006-11-20,Monday,20:30,NYG,10,JAX,26,Home,16,36
2006112300,2006,12,2006-11-23,Thursday,12:30,MIA,27,DET,10,Home,-17,37
2006112301,2006,12,2006-11-23,Thursday,16:25,TB,10,DAL,38,Home,28,48
2006112302,2006,12,2006-11-23,Thursday,20:00,DEN,10,KC,19,Home,9,29
2006112600,2006,12,2006-11-26,Sunday,13:00,NO,31,ATL,13,Home,-18,44
2006112601,2006,12,2006-11-26,Sunday,13:00,PIT,0,BAL,27,Home,27,27
2006112602,2006,12,2006-11-26,Sunday,13:00,JAX,24,BUF,27,Home,3,51
2006112603,2006,12,2006-11-26,Sunday,13:00,CIN,30,CLE,0,Home,-30,30
2006112604,2006,12,2006-11-26,Sunday,20:15,PHI,21,IND,45,Home,24,66
2006112605,2006,12,2006-11-26,Sunday,13:00,ARI,26,MIN,31,Home,5,57
2006112606,2006,12,2006-11-26,Sunday,16:15,CHI,13,NE,17,Home,4,30
2006112607,2006,12,2006-11-26,Sunday,13:00,HOU,11,NYJ,26,Home,15,37
2006112608,2006,12,2006-11-26,Sunday,13:00,SF,17,STL,20,Home,3,37
2006112609,2006,12,2006-11-26,Sunday,16:15,NYG,21,TEN,24,Home,3,45
2006112610,2006,12,2006-11-26,Sunday,13:00,CAR,13,WAS,17,Home,4,30
2006112611,2006,12,2006-11-26,Sunday,16:05,OAK,14,SD,21,Home,7,35
2006112700,2006,12,2006-11-27,Monday,20:30,GB,24,SEA,34,Home,10,58
2006113000,2006,13,2006-11-30,Thursday,20:00,BAL,7,CIN,13,Home,6,20
2006120300,2006,13,2006-12-03,Sunday,13:00,KC,28,CLE,31,Home,3,59
2006120301,2006,13,2006-12-03,Sunday,13:00,NYJ,38,GB,10,Home,-28,48
2006120302,2006,13,2006-12-03,Sunday,16:05,JAX,24,MIA,10,Home,-14,34
2006120303,2006,13,2006-12-03,Sunday,13:00,DET,21,NE,28,Home,7,49
2006120304,2006,13,2006-12-03,Sunday,13:00,SF,10,NO,34,Home,24,44
2006120305,2006,13,2006-12-03,Sunday,16:15,DAL,23,NYG,20,Home,-3,43
2006120306,2006,13,2006-12-03,Sunday,16:15,TB,3,PIT,20,Home,17,23
2006120307,2006,13,2006-12-03,Sunday,13:00,ARI,34,STL,20,Home,-14,54
2006120308,2006,13,2006-12-03,Sunday,13:00,IND,17,TEN,20,Home,3,37
2006120309,2006,13,2006-12-03,Sunday,13:00,ATL,24,WAS,14,Home,-10,38
2006120310,2006,13,2006-12-03,Sunday,16:05,HOU,23,OAK,14,Home,-9,37
2006120311,2006,13,2006-12-03,Sunday,20:15,SEA,23,DEN,20,Home,-3,43
2006120312,2006,13,2006-12-03,Sunday,13:00,SD,24,BUF,21,Home,-3,45
2006120313,2006,13,2006-12-03,Sunday,13:00,MIN,13,CHI,23,Home,10,36
2006120400,2006,13,2006-12-04,Monday,20:30,CAR,24,PHI,27,Home,3,51
2006120700,2006,14,2006-12-07,Thursday,20:00,CLE,7,PIT,27,Home,20,34
2006121000,2006,14,2006-12-10,Sunday,13:00,NYG,27,CAR,13,Home,-14,40
2006121001,2006,14,2006-12-10,Sunday,13:00,OAK,10,CIN,27,Home,17,37
2006121002,2006,14,2006-12-10,Sunday,20:15,NO,42,DAL,17,Home,-25,59
2006121003,2006,14,2006-12-10,Sunday,13:00,MIN,30,DET,20,Home,-10,50
2006121004,2006,14,2006-12-10,Sunday,13:00,TEN,26,HOU,20,Home,-6,46
2006121005,2006,14,2006-12-10,Sunday,13:00,IND,17,JAX,44,Home,27,61
2006121006,2006,14,2006-12-10,Sunday,13:00,BAL,20,KC,10,Home,-10,30
2006121007,2006,14,2006-12-10,Sunday,13:00,NE,0,MIA,21,Home,21,21
2006121008,2006,14,2006-12-10,Sunday,16:15,BUF,31,NYJ,13,Home,-18,44
2006121009,2006,14,2006-12-10,Sunday,13:00,ATL,17,TB,6,Home,-11,23
2006121010,2006,14,2006-12-10,Sunday,13:00,PHI,21,WAS,19,Home,-2,40
2006121011,2006,14,2006-12-10,Sunday,16:05,SEA,21,ARI,27,Home,6,48
2006121012,2006,14,2006-12-10,Sunday,16:05,GB,30,SF,19,Home,-11,49
2006121013,2006,14,2006-12-10,Sunday,16:15,DEN,20,SD,48,Home,28,68
2006121100,2006,14,2006-12-11,Monday,20:30,CHI,42,STL,27,Home,-15,69
2006121400,2006,15,2006-12-14,Thursday,20:00,SF,24,SEA,14,Home,-10,38
2006121600,2006,15,2006-12-16,Saturday,20:00,DAL,38,ATL,28,Home,-10,66
2006121700,2006,15,2006-12-17,Sunday,13:00,CLE,17,BAL,27,Home,10,44
2006121701,2006,15,2006-12-17,Sunday,13:00,MIA,0,BUF,21,Home,21,21
2006121702,2006,15,2006-12-17,Sunday,13:00,PIT,37,CAR,3,Home,-34,40
2006121703,2006,15,2006-12-17,Sunday,13:00,TB,31,CHI,34,Home,3,65
2006121704,2006,15,2006-12-17,Sunday,13:00,DET,9,GB,17,Home,8,26
2006121705,2006,15,2006-12-17,Sunday,13:00,NYJ,26,MIN,13,Home,-13,39
2006121706,2006,15,2006-12-17,Sunday,13:00,HOU,7,NE,40,Home,33,47
2006121707,2006,15,2006-12-17,Sunday,16:15,PHI,36,NYG,22,Home,-14,58
2006121708,2006,15,2006-12-17,Sunday,13:00,JAX,17,TEN,24,Home,7,41
2006121709,2006,15,2006-12-17,Sunday,16:05,DEN,37,ARI,20,Home,-17,57
2006121710,2006,15,2006-12-17,Sunday,20:15,KC,9,SD,20,Home,11,29
2006121711,2006,15,2006-12-17,Sunday,16:15,STL,20,OAK,0,Home,-20,20
2006121712,2006,15,2006-12-17,Sunday,13:00,WAS,16,NO,10,Home,-6,26
2006121800,2006,15,2006-12-18,Monday,20:30,CIN,16,IND,34,Home,18,50
2006122100,2006,16,2006-12-21,Thursday,20:00,MIN,7,GB,9,Home,2,16
2006122300,2006,16,2006-12-23,Saturday,20:00,KC,20,OAK,9,Home,-11,29
2006122400,2006,16,2006-12-24,Sunday,13:00,CAR,10,ATL,3,Home,-7,13
2006122401,2006,16,2006-12-24,Sunday,13:00,TEN,30,BUF,29,Home,-1,59
2006122402,2006,16,2006-12-24,Sunday,13:00,TB,22,CLE,7,Home,-15,29
2006122403,2006,16,2006-12-24,Sunday,13:00,CHI,26,DET,21,Home,-5,47
2006122404,2006,16,2006-12-24,Sunday,13:00,IND,24,HOU,27,Home,3,51
2006122405,2006,16,2006-12-24,Sunday,13:00,NE,24,JAX,21,Home,-3,45
2006122406,2006,16,2006-12-24,Sunday,13:00,NO,30,NYG,7,Home,-23,37
2006122407,2006,16,2006-12-24,Sunday,13:00,BAL,31,PIT,7,Home,-24,38
2006122408,2006,16,2006-12-24,Sunday,13:00,WAS,31,STL,37,Home,6,68
2006122409,2006,16,2006-12-24,Sunday,16:05,ARI,26,SF,20,Home,-6,46
2006122410,2006,16,2006-12-24,Sunday,16:15,CIN,23,DEN,24,Home,1,47
2006122411,2006,16,2006-12-24,Sunday,16:15,SD,20,SEA,17,Home,-3,37
2006122500,2006,16,2006-12-25,Monday,17:00,PHI,23,DAL,7,Home,-16,30
2006122501,2006,16,2006-12-25,Monday,20:30,NYJ,13,MIA,10,Home,-3,23
2006123000,2006,17,2006-12-30,Saturday,20:00,NYG,34,WAS,28,Home,-6,62
2006123100,2006,17,2006-12-31,Sunday,16:15,BUF,7,BAL,19,Home,12,26
2006123101,2006,17,2006-12-31,Sunday,20:15,GB,26,CHI,7,Home,-19,33
2006123102,2006,17,2006-12-31,Sunday,13:00,PIT,23,CIN,17,Home,-6,40
2006123103,2006,17,2006-12-31,Sunday,13:00,DET,39,DAL,31,Home,-8,70
2006123104,2006,17,2006-12-31,Sunday,13:00,CLE,6,HOU,14,Home,8,20
2006123105,2006,17,2006-12-31,Sunday,16:15,MIA,22,IND,27,Home,5,49
2006123106,2006,17,2006-12-31,Sunday,13:00,JAX,30,KC,35,Home,5,65
2006123107,2006,17,2006-12-31,Sunday,13:00,STL,41,MIN,21,Home,-20,62
2006123108,2006,17,2006-12-31,Sunday,13:00,CAR,31,NO,21,Home,-10,52
2006123109,2006,17,2006-12-31,Sunday,13:00,OAK,3,NYJ,23,Home,20,26
2006123110,2006,17,2006-12-31,Sunday,16:15,ATL,17,PHI,24,Home,7,41
2006123111,2006,17,2006-12-31,Sunday,13:00,SEA,23,TB,7,Home,-16,30
2006123112,2006,17,2006-12-31,Sunday,13:00,NE,40,TEN,23,Home,-17,63
2006123113,2006,17,2006-12-31,Sunday,16:15,SF,26,DEN,23,Home,-3,49
2006123114,2006,17,2006-12-31,Sunday,16:15,ARI,20,SD,27,Home,7,47
2007010600,2006,18,2007-01-06,Saturday,20:00,DAL,20,SEA,21,Home,1,41
2007010601,2006,18,2007-01-06,Saturday,16:30,KC,8,IND,23,Home,15,31
2007010700,2006,18,2007-01-07,Sunday,16:35,NYG,20,PHI,23,Home,3,43
2007010701,2006,18,2007-01-07,Sunday,13:00,NYJ,16,NE,37,Home,21,53
2007011300,2006,19,2007-01-13,Saturday,20:00,PHI,24,NO,27,Home,3,51
2007011301,2006,19,2007-01-13,Saturday,16:30,IND,15,BAL,6,Home,-9,21
2007011400,2006,19,2007-01-14,Sunday,13:00,SEA,24,CHI,27,Home,3,51
2007011401,2006,19,2007-01-14,Sunday,16:30,NE,24,SD,21,Home,-3,45
2007012100,2006,20,2007-01-21,Sunday,15:00,NO,14,CHI,39,Home,25,53
2007012101,2006,20,2007-01-21,Sunday,18:30,NE,34,IND,38,Home,4,72
2007020400,2006,21,2007-02-04,Sunday,18:25,IND,29,CHI,17,Neutral,-12,46
2007090600,2007,1,2007-09-06,Thursday,20:30,NO,10,IND,41,Home,31,51
2007090900,2007,1,2007-09-09,Sunday,13:00,DEN,15,BUF,14,Home,-1,29
2007090901,2007,1,2007-09-09,Sunday,13:00,PIT,34,CLE,7,Home,-27,41
2007090902,2007,1,2007-09-09,Sunday,13:00,PHI,13,GB,16,Home,3,29
2007090903,2007,1,2007-09-09,Sunday,13:00,KC,3,HOU,20,Home,17,23
2007090904,2007,1,2007-09-09,Sunday,13:00,ATL,3,MIN,24,Home,21,27
2007090905,2007,1,2007-09-09,Sunday,13:00,NE,38,NYJ,14,Home,-24,52
2007090906,2007,1,2007-09-09,Sunday,13:00,CAR,27,STL,13,Home,-14,40
2007090907,2007,1,2007-09-09,Sunday,13:00,MIA,13,WAS,16,Home,3,29
2007090908,2007,1,2007-09-09,Sunday,16:15,DET,36,OAK,21,Home,-15,57
2007090909,2007,1,2007-09-09,Sunday,16:15,CHI,3,SD,14,Home,11,17
2007090910,2007,1,2007-09-09,Sunday,16:15,TB,6,SEA,20,Home,14,26
2007090911,2007,1,2007-09-09,Sunday,20:25,NYG,35,DAL,45,Home,10,80
2007090912,2007,1,2007-09-09,Sunday,13:00,TEN,13,JAX,10,Home,-3,23
2007091000,2007,1,2007-09-10,Monday,19:10,BAL,20,CIN,27,Home,7,47
2007091001,2007,1,2007-09-10,Monday,22:25,ARI,17,SF,20,Home,3,37
2007091600,2007,2,2007-09-16,Sunday,13:00,HOU,34,CAR,21,Home,-13,55
2007091601,2007,2,2007-09-16,Sunday,13:00,CIN,45,CLE,51,Home,6,96
2007091602,2007,2,2007-09-16,Sunday,13:00,ATL,7,JAX,13,Home,6,20
2007091603,2007,2,2007-09-16,Sunday,13:00,GB,35,NYG,13,Home,-22,48
2007091604,2007,2,2007-09-16,Sunday,13:00,BUF,3,PIT,26,Home,23,29
2007091605,2007,2,2007-09-16,Sunday,13:00,SF,17,STL,16,Home,-1,33
2007091606,2007,2,2007-09-16,Sunday,13:00,NO,14,TB,31,Home,17,45
2007091607,2007,2,2007-09-16,Sunday,13:00,IND,22,TEN,20,Home,-2,42
2007091608,2007,2,2007-09-16,Sunday,16:05,SEA,20,ARI,23,Home,3,43
2007091609,2007,2,2007-09-16,Sunday,16:05,MIN,17,DET,20,Home,3,37
2007091610,2007,2,2007-09-16,Sunday,16:05,DAL,37,MIA,20,Home,-17,57
2007091611,2007,2,2007-09-16,Sunday,16:15,NYJ,13,BAL,20,Home,7,33
2007091612,2007,2,2007-09-16,Sunday,16:15,KC,10,CHI,20,Home,10,30
2007091613,2007,2,2007-09-16,Sunday,16:15,OAK,20,DEN,23,Home,3,43
2007091614,2007,2,2007-09-16,Sunday,20:25,SD,14,NE,38,Home,24,52
2007091700,2007,2,2007-09-17,Monday,20:40,WAS,20,PHI,12,Home,-8,32
2007092300,2007,3,2007-09-23,Sunday,13:00,ARI,23,BAL,26,Home,3,49
2007092301,2007,3,2007-09-23,Sunday,13:00,SD,24,GB,31,Home,7,55
2007092302,2007,3,2007-09-23,Sunday,13:00,IND,30,HOU,24,Home,-6,54
2007092303,2007,3,2007-09-23,Sunday,13:00,MIN,10,KC,13,Home,3,23
2007092304,2007,3,2007-09-23,Sunday,13:00,BUF,7,NE,38,Home,31,45
2007092305,2007,3,2007-09-23,Sunday,13:00,MIA,28,NYJ,31,Home,3,59
2007092306,2007,3,2007-09-23,Sunday,13:00,DET,21,PHI,56,Home,35,77
2007092307,2007,3,2007-09-23,Sunday,13:00,SF,16,PIT,37,Home,21,53
2007092308,2007,3,2007-09-23,Sunday,13:00,STL,3,TB,24,Home,21,27
2007092309,2007,3,2007-09-23,Sunday,16:05,JAX,23,DEN,14,Home,-9,37
2007092310,2007,3,2007-09-23,Sunday,16:05,CLE,24,OAK,26,Home,2,50
2007092311,2007,3,2007-09-23,Sunday,16:05,CIN,21,SEA,24,Home,3,45
2007092312,2007,3,2007-09-23,Sunday,16:15,CAR,27,ATL,20,Home,-7,47
2007092313,2007,3,2007-09-23,Sunday,16:15,NYG,24,WAS,17,Home,-7,41
2007092314,2007,3,2007-09-23,Sunday,20:25,DAL,34,CHI,10,Home,-24,44
2007092400,2007,3,2007-09-24,Monday,20:40,TEN,31,NO,14,Home,-17,45
2007093000,2007,4,2007-09-30,Sunday,13:00,HOU,16,ATL,26,Home,10,42
2007093001,2007,4,2007-09-30,Sunday,13:00,NYJ,14,BUF,17,Home,3,31
2007093002,2007,4,2007-09-30,Sunday,13:00,BAL,13,CLE,27,Home,14,40
2007093003,2007,4,2007-09-30,Sunday,13:00,STL,7,DAL,35,Home,28,42
2007093004,2007,4,2007-09-30,Sunday,13:00,CHI,27,DET,37,Home,10,64
2007093005,2007,4,2007-09-30,Sunday,13:00,OAK,35,MIA,17,Home,-18,52
2007093006,2007,4,2007-09-30,Sunday,13:00,GB,23,MIN,16,Home,-7,39
2007093007,2007,4,2007-09-30,Sunday,16:05,TB,20,CAR,7,Home,-13,27
2007093008,2007,4,2007-09-30,Sunday,16:05,SEA,23,SF,3,Home,-20,26
2007093009,2007,4,2007-09-30,Sunday,16:15,PIT,14,ARI,21,Home,7,35
2007093010,2007,4,2007-09-30,Sunday,16:15,DEN,20,IND,38,Home,18,58
2007093011,2007,4,2007-09-30,Sunday,16:15,KC,30,SD,16,Home,-14,46
2007093012,2007,4,2007-09-30,Sunday,20:25,PHI,3,NYG,16,Home,13,19
2007100100,2007,4,2007-10-01,Monday,20:40,NE,34,CIN,13,Home,-21,47
2007100700,2007,5,2007-10-07,Sunday,13:00,MIA,19,HOU,22,Home,3,41
2007100701,2007,5,2007-10-07,Sunday,13:00,JAX,17,KC,7,Home,-10,24
2007100702,2007,5,2007-10-07,Sunday,13:00,CLE,17,NE,34,Home,17,51
2007100703,2007,5,2007-10-07,Sunday,13:00,CAR,16,NO,13,Home,-3,29
2007100704,2007,5,2007-10-07,Sunday,13:00,NYJ,24,NYG,35,Home,11,59
2007100705,2007,5,2007-10-07,Sunday,13:00,SEA,0,PIT,21,Home,21,21
2007100706,2007,5,2007-10-07,Sunday,13:00,ARI,34,STL,31,Home,-3,65
2007100707,2007,5,2007-10-07,Sunday,13:00,ATL,13,TEN,20,Home,7,33
2007100708,2007,5,2007-10-07,Sunday,13:00,DET,3,WAS,34,Home,31,37
2007100709,2007,5,2007-10-07,Sunday,16:05,TB,14,IND,33,Home,19,47
2007100710,2007,5,2007-10-07,Sunday,16:15,SD,41,DEN,3,Home,-38,44
2007100711,2007,5,2007-10-07,Sunday,16:15,BAL,9,SF,7,Home,-2,16
2007100712,2007,5,2007-10-07,Sunday,20:25,CHI,27,GB,20,Home,-7,47
2007100800,2007,5,2007-10-08,Monday,20:40,DAL,25,BUF,24,Home,-1,49
2007101400,2007,6,2007-10-14,Sunday,13:00,STL,3,BAL,22,Home,19,25
2007101401,2007,6,2007-10-14,Sunday,13:00,MIN,34,CHI,31,Home,-3,65
2007101402,2007,6,2007-10-14,Sunday,13:00,MIA,31,CLE,41,Home,10,72
2007101403,2007,6,2007-10-14,Sunday,13:00,WAS,14,GB,17,Home,3,31
2007101404,2007,6,2007-10-14,Sunday,13:00,HOU,17,JAX,37,Home,20,54
2007101405,2007,6,2007-10-14,Sunday,13:00,CIN,20,KC,27,Home,7,47
2007101406,2007,6,2007-10-14,Sunday,13:00,PHI,16,NYJ,9,Home,-7,25
2007101407,2007,6,2007-10-14,Sunday,13:00,TEN,10,TB,13,Home,3,23
2007101408,2007,6,2007-10-14,Sunday,16:05,CAR,25,ARI,10,Home,-15,35
2007101409,2007,6,2007-10-14,Sunday,16:15,NE,48,DAL,27,Home,-21,75
2007101410,2007,6,2007-10-14,Sunday,16:15,OAK,14,SD,28,Home,14,42
2007101411,2007,6,2007-10-14,Sunday,20:25,NO,28,SEA,17,Home,-11,45
2007101500,2007,6,2007-10-15,Monday,20:40,NYG,31,ATL,10,Home,-21,41
2007102100,2007,7,2007-10-21,Sunday,13:00,BAL,14,BUF,19,Home,5,33
2007102101,2007,7,2007-10-21,Sunday,16:15,MIN,14,DAL,24,Home,10,38
2007102102,2007,7,2007-10-21,Sunday,13:00,TB,16,DET,23,Home,7,39
2007102103,2007,7,2007-10-21,Sunday,13:00,TEN,38,HOU,36,Home,-2,74
2007102104,2007,7,2007-10-21,Sunday,13:00,NE,49,MIA,28,Home,-21,77
2007102105,2007,7,2007-10-21,Sunday,13:00,SF,15,NYG,33,Home,18,48
2007102106,2007,7,2007-10-21,Sunday,13:00,ATL,16,NO,22,Home,6,38
2007102107,2007,7,2007-10-21,Sunday,13:00,ARI,19,WAS,21,Home,2,40
2007102108,2007,7,2007-10-21,Sunday,16:05,NYJ,31,CIN,38,Home,7,69
2007102109,2007,7,2007-10-21,Sunday,16:05,KC,12,OAK,10,Home,-2,22
2007102110,2007,7,2007-10-21,Sunday,16:15,CHI,19,PHI,16,Home,-3,35
2007102111,2007,7,2007-10-21,Sunday,16:15,STL,6,SEA,33,Home,27,39
2007102112,2007,7,2007-10-21,Sunday,20:25,PIT,28,DEN,31,Home,3,59
2007102200,2007,7,2007-10-22,Monday,20:40,IND,29,JAX,7,Home,-22,36
2007102800,2007,8,2007-10-28,Sunday,13:00,IND,31,CAR,7,Home,-24,38
2007102801,2007,8,2007-10-28,Sunday,13:00,DET,16,CHI,7,Home,-9,23
2007102802,2007,8,2007-10-28,Sunday,13:00,PIT,24,CIN,13,Home,-11,37
2007102803,2007,8,2007-10-28,Sunday,13:00,NYG,13,MIA,10,Neutral,-3,23
2007102804,2007,8,2007-10-28,Sunday,13:00,PHI,23,MIN,16,Home,-7,39
2007102805,2007,8,2007-10-28,Sunday,13:00,CLE,27,STL,20,Home,-7,47
2007102806,2007,8,2007-10-28,Sunday,13:00,OAK,9,TEN,13,Home,4,22
2007102807,2007,8,2007-10-28,Sunday,16:05,BUF,13,NYJ,3,Home,-10,16
2007102808,2007,8,2007-10-28,Sunday,16:05,HOU,10,SD,35,Home,25,45
2007102809,2007,8,2007-10-28,Sunday,16:05,JAX,24,TB,23,Home,-1,47
2007102810,2007,8,2007-10-28,Sunday,16:15,WAS,7,NE,52,Home,45,59
2007102811,2007,8,2007-10-28,Sunday,16:15,NO,31,SF,10,Home,-21,41
2007102900,2007,8,2007-10-29,Monday,20:40,GB,19,DEN,13,Home,-6,32
2007110400,2007,9,2007-11-04,Sunday,13:00,SF,16,ATL,20,Home,4,36
2007110401,2007,9,2007-11-04,Sunday,13:00,CIN,21,BUF,33,Home,12,54
2007110402,2007,9,2007-11-04,Sunday,13:00,DEN,7,DET,44,Home,37,51
2007110403,2007,9,2007-11-04,Sunday,13:00,GB,33,KC,22,Home,-11,55
2007110404,2007,9,2007-11-04,Sunday,13:00,SD,17,MIN,35,Home,18,52
2007110405,2007,9,2007-11-04,Sunday,13:00,JAX,24,NO,41,Home,17,65
2007110406,2007,9,2007-11-04,Sunday,13:00,WAS,23,NYJ,20,Home,-3,43
2007110407,2007,9,2007-11-04,Sunday,13:00,ARI,10,TB,17,Home,7,27
2007110408,2007,9,2007-11-04,Sunday,13:00,CAR,7,TEN,20,Home,13,27
2007110409,2007,9,2007-11-04,Sunday,16:05,SEA,30,CLE,33,Home,3,63
2007110410,2007,9,2007-11-04,Sunday,16:15,NE,24,IND,20,Home,-4,44
2007110411,2007,9,2007-11-04,Sunday,16:15,HOU,24,OAK,17,Home,-7,41
2007110412,2007,9,2007-11-04,Sunday,20:25,DAL,38,PHI,17,Home,-21,55
2007110500,2007,9,2007-11-05,Monday,20:40,BAL,7,PIT,38,Home,31,45
2007111100,2007,10,2007-11-11,Sunday,13:00,ATL,20,CAR,13,Home,-7,33
2007111101,2007,10,2007-11-11,Sunday,13:00,MIN,0,GB,34,Home,34,34
2007111102,2007,10,2007-11-11,Sunday,13:00,DEN,27,KC,11,Home,-16,38
2007111103,2007,10,2007-11-11,Sunday,13:00,BUF,13,MIA,10,Home,-3,23
2007111104,2007,10,2007-11-11,Sunday,13:00,STL,37,NO,29,Home,-8,66
2007111105,2007,10,2007-11-11,Sunday,13:00,CLE,28,PIT,31,Home,3,59
2007111106,2007,10,2007-11-11,Sunday,13:00,JAX,28,TEN,13,Home,-15,41
2007111107,2007,10,2007-11-11,Sunday,13:00,PHI,33,WAS,25,Home,-8,58
2007111108,2007,10,2007-11-11,Sunday,16:05,CIN,21,BAL,7,Home,-14,28
2007111109,2007,10,2007-11-11,Sunday,16:15,DET,21,ARI,31,Home,10,52
2007111110,2007,10,2007-11-11,Sunday,16:15,DAL,31,NYG,20,Home,-11,51
2007111111,2007,10,2007-11-11,Sunday,16:15,CHI,17,OAK,6,Home,-11,23
2007111112,2007,10,2007-11-11,Sunday,20:15,IND,21,SD,23,Home,2,44
2007111200,2007,10,2007-11-12,Monday,20:40,SF,0,SEA,24,Home,24,24
2007111800,2007,11,2007-11-18,Sunday,13:00,TB,31,ATL,7,Home,-24,38
2007111801,2007,11,2007-11-18,Sunday,13:00,CLE,33,BAL,30,Home,-3,63
2007111802,2007,11,2007-11-18,Sunday,20:25,NE,56,BUF,10,Home,-46,66
2007111803,2007,11,2007-11-18,Sunday,13:00,ARI,35,CIN,27,Home,-8,62
2007111804,2007,11,2007-11-18,Sunday,16:15,WAS,23,DAL,28,Home,5,51
2007111805,2007,11,2007-11-18,Sunday,13:00,CAR,17,GB,31,Home,14,48
2007111806,2007,11,2007-11-18,Sunday,13:00,NO,10,HOU,23,Home,13,33
2007111807,2007,11,2007-11-18,Sunday,13:00,KC,10,IND,13,Home,3,23
2007111808,2007,11,2007-11-18,Sunday,13:00,SD,17,JAX,24,Home,7,41
2007111809,2007,11,2007-11-18,Sunday,13:00,OAK,22,MIN,29,Home,7,51
2007111810,2007,11,2007-11-18,Sunday,16:05,PIT,16,NYJ,19,Home,3,35
2007111811,2007,11,2007-11-18,Sunday,13:00,MIA,7,PHI,17,Home,10,24
2007111812,2007,11,2007-11-18,Sunday,13:00,NYG,16,DET,10,Home,-6,26
2007111813,2007,11,2007-11-18,Sunday,16:15,STL,13,SF,9,Home,-4,22
2007111814,2007,11,2007-11-18,Sunday,16:15,CHI,23,SEA,30,Home,7,53
2007111900,2007,11,2007-11-19,Monday,20:40,TEN,20,DEN,34,Home,14,54
2007112200,2007,12,2007-11-22,Thursday,12:30,GB,37,DET,26,Home,-11,63
2007112201,2007,12,2007-11-22,Thursday,16:15,NYJ,3,DAL,34,Home,31,37
2007112202,2007,12,2007-11-22,Thursday,20:15,IND,31,ATL,13,Home,-18,44
2007112500,2007,12,2007-11-25,Sunday,13:00,NO,31,CAR,6,Home,-25,37
2007112501,2007,12,2007-11-25,Sunday,16:15,DEN,34,CHI,37,Home,3,71
2007112502,2007,12,2007-11-25,Sunday,13:00,TEN,6,CIN,35,Home,29,41
2007112503,2007,12,2007-11-25,Sunday,13:00,HOU,17,CLE,27,Home,10,44
2007112504,2007,12,2007-11-25,Sunday,13:00,BUF,14,JAX,36,Home,22,50
2007112505,2007,12,2007-11-25,Sunday,13:00,OAK,20,KC,17,Home,-3,37
2007112506,2007,12,2007-11-25,Sunday,13:00,MIN,41,NYG,17,Home,-24,58
2007112507,2007,12,2007-11-25,Sunday,13:00,SEA,24,STL,19,Home,-5,43
2007112508,2007,12,2007-11-25,Sunday,13:00,WAS,13,TB,19,Home,6,32
2007112509,2007,12,2007-11-25,Sunday,16:05,SF,37,ARI,31,Home,-6,68
2007112510,2007,12,2007-11-25,Sunday,16:15,BAL,14,SD,32,Home,18,46
2007112511,2007,12,2007-11-25,Sunday,20:25,PHI,28,NE,31,Home,3,59
2007112600,2007,12,2007-11-26,Monday,20:30,MIA,0,PIT,3,Home,3,3
2007112900,2007,13,2007-11-29,Thursday,20:15,GB,27,DAL,37,Home,10,64
2007120200,2007,13,2007-12-02,Sunday,13:00,SF,14,CAR,31,Home,17,45
2007120201,2007,13,2007-12-02,Sunday,13:00,JAX,25,IND,28,Home,3,53
2007120202,2007,13,2007-12-02,Sunday,13:00,SD,24,KC,10,Home,-14,34
2007120203,2007,13,2007-12-02,Sunday,13:00,NYJ,40,MIA,13,Home,-27,53
2007120204,2007,13,2007-12-02,Sunday,13:00,DET,10,MIN,42,Home,32,52
2007120205,2007,13,2007-12-02,Sunday,16:15,TB,27,NO,23,Home,-4,50
2007120206,2007,13,2007-12-02,Sunday,13:00,SEA,28,PHI,24,Home,-4,52
2007120207,2007,13,2007-12-02,Sunday,13:00,ATL,16,STL,28,Home,12,44
2007120208,2007,13,2007-12-02,Sunday,13:00,HOU,20,TEN,28,Home,8,48
2007120209,2007,13,2007-12-02,Sunday,13:00,BUF,17,WAS,16,Home,-1,33
2007120210,2007,13,2007-12-02,Sunday,16:05,CLE,21,ARI,27,Home,6,48
2007120211,2007,13,2007-12-02,Sunday,16:05,DEN,20,OAK,34,Home,14,54
2007120212,2007,13,2007-12-02,Sunday,16:15,NYG,21,CHI,16,Home,-5,37
2007120213,2007,13,2007-12-02,Sunday,20:25,CIN,10,PIT,24,Home,14,34
2007120300,2007,13,2007-12-03,Monday,20:40,NE,27,BAL,24,Home,-3,51
2007120600,2007,14,2007-12-06,Thursday,20:15,CHI,16,WAS,24,Home,8,40
2007120900,2007,14,2007-12-09,Sunday,13:00,MIA,17,BUF,38,Home,21,55
2007120901,2007,14,2007-12-09,Sunday,13:00,STL,10,CIN,19,Home,9,29
2007120902,2007,14,2007-12-09,Sunday,13:00,DAL,28,DET,27,Home,-1,55
2007120903,2007,14,2007-12-09,Sunday,13:00,OAK,7,GB,38,Home,31,45
2007120904,2007,14,2007-12-09,Sunday,13:00,TB,14,HOU,28,Home,14,42
2007120905,2007,14,2007-12-09,Sunday,13:00,CAR,6,JAX,37,Home,31,43
2007120906,2007,14,2007-12-09,Sunday,16:15,PIT,13,NE,34,Home,21,47
2007120907,2007,14,2007-12-09,Sunday,13:00,NYG,16,PHI,13,Home,-3,29
2007120908,2007,14,2007-12-09,Sunday,13:00,SD,23,TEN,17,Home,-6,40
2007120909,2007,14,2007-12-09,Sunday,16:05,MIN,27,SF,7,Home,-20,34
2007120910,2007,14,2007-12-09,Sunday,16:05,ARI,21,SEA,42,Home,21,63
2007120911,2007,14,2007-12-09,Sunday,16:15,KC,7,DEN,41,Home,34,48
2007120912,2007,14,2007-12-09,Sunday,16:15,CLE,24,NYJ,18,Home,-6,42
2007120913,2007,14,2007-12-09,Sunday,20:25,IND,44,BAL,20,Home,-24,64
2007121000,2007,14,2007-12-10,Monday,20:40,NO,34,ATL,14,Home,-20,48
2007121300,2007,15,2007-12-13,Thursday,20:15,DEN,13,HOU,31,Home,18,44
2007121500,2007,15,2007-12-15,Saturday,20:15,CIN,13,SF,20,Home,7,33
2007121600,2007,15,2007-12-16,Sunday,13:00,SEA,10,CAR,13,Home,3,23
2007121601,2007,15,2007-12-16,Sunday,13:00,BUF,0,CLE,8,Home,8,8
2007121602,2007,15,2007-12-16,Sunday,13:00,TEN,26,KC,17,Home,-9,43
2007121603,2007,15,2007-12-16,Sunday,13:00,BAL,16,MIA,22,Home,6,38
2007121604,2007,15,2007-12-16,Sunday,13:00,NYJ,10,NE,20,Home,10,30
2007121605,2007,15,2007-12-16,Sunday,13:00,ARI,24,NO,31,Home,7,55
2007121606,2007,15,2007-12-16,Sunday,13:00,JAX,29,PIT,22,Home,-7,51
2007121607,2007,15,2007-12-16,Sunday,13:00,GB,33,STL,14,Home,-19,47
2007121608,2007,15,2007-12-16,Sunday,13:00,ATL,3,TB,37,Home,34,40
2007121609,2007,15,2007-12-16,Sunday,16:05,IND,21,OAK,14,Home,-7,35
2007121610,2007,15,2007-12-16,Sunday,16:15,PHI,10,DAL,6,Home,-4,16
2007121611,2007,15,2007-12-16,Sunday,16:15,DET,14,SD,51,Home,37,65
2007121612,2007,15,2007-12-16,Sunday,20:25,WAS,22,NYG,10,Home,-12,32
2007121701,2007,15,2007-12-17,Monday,20:40,CHI,13,MIN,20,Home,7,33
2007122000,2007,16,2007-12-20,Thursday,20:15,PIT,41,STL,24,Home,-17,65
2007122200,2007,16,2007-12-22,Saturday,20:15,DAL,20,CAR,13,Home,-7,33
2007122300,2007,16,2007-12-23,Sunday,13:00,NYG,38,BUF,21,Home,-17,59
2007122301,2007,16,2007-12-23,Sunday,13:00,GB,7,CHI,35,Home,28,42
2007122302,2007,16,2007-12-23,Sunday,13:00,CLE,14,CIN,19,Home,5,33
2007122303,2007,16,2007-12-23,Sunday,13:00,KC,20,DET,25,Home,5,45
2007122304,2007,16,2007-12-23,Sunday,13:00,HOU,15,IND,38,Home,23,53
2007122305,2007,16,2007-12-23,Sunday,13:00,OAK,11,JAX,49,Home,38,60
2007122306,2007,16,2007-12-23,Sunday,20:15,WAS,32,MIN,21,Home,-11,53
2007122307,2007,16,2007-12-23,Sunday,16:15,MIA,7,NE,28,Home,21,35
2007122308,2007,16,2007-12-23,Sunday,13:00,PHI,38,NO,23,Home,-15,61
2007122309,2007,16,2007-12-23,Sunday,16:05,ATL,27,ARI,30,Home,3,57
2007122310,2007,16,2007-12-23,Sunday,16:15,BAL,6,SEA,27,Home,21,33
2007122311,2007,16,2007-12-23,Sunday,16:15,NYJ,6,TEN,10,Home,4,16
2007122312,2007,16,2007-12-23,Sunday,16:05,TB,19,SF,21,Home,2,40
2007122400,2007,16,2007-12-24,Monday,20:00,DEN,3,SD,23,Home,20,26
2007122900,2007,17,2007-12-29,Saturday,20:15,NE,38,NYG,35,Home,-3,73
2007123000,2007,17,2007-12-30,Sunday,13:00,SEA,41,ATL,44,Home,3,85
2007123001,2007,17,2007-12-30,Sunday,16:15,PIT,21,BAL,27,Home,6,48
2007123002,2007,17,2007-12-30,Sunday,13:00,NO,25,CHI,33,Home,8,58
2007123003,2007,17,2007-12-30,Sunday,13:00,SF,7,CLE,20,Home,13,27
2007123004,2007,17,2007-12-30,Sunday,13:00,DET,13,GB,34,Home,21,47
2007123005,2007,17,2007-12-30,Sunday,13:00,JAX,28,HOU,42,Home,14,70
2007123006,2007,17,2007-12-30,Sunday,20:25,TEN,16,IND,10,Home,-6,26
2007123007,2007,17,2007-12-30,Sunday,13:00,CIN,38,MIA,25,Home,-13,63
2007123008,2007,17,2007-12-30,Sunday,13:00,BUF,9,PHI,17,Home,8,26
2007123009,2007,17,2007-12-30,Sunday,13:00,CAR,31,TB,23,Home,-8,54
2007123010,2007,17,2007-12-30,Sunday,16:15,DAL,6,WAS,27,Home,21,33
2007123011,2007,17,2007-12-30,Sunday,16:15,STL,19,ARI,48,Home,29,67
2007123012,2007,17,2007-12-30,Sunday,16:15,MIN,19,DEN,22,Home,3,41
2007123013,2007,17,2007-12-30,Sunday,16:15,SD,30,OAK,17,Home,-13,47
2007123014,2007,17,2007-12-30,Sunday,16:15,KC,10,NYJ,13,Home,3,23
2008010500,2007,18,2008-01-05,Saturday,16:30,WAS,14,SEA,35,Home,21,49
2008010501,2007,18,2008-01-05,Saturday,20:15,JAX,31,PIT,29,Home,-2,60
2008010600,2007,18,2008-01-06,Sunday,13:00,NYG,24,TB,14,Home,-10,38
2008010601,2007,18,2008-01-06,Sunday,16:30,TEN,6,SD,17,Home,11,23
2008011200,2007,19,2008-01-12,Saturday,16:30,SEA,20,GB,42,Home,22,62
2008011201,2007,19,2008-01-12,Saturday,20:15,JAX,20,NE,31,Home,11,51
2008011300,2007,19,2008-01-13,Sunday,13:00,SD,28,IND,24,Home,-4,52
2008011301,2007,19,2008-01-13,Sunday,16:30,NYG,21,DAL,17,Home,-4,38
2008012000,2007,20,2008-01-20,Sunday,15:00,SD,12,NE,21,Home,9,33
2008012001,2007,20,2008-01-20,Sunday,18:30,NYG,23,GB,20,Home,-3,43
2008020300,2007,21,2008-02-03,Sunday,18:30,NYG,17,NE,14,Neutral,-3,31
2008090400,2008,1,2008-09-04,Thursday,19:00,WAS,7,NYG,16,Home,9,23
2008090700,2008,1,2008-09-07,Sunday,13:00,DET,21,ATL,34,Home,13,55
2008090701,2008,1,2008-09-07,Sunday,13:00,CIN,10,BAL,17,Home,7,27
2008090702,2008,1,2008-09-07,Sunday,13:00,SEA,10,BUF,34,Home,24,44
2008090703,2008,1,2008-09-07,Sunday,13:00,NYJ,20,MIA,14,Home,-6,34
2008090704,2008,1,2008-09-07,Sunday,13:00,KC,10,NE,17,Home,7,27
2008090705,2008,1,2008-09-07,Sunday,13:00,TB,20,NO,24,Home,4,44
2008090706,2008,1,2008-09-07,Sunday,13:00,STL,3,PHI,38,Home,35,41
2008090707,2008,1,2008-09-07,Sunday,13:00,HOU,17,PIT,38,Home,21,55
2008090708,2008,1,2008-09-07,Sunday,13:00,JAX,10,TEN,17,Home,7,27
2008090709,2008,1,2008-09-07,Sunday,16:15,DAL,28,CLE,10,Home,-18,38
2008090710,2008,1,2008-09-07,Sunday,16:15,CAR,26,SD,24,Home,-2,50
2008090711,2008,1,2008-09-07,Sunday,16:15,ARI,23,SF,13,Home,-10,36
2008090712,2008,1,2008-09-07,Sunday,20:15,CHI,29,IND,13,Home,-16,42
2008090800,2008,1,2008-09-08,Monday,19:00,MIN,19,GB,24,Home,5,43
2008090801,2008,1,2008-09-08,Monday,22:15,DEN,41,OAK,14,Home,-27,55
2008091400,2008,2,2008-09-14,Sunday,13:00,CHI,17,CAR,20,Home,3,37
2008091401,2008,2,2008-09-14,Sunday,13:00,TEN,24,CIN,7,Home,-17,31
2008091402,2008,2,2008-09-14,Sunday,13:00,GB,48,DET,25,Home,-23,73
2008091403,2008,2,2008-09-14,Sunday,13:00,BUF,20,JAX,16,Home,-4,36
2008091404,2008,2,2008-09-14,Sunday,13:00,OAK,23,KC,8,Home,-15,31
2008091405,2008,2,2008-09-14,Sunday,13:00,IND,18,MIN,15,Home,-3,33
2008091406,2008,2,2008-09-14,Sunday,13:00,NYG,41,STL,13,Home,-28,54
2008091407,2008,2,2008-09-14,Sunday,13:00,NO,24,WAS,29,Home,5,53
2008091408,2008,2,2008-09-14,Sunday,16:05,SF,33,SEA,30,Home,-3,63
2008091409,2008,2,2008-09-14,Sunday,16:05,ATL,9,TB,24,Home,15,33
2008091410,2008,2,2008-09-14,Sunday,16:15,MIA,10,ARI,31,Home,21,41
2008091411,2008,2,2008-09-14,Sunday,16:15,SD,38,DEN,39,Home,1,77
2008091413,2008,2,2008-09-14,Sunday,16:15,NE,19,NYJ,10,Home,-9,29
2008091414,2008,2,2008-09-14,Sunday,20:15,PIT,10,CLE,6,Home,-4,16
2008091500,2008,2,2008-09-15,Monday,20:30,PHI,37,DAL,41,Home,4,78
2008092100,2008,3,2008-09-21,Sunday,13:00,KC,14,ATL,38,Home,24,52
2008092101,2008,3,2008-09-21,Sunday,13:00,OAK,23,BUF,24,Home,1,47
2008092102,2008,3,2008-09-21,Sunday,13:00,TB,27,CHI,24,Home,-3,51
2008092103,2008,3,2008-09-21,Sunday,13:00,CAR,10,MIN,20,Home,10,30
2008092104,2008,3,2008-09-21,Sunday,13:00,MIA,38,NE,13,Home,-25,51
2008092105,2008,3,2008-09-21,Sunday,13:00,CIN,23,NYG,26,Home,3,49
2008092106,2008,3,2008-09-21,Sunday,13:00,HOU,12,TEN,31,Home,19,43
2008092107,2008,3,2008-09-21,Sunday,13:00,ARI,17,WAS,24,Home,7,41
2008092108,2008,3,2008-09-21,Sunday,16:05,NO,32,DEN,34,Home,2,66
2008092109,2008,3,2008-09-21,Sunday,16:05,DET,13,SF,31,Home,18,44
2008092110,2008,3,2008-09-21,Sunday,16:05,STL,13,SEA,37,Home,24,50
2008092111,2008,3,2008-09-21,Sunday,16:15,CLE,10,BAL,28,Home,18,38
2008092112,2008,3,2008-09-21,Sunday,16:15,JAX,23,IND,21,Home,-2,44
2008092113,2008,3,2008-09-21,Sunday,16:15,PIT,6,PHI,15,Home,9,21
2008092114,2008,3,2008-09-21,Sunday,20:15,DAL,27,GB,16,Home,-11,43
2008092200,2008,3,2008-09-22,Monday,20:30,NYJ,29,SD,48,Home,19,77
2008092800,2008,4,2008-09-28,Sunday,13:00,ATL,9,CAR,24,Home,15,33
2008092801,2008,4,2008-09-28,Sunday,13:00,CLE,20,CIN,12,Home,-8,32
2008092802,2008,4,2008-09-28,Sunday,13:00,HOU,27,JAX,30,Home,3,57
2008092803,2008,4,2008-09-28,Sunday,13:00,DEN,19,KC,33,Home,14,52
2008092804,2008,4,2008-09-28,Sunday,13:00,SF,17,NO,31,Home,14,48
2008092805,2008,4,2008-09-28,Sunday,13:00,ARI,35,NYJ,56,Home,21,91
2008092806,2008,4,2008-09-28,Sunday,13:00,GB,21,TB,30,Home,9,51
2008092807,2008,4,2008-09-28,Sunday,13:00,MIN,17,TEN,30,Home,13,47
2008092808,2008,4,2008-09-28,Sunday,16:05,SD,28,OAK,18,Home,-10,46
2008092809,2008,4,2008-09-28,Sunday,16:05,BUF,31,STL,14,Home,-17,45
2008092810,2008,4,2008-09-28,Sunday,16:15,WAS,26,DAL,24,Home,-2,50
2008092811,2008,4,2008-09-28,Sunday,20:15,PHI,20,CHI,24,Home,4,44
2008092900,2008,4,2008-09-29,Monday,20:30,BAL,20,PIT,23,Home,3,43
2008100500,2008,5,2008-10-05,Sunday,13:00,TEN,13,BAL,10,Home,-3,23
2008100501,2008,5,2008-10-05,Sunday,13:00,KC,0,CAR,34,Home,34,34
2008100502,2008,5,2008-10-05,Sunday,13:00,CHI,34,DET,7,Home,-27,41
2008100503,2008,5,2008-10-05,Sunday,13:00,ATL,27,GB,24,Home,-3,51
2008100504,2008,5,2008-10-05,Sunday,13:00,IND,31,HOU,27,Home,-4,58
2008100505,2008,5,2008-10-05,Sunday,13:00,SD,10,MIA,17,Home,7,27
2008100506,2008,5,2008-10-05,Sunday,13:00,SEA,6,NYG,44,Home,38,50
2008100507,2008,5,2008-10-05,Sunday,13:00,WAS,23,PHI,17,Home,-6,40
2008100508,2008,5,2008-10-05,Sunday,16:05,TB,13,DEN,16,Home,3,29
2008100509,2008,5,2008-10-05,Sunday,16:15,BUF,17,ARI,41,Home,24,58
2008100510,2008,5,2008-10-05,Sunday,16:15,CIN,22,DAL,31,Home,9,53
2008100511,2008,5,2008-10-05,Sunday,16:15,NE,30,SF,21,Home,-9,51
2008100512,2008,5,2008-10-05,Sunday,20:15,PIT,26,JAX,21,Home,-5,47
2008100600,2008,5,2008-10-06,Monday,20:30,MIN,30,NO,27,Home,-3,57
2008101200,2008,6,2008-10-12,Sunday,13:00,CHI,20,ATL,22,Home,2,42
2008101201,2008,6,2008-10-12,Sunday,13:00,MIA,28,HOU,29,Home,1,57
2008101202,2008,6,2008-10-12,Sunday,13:00,BAL,3,IND,31,Home,28,34
2008101203,2008,6,2008-10-12,Sunday,13:00,DET,10,MIN,12,Home,2,22
2008101204,2008,6,2008-10-12,Sunday,13:00,OAK,3,NO,34,Home,31,37
2008101205,2008,6,2008-10-12,Sunday,13:00,CIN,14,NYJ,26,Home,12,40
2008101206,2008,6,2008-10-12,Sunday,13:00,CAR,3,TB,27,Home,24,30
2008101207,2008,6,2008-10-12,Sunday,13:00,STL,19,WAS,17,Home,-2,36
2008101208,2008,6,2008-10-12,Sunday,16:05,JAX,24,DEN,17,Home,-7,41
2008101209,2008,6,2008-10-12,Sunday,16:15,DAL,24,ARI,30,Home,6,54
2008101210,2008,6,2008-10-12,Sunday,16:15,PHI,40,SF,26,Home,-14,66
2008101211,2008,6,2008-10-12,Sunday,16:15,GB,27,SEA,17,Home,-10,44
2008101212,2008,6,2008-10-12,Sunday,20:15,NE,10,SD,30,Home,20,40
2008101300,2008,6,2008-10-13,Monday,20:30,NYG,14,CLE,35,Home,21,49
2008101900,2008,7,2008-10-19,Sunday,13:00,SD,14,BUF,23,Home,9,37
2008101901,2008,7,2008-10-19,Sunday,13:00,NO,7,CAR,30,Home,23,37
2008101902,2008,7,2008-10-19,Sunday,13:00,MIN,41,CHI,48,Home,7,89
2008101903,2008,7,2008-10-19,Sunday,13:00,PIT,38,CIN,10,Home,-28,48
2008101904,2008,7,2008-10-19,Sunday,13:00,TEN,34,KC,10,Home,-24,44
2008101905,2008,7,2008-10-19,Sunday,13:00,BAL,27,MIA,13,Home,-14,40
2008101906,2008,7,2008-10-19,Sunday,13:00,SF,17,NYG,29,Home,12,46
2008101907,2008,7,2008-10-19,Sunday,13:00,DAL,14,STL,34,Home,20,48
2008101908,2008,7,2008-10-19,Sunday,16:05,DET,21,HOU,28,Home,7,49
2008101909,2008,7,2008-10-19,Sunday,16:15,IND,14,GB,34,Home,20,48
2008101910,2008,7,2008-10-19,Sunday,16:15,NYJ,13,OAK,16,Home,3,29
2008101911,2008,7,2008-10-19,Sunday,16:15,CLE,11,WAS,14,Home,3,25
2008101912,2008,7,2008-10-19,Sunday,20:15,SEA,10,TB,20,Home,10,30
2008102000,2008,7,2008-10-20,Monday,20:30,DEN,7,NE,41,Home,34,48
2008102600,2008,8,2008-10-26,Sunday,13:00,OAK,10,BAL,29,Home,19,39
2008102601,2008,8,2008-10-26,Sunday,13:00,ARI,23,CAR,27,Home,4,50
2008102602,2008,8,2008-10-26,Sunday,13:00,TB,9,DAL,13,Home,4,22
2008102603,2008,8,2008-10-26,Sunday,13:00,WAS,25,DET,17,Home,-8,42
2008102604,2008,8,2008-10-26,Sunday,13:00,BUF,16,MIA,25,Home,9,41
2008102605,2008,8,2008-10-26,Sunday,13:00,STL,16,NE,23,Home,7,39
2008102606,2008,8,2008-10-26,Sunday,13:00,SD,32,NO,37,Neutral,5,69
2008102607,2008,8,2008-10-26,Sunday,13:00,KC,24,NYJ,28,Home,4,52
2008102608,2008,8,2008-10-26,Sunday,13:00,ATL,14,PHI,27,Home,13,41
2008102609,2008,8,2008-10-26,Sunday,16:05,CLE,23,JAX,17,Home,-6,40
2008102610,2008,8,2008-10-26,Sunday,16:15,NYG,21,PIT,14,Home,-7,35
2008102611,2008,8,2008-10-26,Sunday,16:15,SEA,34,SF,13,Home,-21,47
2008102612,2008,8,2008-10-26,Sunday,16:05,CIN,6,HOU,35,Home,29,41
2008102700,2008,8,2008-10-27,Monday,20:30,IND,21,TEN,31,Home,10,52
2008110200,2008,9,2008-11-02,Sunday,13:00,NYJ,26,BUF,17,Home,-9,43
2008110201,2008,9,2008-11-02,Sunday,13:00,DET,23,CHI,27,Home,4,50
2008110202,2008,9,2008-11-02,Sunday,13:00,JAX,19,CIN,21,Home,2,40
2008110203,2008,9,2008-11-02,Sunday,13:00,BAL,37,CLE,27,Home,-10,64
2008110204,2008,9,2008-11-02,Sunday,13:00,TB,30,KC,27,Home,-3,57
2008110205,2008,9,2008-11-02,Sunday,13:00,HOU,21,MIN,28,Home,7,49
2008110206,2008,9,2008-11-02,Sunday,13:00,ARI,34,STL,13,Home,-21,47
2008110207,2008,9,2008-11-02,Sunday,13:00,GB,16,TEN,19,Home,3,35
2008110208,2008,9,2008-11-02,Sunday,16:05,MIA,26,DEN,17,Home,-9,43
2008110209,2008,9,2008-11-02,Sunday,16:15,DAL,14,NYG,35,Home,21,49
2008110210,2008,9,2008-11-02,Sunday,16:15,ATL,24,OAK,0,Home,-24,24
2008110211,2008,9,2008-11-02,Sunday,16:15,PHI,26,SEA,7,Home,-19,33
2008110212,2008,9,2008-11-02,Sunday,20:15,NE,15,IND,18,Home,3,33
2008110300,2008,9,2008-11-03,Monday,20:30,PIT,23,WAS,6,Home,-17,29
2008110600,2008,10,2008-11-06,Thursday,20:15,DEN,34,CLE,30,Home,-4,64
2008110900,2008,10,2008-11-09,Sunday,13:00,NO,20,ATL,34,Home,14,54
2008110901,2008,10,2008-11-09,Sunday,13:00,TEN,21,CHI,14,Home,-7,35
2008110902,2008,10,2008-11-09,Sunday,13:00,JAX,38,DET,14,Home,-24,52
2008110903,2008,10,2008-11-09,Sunday,13:00,BAL,41,HOU,13,Home,-28,54
2008110904,2008,10,2008-11-09,Sunday,13:00,SEA,19,MIA,21,Home,2,40
2008110905,2008,10,2008-11-09,Sunday,13:00,GB,27,MIN,28,Home,1,55
2008110906,2008,10,2008-11-09,Sunday,13:00,BUF,10,NE,20,Home,10,30
2008110907,2008,10,2008-11-09,Sunday,13:00,STL,3,NYJ,47,Home,44,50
2008110908,2008,10,2008-11-09,Sunday,16:05,CAR,17,OAK,6,Home,-11,23
2008110909,2008,10,2008-11-09,Sunday,16:15,IND,24,PIT,20,Home,-4,44
2008110910,2008,10,2008-11-09,Sunday,16:15,KC,19,SD,20,Home,1,39
2008110911,2008,10,2008-11-09,Sunday,20:15,NYG,36,PHI,31,Home,-5,67
2008111000,2008,10,2008-11-10,Monday,20:30,SF,24,ARI,29,Home,5,53
2008111300,2008,11,2008-11-13,Thursday,20:15,NYJ,34,NE,31,Home,-3,65
2008111600,2008,11,2008-11-16,Sunday,13:00,DEN,24,ATL,20,Home,-4,44
2008111601,2008,11,2008-11-16,Sunday,13:00,DET,22,CAR,31,Home,9,53
2008111602,2008,11,2008-11-16,Sunday,13:00,PHI,13,CIN,13,Home,0,26
2008111603,2008,11,2008-11-16,Sunday,13:00,CHI,3,GB,37,Home,34,40
2008111604,2008,11,2008-11-16,Sunday,13:00,HOU,27,IND,33,Home,6,60
2008111605,2008,11,2008-11-16,Sunday,16:15,TEN,24,JAX,14,Home,-10,38
2008111606,2008,11,2008-11-16,Sunday,13:00,NO,30,KC,20,Home,-10,50
2008111607,2008,11,2008-11-16,Sunday,13:00,OAK,15,MIA,17,Home,2,32
2008111608,2008,11,2008-11-16,Sunday,13:00,BAL,10,NYG,30,Home,20,40
2008111609,2008,11,2008-11-16,Sunday,13:00,MIN,13,TB,19,Home,6,32
2008111610,2008,11,2008-11-16,Sunday,16:05,STL,16,SF,35,Home,19,51
2008111611,2008,11,2008-11-16,Sunday,16:05,ARI,26,SEA,20,Home,-6,46
2008111612,2008,11,2008-11-16,Sunday,16:15,SD,10,PIT,11,Home,1,21
2008111613,2008,11,2008-11-16,Sunday,20:15,DAL,14,WAS,10,Home,-4,24
2008111700,2008,11,2008-11-17,Monday,20:30,CLE,29,BUF,27,Home,-2,56
2008112000,2008,12,2008-11-20,Thursday,20:15,CIN,10,PIT,27,Home,17,37
2008112300,2008,12,2008-11-23,Sunday,16:15,CAR,28,ATL,45,Home,17,73
2008112301,2008,12,2008-11-23,Sunday,13:00,PHI,7,BAL,36,Home,29,43
2008112302,2008,12,2008-11-23,Sunday,13:00,HOU,16,CLE,6,Home,-10,22
2008112303,2008,12,2008-11-23,Sunday,13:00,SF,22,DAL,35,Home,13,57
2008112304,2008,12,2008-11-23,Sunday,13:00,TB,38,DET,20,Home,-18,58
2008112305,2008,12,2008-11-23,Sunday,13:00,MIN,30,JAX,12,Home,-18,42
2008112306,2008,12,2008-11-23,Sunday,13:00,BUF,54,KC,31,Home,-23,85
2008112307,2008,12,2008-11-23,Sunday,13:00,NE,48,MIA,28,Home,-20,76
2008112308,2008,12,2008-11-23,Sunday,13:00,CHI,27,STL,3,Home,-24,30
2008112309,2008,12,2008-11-23,Sunday,13:00,NYJ,34,TEN,13,Home,-21,47
2008112310,2008,12,2008-11-23,Sunday,16:05,OAK,31,DEN,10,Home,-21,41
2008112311,2008,12,2008-11-23,Sunday,16:15,NYG,37,ARI,29,Home,-8,66
2008112312,2008,12,2008-11-23,Sunday,16:15,WAS,20,SEA,17,Home,-3,37
2008112313,2008,12,2008-11-23,Sunday,20:15,IND,23,SD,20,Home,-3,43
2008112400,2008,12,2008-11-24,Monday,20:30,GB,29,NO,51,Home,22,80
2008112700,2008,13,2008-11-27,Thursday,12:30,TEN,47,DET,10,Home,-37,57
2008112701,2008,13,2008-11-27,Thursday,16:25,SEA,9,DAL,34,Home,25,43
2008112702,2008,13,2008-11-27,Thursday,20:15,ARI,20,PHI,48,Home,28,68
2008113000,2008,13,2008-11-30,Sunday,13:00,SF,10,BUF,3,Home,-7,13
2008113001,2008,13,2008-11-30,Sunday,13:00,BAL,34,CIN,3,Home,-31,37
2008113002,2008,13,2008-11-30,Sunday,13:00,IND,10,CLE,6,Home,-4,16
2008113003,2008,13,2008-11-30,Sunday,13:00,CAR,35,GB,31,Home,-4,66
2008113004,2008,13,2008-11-30,Sunday,16:15,DEN,34,NYJ,17,Home,-17,51
2008113005,2008,13,2008-11-30,Sunday,13:00,MIA,16,STL,12,Home,-4,28
2008113006,2008,13,2008-11-30,Sunday,13:00,NO,20,TB,23,Home,3,43
2008113007,2008,13,2008-11-30,Sunday,13:00,NYG,23,WAS,7,Home,-16,30
2008113008,2008,13,2008-11-30,Sunday,16:05,ATL,22,SD,16,Home,-6,38
2008113009,2008,13,2008-11-30,Sunday,16:15,PIT,33,NE,10,Home,-23,43
2008113010,2008,13,2008-11-30,Sunday,16:15,KC,20,OAK,13,Home,-7,33
2008113011,2008,13,2008-11-30,Sunday,20:15,CHI,14,MIN,34,Home,20,48
2008120100,2008,13,2008-12-01,Monday,20:30,JAX,17,HOU,30,Home,13,47
2008120400,2008,14,2008-12-04,Thursday,20:15,OAK,7,SD,34,Home,27,41
2008120700,2008,14,2008-12-07,Sunday,20:15,WAS,10,BAL,24,Home,14,34
2008120701,2008,14,2008-12-07,Sunday,13:00,JAX,10,CHI,23,Home,13,33
2008120702,2008,14,2008-12-07,Sunday,13:00,MIN,20,DET,16,Home,-4,36
2008120703,2008,14,2008-12-07,Sunday,13:00,HOU,24,GB,21,Home,-3,45
2008120704,2008,14,2008-12-07,Sunday,13:00,CIN,3,IND,35,Home,32,38
2008120705,2008,14,2008-12-07,Sunday,13:00,ATL,25,NO,29,Home,4,54
2008120706,2008,14,2008-12-07,Sunday,13:00,PHI,20,NYG,14,Home,-6,34
2008120707,2008,14,2008-12-07,Sunday,13:00,CLE,9,TEN,28,Home,19,37
2008120708,2008,14,2008-12-07,Sunday,16:05,MIA,16,BUF,3,Neutral,-13,19
2008120709,2008,14,2008-12-07,Sunday,16:05,KC,17,DEN,24,Home,7,41
2008120710,2008,14,2008-12-07,Sunday,16:05,NYJ,14,SF,24,Home,10,38
2008120711,2008,14,2008-12-07,Sunday,16:15,STL,10,ARI,34,Home,24,44
2008120712,2008,14,2008-12-07,Sunday,16:15,DAL,13,PIT,20,Home,7,33
2008120713,2008,14,2008-12-07,Sunday,16:05,NE,24,SEA,21,Home,-3,45
2008120800,2008,14,2008-12-08,Monday,20:30,TB,23,CAR,38,Home,15,61
2008121100,2008,15,2008-12-11,Thursday,20:15,NO,24,CHI,27,Home,3,51
2008121400,2008,15,2008-12-14,Sunday,13:00,TB,10,ATL,13,Home,3,23
2008121401,2008,15,2008-12-14,Sunday,16:15,PIT,13,BAL,9,Home,-4,22
2008121402,2008,15,2008-12-14,Sunday,16:15,DEN,10,CAR,30,Home,20,40
2008121403,2008,15,2008-12-14,Sunday,13:00,WAS,13,CIN,20,Home,7,33
2008121404,2008,15,2008-12-14,Sunday,13:00,TEN,12,HOU,13,Home,1,25
2008121405,2008,15,2008-12-14,Sunday,13:00,DET,21,IND,31,Home,10,52
2008121406,2008,15,2008-12-14,Sunday,13:00,GB,16,JAX,20,Home,4,36
2008121407,2008,15,2008-12-14,Sunday,13:00,SD,22,KC,21,Home,-1,43
2008121408,2008,15,2008-12-14,Sunday,13:00,SF,9,MIA,14,Home,5,23
2008121409,2008,15,2008-12-14,Sunday,13:00,BUF,27,NYJ,31,Home,4,58
2008121410,2008,15,2008-12-14,Sunday,13:00,SEA,23,STL,20,Home,-3,43
2008121411,2008,15,2008-12-14,Sunday,16:05,MIN,35,ARI,14,Home,-21,49
2008121412,2008,15,2008-12-14,Sunday,16:15,NE,49,OAK,26,Home,-23,75
2008121413,2008,15,2008-12-14,Sunday,20:15,NYG,8,DAL,20,Home,12,28
2008121500,2008,15,2008-12-15,Monday,20:30,CLE,10,PHI,30,Home,20,40
2008121800,2008,16,2008-12-18,Thursday,20:15,IND,31,JAX,24,Home,-7,55
2008122000,2008,16,2008-12-20,Saturday,20:15,BAL,33,DAL,24,Home,-9,57
2008122100,2008,16,2008-12-21,Sunday,13:00,CIN,14,CLE,0,Home,-14,14
2008122101,2008,16,2008-12-21,Sunday,13:00,NO,42,DET,7,Home,-35,49
2008122102,2008,16,2008-12-21,Sunday,13:00,MIA,38,KC,31,Home,-7,69
2008122103,2008,16,2008-12-21,Sunday,16:15,ATL,24,MIN,17,Home,-7,41
2008122104,2008,16,2008-12-21,Sunday,13:00,ARI,7,NE,47,Home,40,54
2008122105,2008,16,2008-12-21,Sunday,20:15,CAR,28,NYG,34,Home,6,62
2008122106,2008,16,2008-12-21,Sunday,13:00,SF,17,STL,16,Home,-1,33
2008122107,2008,16,2008-12-21,Sunday,13:00,PIT,14,TEN,31,Home,17,45
2008122108,2008,16,2008-12-21,Sunday,16:15,PHI,3,WAS,10,Home,7,13
2008122109,2008,16,2008-12-21,Sunday,16:05,BUF,30,DEN,23,Home,-7,53
2008122110,2008,16,2008-12-21,Sunday,16:05,HOU,16,OAK,27,Home,11,43
2008122111,2008,16,2008-12-21,Sunday,16:05,NYJ,3,SEA,13,Home,10,16
2008122112,2008,16,2008-12-21,Sunday,13:00,SD,41,TB,24,Home,-17,65
2008122200,2008,16,2008-12-22,Monday,20:30,GB,17,CHI,20,Home,3,37
2008122800,2008,17,2008-12-28,Sunday,13:00,STL,27,ATL,31,Home,4,58
2008122801,2008,17,2008-12-28,Sunday,16:15,JAX,7,BAL,27,Home,20,34
2008122802,2008,17,2008-12-28,Sunday,13:00,NE,13,BUF,0,Home,-13,13
2008122803,2008,17,2008-12-28,Sunday,13:00,KC,6,CIN,16,Home,10,22
2008122804,2008,17,2008-12-28,Sunday,13:00,DET,21,GB,31,Home,10,52
2008122805,2008,17,2008-12-28,Sunday,13:00,CHI,24,HOU,31,Home,7,55
2008122806,2008,17,2008-12-28,Sunday,13:00,TEN,0,IND,23,Home,23,23
2008122807,2008,17,2008-12-28,Sunday,13:00,NYG,19,MIN,20,Home,1,39
2008122808,2008,17,2008-12-28,Sunday,13:00,CAR,33,NO,31,Home,-2,64
2008122809,2008,17,2008-12-28,Sunday,16:15,MIA,24,NYJ,17,Home,-7,41
2008122810,2008,17,2008-12-28,Sunday,16:15,DAL,6,PHI,44,Home,38,50
2008122811,2008,17,2008-12-28,Sunday,13:00,CLE,0,PIT,31,Home,31,31
2008122812,2008,17,2008-12-28,Sunday,13:00,OAK,31,TB,24,Home,-7,55
2008122813,2008,17,2008-12-28,Sunday,16:15,SEA,21,ARI,34,Home,13,55
2008122814,2008,17,2008-12-28,Sunday,20:15,DEN,21,SD,52,Home,31,73
2008122815,2008,17,2008-12-28,Sunday,16:15,WAS,24,SF,27,Home,3,51
2009010300,2008,18,2009-01-03,Saturday,16:30,ATL,24,ARI,30,Home,6,54
2009010301,2008,18,2009-01-03,Saturday,20:00,IND,17,SD,23,Home,6,40
2009010400,2008,18,2009-01-04,Sunday,13:00,BAL,27,MIA,9,Home,-18,36
2009010401,2008,18,2009-01-04,Sunday,16:30,PHI,26,MIN,14,Home,-12,40
2009011000,2008,19,2009-01-10,Saturday,16:30,BAL,13,TEN,10,Home,-3,23
2009011001,2008,19,2009-01-10,Saturday,20:15,ARI,33,CAR,13,Home,-20,46
2009011100,2008,19,2009-01-11,Sunday,16:45,SD,24,PIT,35,Home,11,59
2009011101,2008,19,2009-01-11,Sunday,13:00,PHI,23,NYG,11,Home,-12,34
2009011800,2008,20,2009-01-18,Sunday,16:05,PHI,25,ARI,32,Home,7,57
2009011801,2008,20,2009-01-18,Sunday,18:30,BAL,14,PIT,23,Home,9,37
2009020100,2008,21,2009-02-01,Sunday,18:31,PIT,27,ARI,23,Neutral,-4,50
2009091000,2009,1,2009-09-10,Thursday,20:30,TEN,10,PIT,13,Home,3,23
2009091300,2009,1,2009-09-13,Sunday,13:00,MIA,7,ATL,19,Home,12,26
2009091301,2009,1,2009-09-13,Sunday,13:00,KC,24,BAL,38,Home,14,62
2009091302,2009,1,2009-09-13,Sunday,13:00,PHI,38,CAR,10,Home,-28,48
2009091303,2009,1,2009-09-13,Sunday,13:00,DEN,12,CIN,7,Home,-5,19
2009091304,2009,1,2009-09-13,Sunday,13:00,MIN,34,CLE,20,Home,-14,54
2009091305,2009,1,2009-09-13,Sunday,13:00,NYJ,24,HOU,7,Home,-17,31
2009091306,2009,1,2009-09-13,Sunday,13:00,JAX,12,IND,14,Home,2,26
2009091307,2009,1,2009-09-13,Sunday,13:00,DET,27,NO,45,Home,18,72
2009091308,2009,1,2009-09-13,Sunday,13:00,DAL,34,TB,21,Home,-13,55
2009091309,2009,1,2009-09-13,Sunday,16:15,SF,20,ARI,16,Home,-4,36
2009091310,2009,1,2009-09-13,Sunday,16:15,WAS,17,NYG,23,Home,6,40
2009091311,2009,1,2009-09-13,Sunday,16:15,STL,0,SEA,28,Home,28,28
2009091312,2009,1,2009-09-13,Sunday,20:20,CHI,15,GB,21,Home,6,36
2009091400,2009,1,2009-09-14,Monday,19:00,BUF,24,NE,25,Home,1,49
2009091401,2009,1,2009-09-14,Monday,22:15,SD,24,OAK,20,Home,-4,44
2009092000,2009,2,2009-09-20,Sunday,13:00,CAR,20,ATL,28,Home,8,48
2009092001,2009,2,2009-09-20,Sunday,13:00,MIN,27,DET,13,Home,-14,40
2009092002,2009,2,2009-09-20,Sunday,13:00,CIN,31,GB,24,Home,-7,55
2009092003,2009,2,2009-09-20,Sunday,13:00,ARI,31,JAX,17,Home,-14,48
2009092004,2009,2,2009-09-20,Sunday,13:00,OAK,13,KC,10,Home,-3,23
2009092005,2009,2,2009-09-20,Sunday,13:00,NE,9,NYJ,16,Home,7,25
2009092006,2009,2,2009-09-20,Sunday,13:00,NO,48,PHI,22,Home,-26,70
2009092007,2009,2,2009-09-20,Sunday,13:00,HOU,34,TEN,31,Home,-3,65
2009092008,2009,2,2009-09-20,Sunday,13:00,STL,7,WAS,9,Home,2,16
2009092009,2009,2,2009-09-20,Sunday,16:05,TB,20,BUF,33,Home,13,53
2009092010,2009,2,2009-09-20,Sunday,16:05,SEA,10,SF,23,Home,13,33
2009092011,2009,2,2009-09-20,Sunday,16:15,PIT,14,CHI,17,Home,3,31
2009092012,2009,2,2009-09-20,Sunday,16:15,CLE,6,DEN,27,Home,21,33
2009092013,2009,2,2009-09-20,Sunday,16:15,BAL,31,SD,26,Home,-5,57
2009092014,2009,2,2009-09-20,Sunday,20:20,NYG,33,DAL,31,Home,-2,64
2009092100,2009,2,2009-09-21,Monday,20:30,IND,27,MIA,23,Home,-4,50
2009092700,2009,3,2009-09-27,Sunday,13:00,CLE,3,BAL,34,Home,31,37
2009092701,2009,3,2009-09-27,Sunday,16:15,PIT,20,CIN,23,Home,3,43
2009092702,2009,3,2009-09-27,Sunday,13:00,WAS,14,DET,19,Home,5,33
2009092703,2009,3,2009-09-27,Sunday,13:00,JAX,31,HOU,24,Home,-7,55
2009092704,2009,3,2009-09-27,Sunday,13:00,SF,24,MIN,27,Home,3,51
2009092705,2009,3,2009-09-27,Sunday,13:00,ATL,10,NE,26,Home,16,36
2009092706,2009,3,2009-09-27,Sunday,13:00,KC,14,PHI,34,Home,20,48
2009092707,2009,3,2009-09-27,Sunday,13:00,GB,36,STL,17,Home,-19,53
2009092708,2009,3,2009-09-27,Sunday,13:00,NYG,24,TB,0,Home,-24,24
2009092709,2009,3,2009-09-27,Sunday,16:05,NO,27,BUF,7,Home,-20,34
2009092710,2009,3,2009-09-27,Sunday,16:05,CHI,25,SEA,19,Home,-6,44
2009092711,2009,3,2009-09-27,Sunday,13:00,TEN,17,NYJ,24,Home,7,41
2009092712,2009,3,2009-09-27,Sunday,16:15,DEN,23,OAK,3,Home,-20,26
2009092713,2009,3,2009-09-27,Sunday,16:15,MIA,13,SD,23,Home,10,36
2009092714,2009,3,2009-09-27,Sunday,20:20,IND,31,ARI,10,Home,-21,41
2009092800,2009,3,2009-09-28,Monday,20:30,CAR,7,DAL,21,Home,14,28
2009100400,2009,4,2009-10-04,Sunday,13:00,DET,24,CHI,48,Home,24,72
2009100401,2009,4,2009-10-04,Sunday,13:00,CIN,23,CLE,20,Home,-3,43
2009100402,2009,4,2009-10-04,Sunday,13:00,OAK,6,HOU,29,Home,23,35
2009100403,2009,4,2009-10-04,Sunday,13:00,SEA,17,IND,34,Home,17,51
2009100404,2009,4,2009-10-04,Sunday,13:00,TEN,17,JAX,37,Home,20,54
2009100405,2009,4,2009-10-04,Sunday,13:00,NYG,27,KC,16,Home,-11,43
2009100406,2009,4,2009-10-04,Sunday,13:00,BAL,21,NE,27,Home,6,48
2009100407,2009,4,2009-10-04,Sunday,13:00,TB,13,WAS,16,Home,3,29
2009100408,2009,4,2009-10-04,Sunday,16:05,BUF,10,MIA,38,Home,28,48
2009100409,2009,4,2009-10-04,Sunday,16:05,NYJ,10,NO,24,Home,14,34
2009100410,2009,4,2009-10-04,Sunday,16:15,DAL,10,DEN,17,Home,7,27
2009100411,2009,4,2009-10-04,Sunday,16:15,STL,0,SF,35,Home,35,35
2009100412,2009,4,2009-10-04,Sunday,20:20,SD,28,PIT,38,Home,10,66
2009100500,2009,4,2009-10-05,Monday,20:30,GB,23,MIN,30,Home,7,53
2009101100,2009,5,2009-10-11,Sunday,13:00,CIN,17,BAL,14,Home,-3,31
2009101101,2009,5,2009-10-11,Sunday,13:00,CLE,6,BUF,3,Home,-3,9
2009101102,2009,5,2009-10-11,Sunday,13:00,WAS,17,CAR,20,Home,3,37
2009101103,2009,5,2009-10-11,Sunday,13:00,PIT,28,DET,20,Home,-8,48
2009101104,2009,5,2009-10-11,Sunday,13:00,DAL,26,KC,20,Home,-6,46
2009101105,2009,5,2009-10-11,Sunday,13:00,OAK,7,NYG,44,Home,37,51
2009101106,2009,5,2009-10-11,Sunday,13:00,TB,14,PHI,33,Home,19,47
2009101107,2009,5,2009-10-11,Sunday,13:00,MIN,38,STL,10,Home,-28,48
2009101108,2009,5,2009-10-11,Sunday,16:05,ATL,45,SF,10,Home,-35,55
2009101109,2009,5,2009-10-11,Sunday,16:15,HOU,21,ARI,28,Home,7,49
2009101110,2009,5,2009-10-11,Sunday,16:15,NE,17,DEN,20,Home,3,37
2009101111,2009,5,2009-10-11,Sunday,16:15,JAX,0,SEA,41,Home,41,41
2009101112,2009,5,2009-10-11,Sunday,20:20,IND,31,TEN,9,Home,-22,40
2009101200,2009,5,2009-10-12,Monday,20:30,NYJ,27,MIA,31,Home,4,58
2009101800,2009,6,2009-10-18,Sunday,13:00,HOU,28,CIN,17,Home,-11,45
2009101801,2009,6,2009-10-18,Sunday,13:00,DET,0,GB,26,Home,26,26
2009101802,2009,6,2009-10-18,Sunday,13:00,STL,20,JAX,23,Home,3,43
2009101803,2009,6,2009-10-18,Sunday,13:00,BAL,31,MIN,33,Home,2,64
2009101804,2009,6,2009-10-18,Sunday,13:00,NYG,27,NO,48,Home,21,75
2009101805,2009,6,2009-10-18,Sunday,13:00,CLE,14,PIT,27,Home,13,41
2009101806,2009,6,2009-10-18,Sunday,13:00,CAR,28,TB,21,Home,-7,49
2009101807,2009,6,2009-10-18,Sunday,13:00,KC,14,WAS,6,Home,-8,20
2009101808,2009,6,2009-10-18,Sunday,16:05,PHI,9,OAK,13,Home,4,22
2009101809,2009,6,2009-10-18,Sunday,16:05,ARI,27,SEA,3,Home,-24,30
2009101810,2009,6,2009-10-18,Sunday,16:15,TEN,0,NE,59,Home,59,59
2009101811,2009,6,2009-10-18,Sunday,16:15,BUF,16,NYJ,13,Home,-3,29
2009101812,2009,6,2009-10-18,Sunday,20:20,CHI,14,ATL,21,Home,7,35
2009101900,2009,6,2009-10-19,Monday,20:30,DEN,34,SD,23,Home,-11,57
2009102500,2009,7,2009-10-25,Sunday,16:15,CHI,10,CIN,45,Home,35,55
2009102501,2009,7,2009-10-25,Sunday,13:00,GB,31,CLE,3,Home,-28,34
2009102502,2009,7,2009-10-25,Sunday,13:00,SF,21,HOU,24,Home,3,45
2009102503,2009,7,2009-10-25,Sunday,13:00,SD,37,KC,7,Home,-30,44
2009102504,2009,7,2009-10-25,Sunday,13:00,MIN,17,PIT,27,Home,10,44
2009102505,2009,7,2009-10-25,Sunday,13:00,IND,42,STL,6,Home,-36,48
2009102506,2009,7,2009-10-25,Sunday,13:00,NE,35,TB,7,Neutral,-28,42
2009102507,2009,7,2009-10-25,Sunday,16:05,BUF,20,CAR,9,Home,-11,29
2009102508,2009,7,2009-10-25,Sunday,16:05,NYJ,38,OAK,0,Home,-38,38
2009102509,2009,7,2009-10-25,Sunday,16:15,ATL,21,DAL,37,Home,16,58
2009102510,2009,7,2009-10-25,Sunday,16:15,NO,46,MIA,34,Home,-12,80
2009102511,2009,7,2009-10-25,Sunday,20:20,ARI,24,NYG,17,Home,-7,41
2009102600,2009,7,2009-10-26,Monday,20:30,PHI,27,WAS,17,Home,-10,44
2009110100,2009,8,2009-11-01,Sunday,13:00,DEN,7,BAL,30,Home,23,37
2009110101,2009,8,2009-11-01,Sunday,13:00,HOU,31,BUF,10,Home,-21,41
2009110102,2009,8,2009-11-01,Sunday,13:00,CLE,6,CHI,30,Home,24,36
2009110103,2009,8,2009-11-01,Sunday,13:00,SEA,17,DAL,38,Home,21,55
2009110104,2009,8,2009-11-01,Sunday,13:00,STL,17,DET,10,Home,-7,27
2009110105,2009,8,2009-11-01,Sunday,16:15,MIN,38,GB,26,Home,-12,64
2009110106,2009,8,2009-11-01,Sunday,13:00,SF,14,IND,18,Home,4,32
2009110107,2009,8,2009-11-01,Sunday,13:00,MIA,30,NYJ,25,Home,-5,55
2009110108,2009,8,2009-11-01,Sunday,16:05,OAK,16,SD,24,Home,8,40
2009110109,2009,8,2009-11-01,Sunday,16:05,JAX,13,TEN,30,Home,17,43
2009110110,2009,8,2009-11-01,Sunday,16:15,CAR,34,ARI,21,Home,-13,55
2009110111,2009,8,2009-11-01,Sunday,13:00,NYG,17,PHI,40,Home,23,57
2009110200,2009,8,2009-11-02,Monday,20:30,ATL,27,NO,35,Home,8,62
2009110800,2009,9,2009-11-08,Sunday,13:00,WAS,17,ATL,31,Home,14,48
2009110801,2009,9,2009-11-08,Sunday,13:00,ARI,41,CHI,21,Home,-20,62
2009110802,2009,9,2009-11-08,Sunday,13:00,BAL,7,CIN,17,Home,10,24
2009110803,2009,9,2009-11-08,Sunday,13:00,HOU,17,IND,20,Home,3,37
2009110804,2009,9,2009-11-08,Sunday,13:00,KC,21,JAX,24,Home,3,45
2009110805,2009,9,2009-11-08,Sunday,13:00,MIA,17,NE,27,Home,10,44
2009110806,2009,9,2009-11-08,Sunday,13:00,GB,28,TB,38,Home,10,66
2009110807,2009,9,2009-11-08,Sunday,16:05,CAR,20,NO,30,Home,10,50
2009110808,2009,9,2009-11-08,Sunday,16:05,DET,20,SEA,32,Home,12,52
2009110809,2009,9,2009-11-08,Sunday,16:15,SD,21,NYG,20,Home,-1,41
2009110810,2009,9,2009-11-08,Sunday,16:15,TEN,34,SF,27,Home,-7,61
2009110811,2009,9,2009-11-08,Sunday,20:20,DAL,20,PHI,16,Home,-4,36
2009110900,2009,9,2009-11-09,Monday,20:30,PIT,28,DEN,10,Home,-18,38
2009111200,2009,10,2009-11-12,Thursday,20:20,CHI,6,SF,10,Home,4,16
2009111500,2009,10,2009-11-15,Sunday,13:00,ATL,19,CAR,28,Home,9,47
2009111501,2009,10,2009-11-15,Sunday,13:00,TB,23,MIA,25,Home,2,48
2009111502,2009,10,2009-11-15,Sunday,13:00,DET,10,MIN,27,Home,17,37
2009111503,2009,10,2009-11-15,Sunday,13:00,JAX,24,NYJ,22,Home,-2,46
2009111504,2009,10,2009-11-15,Sunday,13:00,CIN,18,PIT,12,Home,-6,30
2009111505,2009,10,2009-11-15,Sunday,13:00,NO,28,STL,23,Home,-5,51
2009111506,2009,10,2009-11-15,Sunday,13:00,BUF,17,TEN,41,Home,24,58
2009111507,2009,10,2009-11-15,Sunday,13:00,DEN,17,WAS,27,Home,10,44
2009111508,2009,10,2009-11-15,Sunday,16:05,KC,16,OAK,10,Home,-6,26
2009111509,2009,10,2009-11-15,Sunday,16:15,SEA,20,ARI,31,Home,11,51
2009111510,2009,10,2009-11-15,Sunday,16:15,DAL,7,GB,17,Home,10,24
2009111511,2009,10,2009-11-15,Sunday,16:15,PHI,23,SD,31,Home,8,54
2009111512,2009,10,2009-11-15,Sunday,20:20,NE,34,IND,35,Home,1,69
2009111600,2009,10,2009-11-16,Monday,20:30,BAL,16,CLE,0,Home,-16,16
2009111900,2009,11,2009-11-19,Thursday,20:20,MIA,24,CAR,17,Home,-7,41
2009112200,2009,11,2009-11-22,Sunday,13:00,IND,17,BAL,15,Home,-2,32
2009112201,2009,11,2009-11-22,Sunday,13:00,WAS,6,DAL,7,Home,1,13
2009112202,2009,11,2009-11-22,Sunday,13:00,CLE,37,DET,38,Home,1,75
2009112203,2009,11,2009-11-22,Sunday,13:00,SF,24,GB,30,Home,6,54
2009112204,2009,11,2009-11-22,Sunday,13:00,BUF,15,JAX,18,Home,3,33
2009112205,2009,11,2009-11-22,Sunday,13:00,PIT,24,KC,27,Home,3,51
2009112206,2009,11,2009-11-22,Sunday,13:00,SEA,9,MIN,35,Home,26,44
2009112207,2009,11,2009-11-22,Sunday,13:00,ATL,31,NYG,34,Home,3,65
2009112208,2009,11,2009-11-22,Sunday,13:00,NO,38,TB,7,Home,-31,45
2009112209,2009,11,2009-11-22,Sunday,16:05,ARI,21,STL,13,Home,-8,34
2009112210,2009,11,2009-11-22,Sunday,16:15,SD,32,DEN,3,Home,-29,35
2009112211,2009,11,2009-11-22,Sunday,16:15,NYJ,14,NE,31,Home,17,45
2009112212,2009,11,2009-11-22,Sunday,16:15,CIN,17,OAK,20,Home,3,37
2009112213,2009,11,2009-11-22,Sunday,20:20,PHI,24,CHI,20,Home,-4,44
2009112300,2009,11,2009-11-23,Monday,20:30,TEN,20,HOU,17,Home,-3,37
2009112600,2009,12,2009-11-26,Thursday,12:30,GB,34,DET,12,Home,-22,46
2009112601,2009,12,2009-11-26,Thursday,16:15,OAK,7,DAL,24,Home,17,31
2009112602,2009,12,2009-11-26,Thursday,20:20,NYG,6,DEN,26,Home,20,32
2009112900,2009,12,2009-11-29,Sunday,13:00,TB,17,ATL,20,Home,3,37
2009112901,2009,12,2009-11-29,Sunday,13:00,MIA,14,BUF,31,Home,17,45
2009112902,2009,12,2009-11-29,Sunday,13:00,CLE,7,CIN,16,Home,9,23
2009112903,2009,12,2009-11-29,Sunday,13:00,IND,35,HOU,27,Home,-8,62
2009112904,2009,12,2009-11-29,Sunday,16:15,CHI,10,MIN,36,Home,26,46
2009112905,2009,12,2009-11-29,Sunday,13:00,CAR,6,NYJ,17,Home,11,23
2009112906,2009,12,2009-11-29,Sunday,13:00,WAS,24,PHI,27,Home,3,51
2009112907,2009,12,2009-11-29,Sunday,13:00,SEA,27,STL,17,Home,-10,44
2009112908,2009,12,2009-11-29,Sunday,16:15,ARI,17,TEN,20,Home,3,37
2009112909,2009,12,2009-11-29,Sunday,16:05,KC,14,SD,43,Home,29,57
2009112910,2009,12,2009-11-29,Sunday,16:05,JAX,3,SF,20,Home,17,23
2009112911,2009,12,2009-11-29,Sunday,20:20,PIT,17,BAL,20,Home,3,37
2009113000,2009,12,2009-11-30,Monday,20:30,NE,17,NO,38,Home,21,55
2009120300,2009,13,2009-12-03,Thursday,20:20,NYJ,19,BUF,13,Home,-6,32
2009120600,2009,13,2009-12-06,Sunday,13:00,PHI,34,ATL,7,Home,-27,41
2009120601,2009,13,2009-12-06,Sunday,13:00,TB,6,CAR,16,Home,10,22
2009120602,2009,13,2009-12-06,Sunday,13:00,STL,9,CHI,17,Home,8,26
2009120603,2009,13,2009-12-06,Sunday,13:00,DET,13,CIN,23,Home,10,36
2009120604,2009,13,2009-12-06,Sunday,13:00,TEN,17,IND,27,Home,10,44
2009120605,2009,13,2009-12-06,Sunday,13:00,HOU,18,JAX,23,Home,5,41
2009120606,2009,13,2009-12-06,Sunday,13:00,DEN,44,KC,13,Home,-31,57
2009120607,2009,13,2009-12-06,Sunday,13:00,OAK,27,PIT,24,Home,-3,51
2009120608,2009,13,2009-12-06,Sunday,13:00,NO,33,WAS,30,Home,-3,63
2009120609,2009,13,2009-12-06,Sunday,16:05,SD,30,CLE,23,Home,-7,53
2009120610,2009,13,2009-12-06,Sunday,20:20,MIN,17,ARI,30,Home,13,47
2009120611,2009,13,2009-12-06,Sunday,16:15,DAL,24,NYG,31,Home,7,55
2009120612,2009,13,2009-12-06,Sunday,16:15,SF,17,SEA,20,Home,3,37
2009120613,2009,13,2009-12-06,Sunday,13:00,NE,21,MIA,22,Home,1,43
2009120700,2009,13,2009-12-07,Monday,20:30,BAL,14,GB,27,Home,13,41
2009121000,2009,14,2009-12-10,Thursday,20:20,PIT,6,CLE,13,Home,7,19
2009121300,2009,14,2009-12-13,Sunday,13:00,NO,26,ATL,23,Home,-3,49
2009121301,2009,14,2009-12-13,Sunday,13:00,DET,3,BAL,48,Home,45,51
2009121302,2009,14,2009-12-13,Sunday,13:00,GB,21,CHI,14,Home,-7,35
2009121303,2009,14,2009-12-13,Sunday,13:00,SEA,7,HOU,34,Home,27,41
2009121304,2009,14,2009-12-13,Sunday,13:00,DEN,16,IND,28,Home,12,44
2009121305,2009,14,2009-12-13,Sunday,13:00,MIA,14,JAX,10,Home,-4,24
2009121306,2009,14,2009-12-13,Sunday,13:00,BUF,16,KC,10,Home,-6,26
2009121307,2009,14,2009-12-13,Sunday,13:00,CIN,10,MIN,30,Home,20,40
2009121308,2009,14,2009-12-13,Sunday,13:00,CAR,10,NE,20,Home,10,30
2009121309,2009,14,2009-12-13,Sunday,13:00,NYJ,26,TB,3,Home,-23,29
2009121310,2009,14,2009-12-13,Sunday,16:05,STL,7,TEN,47,Home,40,54
2009121311,2009,14,2009-12-13,Sunday,16:05,WAS,34,OAK,13,Home,-21,47
2009121312,2009,14,2009-12-13,Sunday,16:15,SD,20,DAL,17,Home,-3,37
2009121313,2009,14,2009-12-13,Sunday,20:20,PHI,45,NYG,38,Home,-7,83
2009121400,2009,14,2009-12-14,Monday,20:30,ARI,9,SF,24,Home,15,33
2009121700,2009,15,2009-12-17,Thursday,20:20,IND,35,JAX,31,Home,-4,66
2009121900,2009,15,2009-12-19,Saturday,20:20,DAL,24,NO,17,Home,-7,41
2009122000,2009,15,2009-12-20,Sunday,16:15,CHI,7,BAL,31,Home,24,38
2009122001,2009,15,2009-12-20,Sunday,13:00,NE,17,BUF,10,Home,-7,27
2009122002,2009,15,2009-12-20,Sunday,13:00,ARI,31,DET,24,Home,-7,55
2009122003,2009,15,2009-12-20,Sunday,13:00,CLE,41,KC,34,Home,-7,75
2009122004,2009,15,2009-12-20,Sunday,13:00,ATL,10,NYJ,7,Home,-3,17
2009122005,2009,15,2009-12-20,Sunday,16:15,SF,13,PHI,27,Home,14,40
2009122006,2009,15,2009-12-20,Sunday,16:15,GB,36,PIT,37,Home,1,73
2009122007,2009,15,2009-12-20,Sunday,13:00,HOU,16,STL,13,Home,-3,29
2009122008,2009,15,2009-12-20,Sunday,13:00,MIA,24,TEN,27,Home,3,51
2009122009,2009,15,2009-12-20,Sunday,16:05,OAK,20,DEN,19,Home,-1,39
2009122010,2009,15,2009-12-20,Sunday,16:05,CIN,24,SD,27,Home,3,51
2009122011,2009,15,2009-12-20,Sunday,16:15,TB,24,SEA,7,Home,-17,31
2009122012,2009,15,2009-12-20,Sunday,20:20,MIN,7,CAR,26,Home,19,33
2009122100,2009,15,2009-12-21,Monday,20:30,NYG,45,WAS,12,Home,-33,57
2009122500,2009,16,2009-12-25,Friday,19:30,SD,42,TEN,17,Home,-25,59
2009122700,2009,16,2009-12-27,Sunday,13:00,BUF,3,ATL,31,Home,28,34
2009122701,2009,16,2009-12-27,Sunday,13:00,KC,10,CIN,17,Home,7,27
2009122702,2009,16,2009-12-27,Sunday,13:00,OAK,9,CLE,23,Home,14,32
2009122703,2009,16,2009-12-27,Sunday,13:00,SEA,10,GB,48,Home,38,58
2009122704,2009,16,2009-12-27,Sunday,13:00,HOU,27,MIA,20,Home,-7,47
2009122705,2009,16,2009-12-27,Sunday,13:00,CAR,41,NYG,9,Home,-32,50
2009122706,2009,16,2009-12-27,Sunday,13:00,JAX,7,NE,35,Home,28,42
2009122707,2009,16,2009-12-27,Sunday,13:00,TB,20,NO,17,Home,-3,37
2009122708,2009,16,2009-12-27,Sunday,16:15,DEN,27,PHI,30,Home,3,57
2009122709,2009,16,2009-12-27,Sunday,13:00,BAL,20,PIT,23,Home,3,43
2009122710,2009,16,2009-12-27,Sunday,16:05,STL,10,ARI,31,Home,21,41
2009122711,2009,16,2009-12-27,Sunday,16:05,DET,6,SF,20,Home,14,26
2009122712,2009,16,2009-12-27,Sunday,16:15,NYJ,29,IND,15,Home,-14,44
2009122713,2009,16,2009-12-27,Sunday,20:20,DAL,17,WAS,0,Home,-17,17
2009122800,2009,16,2009-12-28,Monday,20:30,MIN,30,CHI,36,Home,6,66
2010010300,2009,17,2010-01-03,Sunday,13:00,IND,9,BUF,30,Home,21,39
2010010301,2009,17,2010-01-03,Sunday,13:00,NO,10,CAR,23,Home,13,33
2010010302,2009,17,2010-01-03,Sunday,13:00,JAX,17,CLE,23,Home,6,40
2010010303,2009,17,2010-01-03,Sunday,16:15,PHI,0,DAL,24,Home,24,24
2010010304,2009,17,2010-01-03,Sunday,13:00,CHI,37,DET,23,Home,-14,60
2010010305,2009,17,2010-01-03,Sunday,13:00,NE,27,HOU,34,Home,7,61
2010010306,2009,17,2010-01-03,Sunday,13:00,PIT,30,MIA,24,Home,-6,54
2010010307,2009,17,2010-01-03,Sunday,13:00,NYG,7,MIN,44,Home,37,51
2010010308,2009,17,2010-01-03,Sunday,20:20,CIN,0,NYJ,37,Home,37,37
2010010309,2009,17,2010-01-03,Sunday,13:00,SF,28,STL,6,Home,-22,34
2010010310,2009,17,2010-01-03,Sunday,13:00,ATL,20,TB,10,Home,-10,30
2010010311,2009,17,2010-01-03,Sunday,16:15,GB,33,ARI,7,Home,-26,40
2010010312,2009,17,2010-01-03,Sunday,16:15,KC,44,DEN,24,Home,-20,68
2010010313,2009,17,2010-01-03,Sunday,16:15,BAL,21,OAK,13,Home,-8,34
2010010314,2009,17,2010-01-03,Sunday,16:15,WAS,20,SD,23,Home,3,43
2010010315,2009,17,2010-01-03,Sunday,16:15,TEN,17,SEA,13,Home,-4,30
2010010900,2009,18,2010-01-09,Saturday,20:00,PHI,14,DAL,34,Home,20,48
2010010901,2009,18,2010-01-09,Saturday,16:30,NYJ,24,CIN,14,Home,-10,38
2010011000,2009,18,2010-01-10,Sunday,16:30,GB,45,ARI,51,Home,6,96
2010011001,2009,18,2010-01-10,Sunday,13:00,BAL,33,NE,14,Home,-19,47
2010011600,2009,19,2010-01-16,Saturday,20:15,BAL,3,IND,20,Home,17,23
2010011601,2009,19,2010-01-16,Saturday,16:30,ARI,14,NO,45,Home,31,59
2010011700,2009,19,2010-01-17,Sunday,13:00,DAL,3,MIN,34,Home,31,37
2010011701,2009,19,2010-01-17,Sunday,16:40,NYJ,17,SD,14,Home,-3,31
2010012400,2009,20,2010-01-24,Sunday,15:05,NYJ,17,IND,30,Home,13,47
2010012401,2009,20,2010-01-24,Sunday,18:40,MIN,28,NO,31,Home,3,59
2010020700,2009,21,2010-02-07,Sunday,18:32,NO,31,IND,17,Neutral,-14,48
2010090900,2010,1,2010-09-09,Thursday,20:30,MIN,9,NO,14,Home,5,23
2010091200,2010,1,2010-09-12,Sunday,13:00,CLE,14,TB,17,Home,3,31
2010091201,2010,1,2010-09-12,Sunday,13:00,MIA,15,BUF,10,Home,-5,25
2010091202,2010,1,2010-09-12,Sunday,13:00,CIN,24,NE,38,Home,14,62
2010091203,2010,1,2010-09-12,Sunday,13:00,IND,24,HOU,34,Home,10,58
2010091204,2010,1,2010-09-12,Sunday,13:00,DEN,17,JAX,24,Home,7,41
2010091205,2010,1,2010-09-12,Sunday,13:00,OAK,13,TEN,38,Home,25,51
2010091206,2010,1,2010-09-12,Sunday,13:00,CAR,18,NYG,31,Home,13,49
2010091207,2010,1,2010-09-12,Sunday,13:00,DET,14,CHI,19,Home,5,33
2010091208,2010,1,2010-09-12,Sunday,16:15,ARI,17,STL,13,Home,-4,30
2010091209,2010,1,2010-09-12,Sunday,13:00,ATL,9,PIT,15,Home,6,24
2010091210,2010,1,2010-09-12,Sunday,16:15,GB,27,PHI,20,Home,-7,47
2010091211,2010,1,2010-09-12,Sunday,16:15,SF,6,SEA,31,Home,25,37
2010091212,2010,1,2010-09-12,Sunday,20:20,DAL,7,WAS,13,Home,6,20
2010091300,2010,1,2010-09-13,Monday,19:00,BAL,10,NYJ,9,Home,-1,19
2010091301,2010,1,2010-09-13,Monday,22:15,SD,14,KC,21,Home,7,35
2010091900,2010,2,2010-09-19,Sunday,16:15,HOU,30,WAS,27,Home,-3,57
2010091901,2010,2,2010-09-19,Sunday,13:00,BUF,7,GB,34,Home,27,41
2010091902,2010,2,2010-09-19,Sunday,13:00,MIA,14,MIN,10,Home,-4,24
2010091903,2010,2,2010-09-19,Sunday,13:00,KC,16,CLE,14,Home,-2,30
2010091904,2010,2,2010-09-19,Sunday,13:00,PIT,19,TEN,11,Home,-8,30
2010091905,2010,2,2010-09-19,Sunday,13:00,CHI,27,DAL,20,Home,-7,47
2010091906,2010,2,2010-09-19,Sunday,13:00,PHI,35,DET,32,Home,-3,67
2010091907,2010,2,2010-09-19,Sunday,13:00,ARI,7,ATL,41,Home,34,48
2010091908,2010,2,2010-09-19,Sunday,13:00,TB,20,CAR,7,Home,-13,27
2010091909,2010,2,2010-09-19,Sunday,16:05,SEA,14,DEN,31,Home,17,45
2010091910,2010,2,2010-09-19,Sunday,16:05,STL,14,OAK,16,Home,2,30
2010091911,2010,2,2010-09-19,Sunday,16:15,NE,14,NYJ,28,Home,14,42
2010091912,2010,2,2010-09-19,Sunday,13:00,BAL,10,CIN,15,Home,5,25
2010091913,2010,2,2010-09-19,Sunday,16:15,JAX,13,SD,38,Home,25,51
2010091914,2010,2,2010-09-19,Sunday,20:20,NYG,14,IND,38,Home,24,52
2010092000,2010,2,2010-09-20,Monday,20:30,NO,25,SF,22,Home,-3,47
2010092600,2010,3,2010-09-26,Sunday,13:00,TEN,29,NYG,10,Home,-19,39
2010092601,2010,3,2010-09-26,Sunday,13:00,CIN,20,CAR,7,Home,-13,27
2010092602,2010,3,2010-09-26,Sunday,13:00,PIT,38,TB,13,Home,-25,51
2010092603,2010,3,2010-09-26,Sunday,13:00,BUF,30,NE,38,Home,8,68
2010092604,2010,3,2010-09-26,Sunday,13:00,CLE,17,BAL,24,Home,7,41
2010092605,2010,3,2010-09-26,Sunday,13:00,DET,10,MIN,24,Home,14,34
2010092606,2010,3,2010-09-26,Sunday,13:00,ATL,27,NO,24,Home,-3,51
2010092607,2010,3,2010-09-26,Sunday,16:05,WAS,16,STL,30,Home,14,46
2010092608,2010,3,2010-09-26,Sunday,13:00,DAL,27,HOU,13,Home,-14,40
2010092609,2010,3,2010-09-26,Sunday,13:00,SF,10,KC,31,Home,21,41
2010092610,2010,3,2010-09-26,Sunday,16:05,PHI,28,JAX,3,Home,-25,31
2010092611,2010,3,2010-09-26,Sunday,16:15,IND,27,DEN,13,Home,-14,40
2010092612,2010,3,2010-09-26,Sunday,16:15,OAK,23,ARI,24,Home,1,47
2010092613,2010,3,2010-09-26,Sunday,16:15,SD,20,SEA,27,Home,7,47
2010092614,2010,3,2010-09-26,Sunday,20:20,NYJ,31,MIA,23,Home,-8,54
2010092700,2010,3,2010-09-27,Monday,20:30,GB,17,CHI,20,Home,3,37
2010100300,2010,4,2010-10-03,Sunday,13:00,NYJ,38,BUF,14,Home,-24,52
2010100301,2010,4,2010-10-03,Sunday,13:00,CIN,20,CLE,23,Home,3,43
2010100302,2010,4,2010-10-03,Sunday,13:00,BAL,17,PIT,14,Home,-3,31
2010100303,2010,4,2010-10-03,Sunday,13:00,DEN,26,TEN,20,Home,-6,46
2010100304,2010,4,2010-10-03,Sunday,13:00,DET,26,GB,28,Home,2,54
2010100305,2010,4,2010-10-03,Sunday,13:00,SF,14,ATL,16,Home,2,30
2010100306,2010,4,2010-10-03,Sunday,13:00,CAR,14,NO,16,Home,2,30
2010100307,2010,4,2010-10-03,Sunday,13:00,SEA,3,STL,20,Home,17,23
2010100308,2010,4,2010-10-03,Sunday,16:05,IND,28,JAX,31,Home,3,59
2010100309,2010,4,2010-10-03,Sunday,16:05,HOU,31,OAK,24,Home,-7,55
2010100310,2010,4,2010-10-03,Sunday,16:15,WAS,17,PHI,12,Home,-5,29
2010100311,2010,4,2010-10-03,Sunday,16:15,ARI,10,SD,41,Home,31,51
2010100312,2010,4,2010-10-03,Sunday,20:20,CHI,3,NYG,17,Home,14,20
2010100400,2010,4,2010-10-04,Monday,20:30,NE,41,MIA,14,Home,-27,55
2010101000,2010,5,2010-10-10,Sunday,13:00,JAX,36,BUF,26,Home,-10,62
2010101001,2010,5,2010-10-10,Sunday,13:00,DEN,17,BAL,31,Home,14,48
2010101002,2010,5,2010-10-10,Sunday,13:00,KC,9,IND,19,Home,10,28
2010101003,2010,5,2010-10-10,Sunday,13:00,GB,13,WAS,16,Home,3,29
2010101004,2010,5,2010-10-10,Sunday,13:00,STL,6,DET,44,Home,38,50
2010101005,2010,5,2010-10-10,Sunday,13:00,CHI,23,CAR,6,Home,-17,29
2010101006,2010,5,2010-10-10,Sunday,13:00,TB,24,CIN,21,Home,-3,45
2010101007,2010,5,2010-10-10,Sunday,13:00,ATL,20,CLE,10,Home,-10,30
2010101008,2010,5,2010-10-10,Sunday,13:00,NYG,34,HOU,10,Home,-24,44
2010101009,2010,5,2010-10-10,Sunday,16:05,NO,20,ARI,30,Home,10,50
2010101010,2010,5,2010-10-10,Sunday,16:15,TEN,34,DAL,27,Home,-7,61
2010101011,2010,5,2010-10-10,Sunday,16:15,SD,27,OAK,35,Home,8,62
2010101012,2010,5,2010-10-10,Sunday,20:20,PHI,27,SF,24,Home,-3,51
2010101100,2010,5,2010-10-11,Monday,21:15,MIN,20,NYJ,29,Home,9,49
2010101700,2010,6,2010-10-17,Sunday,13:00,MIA,23,GB,20,Home,-3,43
2010101701,2010,6,2010-10-17,Sunday,13:00,SD,17,STL,20,Home,3,37
2010101702,2010,6,2010-10-17,Sunday,13:00,BAL,20,NE,23,Home,3,43
2010101703,2010,6,2010-10-17,Sunday,13:00,CLE,10,PIT,28,Home,18,38
2010101704,2010,6,2010-10-17,Sunday,13:00,KC,31,HOU,35,Home,4,66
2010101705,2010,6,2010-10-17,Sunday,13:00,DET,20,NYG,28,Home,8,48
2010101706,2010,6,2010-10-17,Sunday,13:00,ATL,17,PHI,31,Home,14,48
2010101707,2010,6,2010-10-17,Sunday,13:00,SEA,23,CHI,20,Home,-3,43
2010101708,2010,6,2010-10-17,Sunday,13:00,NO,31,TB,6,Home,-25,37
2010101709,2010,6,2010-10-17,Sunday,16:05,NYJ,24,DEN,20,Home,-4,44
2010101710,2010,6,2010-10-17,Sunday,16:05,OAK,9,SF,17,Home,8,26
2010101711,2010,6,2010-10-17,Sunday,16:15,DAL,21,MIN,24,Home,3,45
2010101712,2010,6,2010-10-17,Sunday,20:20,IND,27,WAS,24,Home,-3,51
2010101800,2010,6,2010-10-18,Monday,20:30,TEN,30,JAX,3,Home,-27,33
2010102400,2010,7,2010-10-24,Sunday,13:00,CIN,32,ATL,39,Home,7,71
2010102401,2010,7,2010-10-24,Sunday,13:00,PIT,23,MIA,22,Home,-1,45
2010102402,2010,7,2010-10-24,Sunday,13:00,BUF,34,BAL,37,Home,3,71
2010102403,2010,7,2010-10-24,Sunday,13:00,JAX,20,KC,42,Home,22,62
2010102404,2010,7,2010-10-24,Sunday,13:00,CLE,30,NO,17,Home,-13,47
2010102405,2010,7,2010-10-24,Sunday,13:00,WAS,17,CHI,14,Home,-3,31
2010102406,2010,7,2010-10-24,Sunday,13:00,SF,20,CAR,23,Home,3,43
2010102407,2010,7,2010-10-24,Sunday,13:00,STL,17,TB,18,Home,1,35
2010102408,2010,7,2010-10-24,Sunday,13:00,PHI,19,TEN,37,Home,18,56
2010102409,2010,7,2010-10-24,Sunday,16:05,ARI,10,SEA,22,Home,12,32
2010102410,2010,7,2010-10-24,Sunday,16:15,NE,23,SD,20,Home,-3,43
2010102411,2010,7,2010-10-24,Sunday,16:15,OAK,59,DEN,14,Home,-45,73
2010102412,2010,7,2010-10-24,Sunday,20:20,MIN,24,GB,28,Home,4,52
2010102500,2010,7,2010-10-25,Monday,20:30,NYG,41,DAL,35,Home,-6,76
2010103100,2010,8,2010-10-31,Sunday,13:00,DEN,16,SF,24,Neutral,8,40
2010103101,2010,8,2010-10-31,Sunday,13:00,JAX,35,DAL,17,Home,-18,52
2010103102,2010,8,2010-10-31,Sunday,13:00,MIA,22,CIN,14,Home,-8,36
2010103103,2010,8,2010-10-31,Sunday,13:00,BUF,10,KC,13,Home,3,23
2010103104,2010,8,2010-10-31,Sunday,13:00,WAS,25,DET,37,Home,12,62
2010103105,2010,8,2010-10-31,Sunday,13:00,CAR,10,STL,20,Home,10,30
2010103106,2010,8,2010-10-31,Sunday,13:00,GB,9,NYJ,0,Home,-9,9
2010103107,2010,8,2010-10-31,Sunday,16:05,TEN,25,SD,33,Home,8,58
2010103108,2010,8,2010-10-31,Sunday,16:15,MIN,18,NE,28,Home,10,46
2010103109,2010,8,2010-10-31,Sunday,16:15,TB,38,ARI,35,Home,-3,73
2010103110,2010,8,2010-10-31,Sunday,16:15,SEA,3,OAK,33,Home,30,36
2010103111,2010,8,2010-10-31,Sunday,20:20,PIT,10,NO,20,Home,10,30
2010110100,2010,8,2010-11-01,Monday,20:30,HOU,17,IND,30,Home,13,47
2010110700,2010,9,2010-11-07,Sunday,13:00,NYJ,23,DET,20,Home,-3,43
2010110701,2010,9,2010-11-07,Sunday,13:00,MIA,10,BAL,26,Home,16,36
2010110702,2010,9,2010-11-07,Sunday,13:00,NE,14,CLE,34,Home,20,48
2010110703,2010,9,2010-11-07,Sunday,13:00,SD,29,HOU,23,Home,-6,52
2010110704,2010,9,2010-11-07,Sunday,13:00,CHI,22,BUF,19,Home,-3,41
2010110705,2010,9,2010-11-07,Sunday,13:00,ARI,24,MIN,27,Home,3,51
2010110706,2010,9,2010-11-07,Sunday,13:00,TB,21,ATL,27,Home,6,48
2010110707,2010,9,2010-11-07,Sunday,13:00,NO,34,CAR,3,Home,-31,37
2010110708,2010,9,2010-11-07,Sunday,16:05,NYG,41,SEA,7,Home,-34,48
2010110709,2010,9,2010-11-07,Sunday,16:15,IND,24,PHI,26,Home,2,50
2010110710,2010,9,2010-11-07,Sunday,16:15,KC,20,OAK,23,Home,3,43
2010110711,2010,9,2010-11-07,Sunday,20:20,DAL,7,GB,45,Home,38,52
2010110800,2010,9,2010-11-08,Monday,20:30,PIT,27,CIN,21,Home,-6,48
2010111100,2010,10,2010-11-11,Thursday,20:20,BAL,21,ATL,26,Home,5,47
2010111400,2010,10,2010-11-14,Sunday,13:00,TEN,17,MIA,29,Home,12,46
2010111401,2010,10,2010-11-14,Sunday,13:00,NYJ,26,CLE,20,Home,-6,46
2010111402,2010,10,2010-11-14,Sunday,13:00,CIN,17,IND,23,Home,6,40
2010111403,2010,10,2010-11-14,Sunday,13:00,HOU,24,JAX,31,Home,7,55
2010111404,2010,10,2010-11-14,Sunday,13:00,MIN,13,CHI,27,Home,14,40
2010111405,2010,10,2010-11-14,Sunday,13:00,CAR,16,TB,31,Home,15,47
2010111406,2010,10,2010-11-14,Sunday,13:00,DET,12,BUF,14,Home,2,26
2010111407,2010,10,2010-11-14,Sunday,16:05,KC,29,DEN,49,Home,20,78
2010111408,2010,10,2010-11-14,Sunday,16:15,DAL,33,NYG,20,Home,-13,53
2010111409,2010,10,2010-11-14,Sunday,16:15,SEA,36,ARI,18,Home,-18,54
2010111410,2010,10,2010-11-14,Sunday,16:15,STL,20,SF,23,Home,3,43
2010111411,2010,10,2010-11-14,Sunday,20:20,NE,39,PIT,26,Home,-13,65
2010111500,2010,10,2010-11-15,Monday,20:30,PHI,59,WAS,28,Home,-31,87
2010111800,2010,11,2010-11-18,Thursday,20:20,CHI,16,MIA,0,Home,-16,16
2010112100,2010,11,2010-11-21,Sunday,13:00,BAL,37,CAR,13,Home,-24,50
2010112101,2010,11,2010-11-21,Sunday,13:00,HOU,27,NYJ,30,Home,3,57
2010112102,2010,11,2010-11-21,Sunday,13:00,BUF,49,CIN,31,Home,-18,80
2010112103,2010,11,2010-11-21,Sunday,13:00,OAK,3,PIT,35,Home,32,38
2010112104,2010,11,2010-11-21,Sunday,13:00,CLE,20,JAX,24,Home,4,44
2010112105,2010,11,2010-11-21,Sunday,13:00,DET,19,DAL,35,Home,16,54
2010112106,2010,11,2010-11-21,Sunday,13:00,GB,31,MIN,3,Home,-28,34
2010112107,2010,11,2010-11-21,Sunday,16:05,SEA,19,NO,34,Home,15,53
2010112108,2010,11,2010-11-21,Sunday,13:00,WAS,19,TEN,16,Home,-3,35
2010112109,2010,11,2010-11-21,Sunday,13:00,ARI,13,KC,31,Home,18,44
2010112110,2010,11,2010-11-21,Sunday,16:05,ATL,34,STL,17,Home,-17,51
2010112111,2010,11,2010-11-21,Sunday,16:05,TB,21,SF,0,Home,-21,21
2010112112,2010,11,2010-11-21,Sunday,16:15,IND,28,NE,31,Home,3,59
2010112113,2010,11,2010-11-21,Sunday,20:20,NYG,17,PHI,27,Home,10,44
2010112200,2010,11,2010-11-22,Monday,20:30,DEN,14,SD,35,Home,21,49
2010112500,2010,12,2010-11-25,Thursday,12:30,NE,45,DET,24,Home,-21,69
2010112501,2010,12,2010-11-25,Thursday,16:15,NO,30,DAL,27,Home,-3,57
2010112502,2010,12,2010-11-25,Thursday,20:20,CIN,10,NYJ,26,Home,16,36
2010112800,2010,12,2010-11-28,Sunday,13:00,JAX,20,NYG,24,Home,4,44
2010112801,2010,12,2010-11-28,Sunday,13:00,PIT,19,BUF,16,Home,-3,35
2010112802,2010,12,2010-11-28,Sunday,13:00,TEN,0,HOU,20,Home,20,20
2010112803,2010,12,2010-11-28,Sunday,13:00,MIN,17,WAS,13,Home,-4,30
2010112804,2010,12,2010-11-28,Sunday,16:15,PHI,26,CHI,31,Home,5,57
2010112805,2010,12,2010-11-28,Sunday,13:00,GB,17,ATL,20,Home,3,37
2010112806,2010,12,2010-11-28,Sunday,16:15,TB,10,BAL,17,Home,7,27
2010112807,2010,12,2010-11-28,Sunday,13:00,CAR,23,CLE,24,Home,1,47
2010112808,2010,12,2010-11-28,Sunday,16:05,KC,42,SEA,24,Home,-18,66
2010112809,2010,12,2010-11-28,Sunday,16:05,MIA,33,OAK,17,Home,-16,50
2010112810,2010,12,2010-11-28,Sunday,16:15,STL,36,DEN,33,Home,-3,69
2010112811,2010,12,2010-11-28,Sunday,20:20,SD,36,IND,14,Home,-22,50
2010112900,2010,12,2010-11-29,Monday,20:30,SF,27,ARI,6,Home,-21,33
2010120200,2010,13,2010-12-02,Thursday,20:20,HOU,24,PHI,34,Home,10,58
2010120500,2010,13,2010-12-05,Sunday,13:00,BUF,14,MIN,38,Home,24,52
2010120501,2010,13,2010-12-05,Sunday,13:00,CLE,13,MIA,10,Home,-3,23
2010120502,2010,13,2010-12-05,Sunday,13:00,JAX,17,TEN,6,Home,-11,23
2010120503,2010,13,2010-12-05,Sunday,13:00,DEN,6,KC,10,Home,4,16
2010120504,2010,13,2010-12-05,Sunday,13:00,WAS,7,NYG,31,Home,24,38
2010120505,2010,13,2010-12-05,Sunday,13:00,CHI,24,DET,20,Home,-4,44
2010120506,2010,13,2010-12-05,Sunday,13:00,SF,16,GB,34,Home,18,50
2010120507,2010,13,2010-12-05,Sunday,16:15,ATL,28,TB,24,Home,-4,52
2010120508,2010,13,2010-12-05,Sunday,13:00,NO,34,CIN,30,Home,-4,64
2010120509,2010,13,2010-12-05,Sunday,16:05,OAK,28,SD,13,Home,-15,41
2010120510,2010,13,2010-12-05,Sunday,16:15,DAL,38,IND,35,Home,-3,73
2010120511,2010,13,2010-12-05,Sunday,16:15,STL,19,ARI,6,Home,-13,25
2010120512,2010,13,2010-12-05,Sunday,16:15,CAR,14,SEA,31,Home,17,45
2010120513,2010,13,2010-12-05,Sunday,20:20,PIT,13,BAL,10,Home,-3,23
2010120600,2010,13,2010-12-06,Monday,20:30,NYJ,3,NE,45,Home,42,48
2010120900,2010,14,2010-12-09,Thursday,20:20,IND,30,TEN,28,Home,-2,58
2010121200,2010,14,2010-12-12,Sunday,16:15,NE,36,CHI,7,Home,-29,43
2010121201,2010,14,2010-12-12,Sunday,13:00,CLE,6,BUF,13,Home,7,19
2010121202,2010,14,2010-12-12,Sunday,13:00,CIN,7,PIT,23,Home,16,30
2010121203,2010,14,2010-12-12,Sunday,13:00,OAK,31,JAX,38,Home,7,69
2010121204,2010,14,2010-12-12,Sunday,13:00,TB,17,WAS,16,Home,-1,33
2010121205,2010,14,2010-12-12,Sunday,13:00,GB,3,DET,7,Home,4,10
2010121207,2010,14,2010-12-12,Sunday,13:00,ATL,31,CAR,10,Home,-21,41
2010121208,2010,14,2010-12-12,Sunday,16:05,STL,13,NO,31,Home,18,44
2010121209,2010,14,2010-12-12,Sunday,16:05,SEA,21,SF,40,Home,19,61
2010121210,2010,14,2010-12-12,Sunday,16:15,MIA,10,NYJ,6,Home,-4,16
2010121211,2010,14,2010-12-12,Sunday,16:15,DEN,13,ARI,43,Home,30,56
2010121212,2010,14,2010-12-12,Sunday,16:15,KC,0,SD,31,Home,31,31
2010121213,2010,14,2010-12-12,Sunday,20:20,PHI,30,DAL,27,Home,-3,57
2010121300,2010,14,2010-12-13,Monday,20:30,BAL,34,HOU,28,Home,-6,62
2010121301,2010,14,2010-12-13,Monday,19:20,NYG,21,MIN,3,Neutral,-18,24
2010121600,2010,15,2010-12-16,Thursday,20:20,SF,7,SD,34,Home,27,41
2010121900,2010,15,2010-12-19,Sunday,13:00,KC,27,STL,13,Home,-14,40
2010121901,2010,15,2010-12-19,Sunday,13:00,BUF,17,MIA,14,Home,-3,31
2010121902,2010,15,2010-12-19,Sunday,13:00,CLE,17,CIN,19,Home,2,36
2010121903,2010,15,2010-12-19,Sunday,13:00,JAX,24,IND,34,Home,10,58
2010121904,2010,15,2010-12-19,Sunday,13:00,HOU,17,TEN,31,Home,14,48
2010121905,2010,15,2010-12-19,Sunday,13:00,WAS,30,DAL,33,Home,3,63
2010121906,2010,15,2010-12-19,Sunday,13:00,PHI,38,NYG,31,Home,-7,69
2010121907,2010,15,2010-12-19,Sunday,13:00,ARI,12,CAR,19,Home,7,31
2010121908,2010,15,2010-12-19,Sunday,13:00,DET,23,TB,20,Home,-3,43
2010121909,2010,15,2010-12-19,Sunday,13:00,NO,24,BAL,30,Home,6,54
2010121910,2010,15,2010-12-19,Sunday,16:05,ATL,34,SEA,18,Home,-16,52
2010121911,2010,15,2010-12-19,Sunday,16:15,NYJ,22,PIT,17,Home,-5,39
2010121912,2010,15,2010-12-19,Sunday,16:15,DEN,23,OAK,39,Home,16,62
2010121913,2010,15,2010-12-19,Sunday,20:20,GB,27,NE,31,Home,4,58
2010122000,2010,15,2010-12-20,Monday,20:30,CHI,40,MIN,14,Home,-26,54
2010122300,2010,16,2010-12-23,Thursday,20:20,CAR,3,PIT,27,Home,24,30
2010122500,2010,16,2010-12-25,Saturday,19:30,DAL,26,ARI,27,Home,1,53
2010122600,2010,16,2010-12-26,Sunday,13:00,NYJ,34,CHI,38,Home,4,72
2010122601,2010,16,2010-12-26,Sunday,13:00,NE,34,BUF,3,Home,-31,37
2010122602,2010,16,2010-12-26,Sunday,13:00,BAL,20,CLE,10,Home,-10,30
2010122603,2010,16,2010-12-26,Sunday,13:00,TEN,14,KC,34,Home,20,48
2010122605,2010,16,2010-12-26,Sunday,16:15,SEA,15,TB,38,Home,23,53
2010122606,2010,16,2010-12-26,Sunday,13:00,SF,17,STL,25,Home,8,42
2010122607,2010,16,2010-12-26,Sunday,13:00,DET,34,MIA,27,Home,-7,61
2010122608,2010,16,2010-12-26,Sunday,13:00,WAS,20,JAX,17,Home,-3,37
2010122609,2010,16,2010-12-26,Sunday,16:05,HOU,23,DEN,24,Home,1,47
2010122610,2010,16,2010-12-26,Sunday,16:05,IND,31,OAK,26,Home,-5,57
2010122611,2010,16,2010-12-26,Sunday,16:15,NYG,17,GB,45,Home,28,62
2010122612,2010,16,2010-12-26,Sunday,16:05,SD,20,CIN,34,Home,14,54
2010122700,2010,16,2010-12-27,Monday,20:30,NO,17,ATL,14,Home,-3,31
2010122800,2010,16,2010-12-28,Tuesday,20:00,MIN,24,PHI,14,Home,-10,38
2011010200,2010,17,2011-01-02,Sunday,13:00,MIA,7,NE,38,Home,31,45
2011010201,2010,17,2011-01-02,Sunday,13:00,BUF,7,NYJ,38,Home,31,45
2011010202,2010,17,2011-01-02,Sunday,13:00,CIN,7,BAL,13,Home,6,20
2011010203,2010,17,2011-01-02,Sunday,13:00,PIT,41,CLE,9,Home,-32,50
2011010204,2010,17,2011-01-02,Sunday,16:15,JAX,17,HOU,34,Home,17,51
2011010205,2010,17,2011-01-02,Sunday,16:15,TEN,20,IND,23,Home,3,43
2011010206,2010,17,2011-01-02,Sunday,13:00,OAK,31,KC,10,Home,-21,41
2011010207,2010,17,2011-01-02,Sunday,16:15,DAL,14,PHI,13,Home,-1,27
2011010208,2010,17,2011-01-02,Sunday,16:15,NYG,17,WAS,14,Home,-3,31
2011010209,2010,17,2011-01-02,Sunday,13:00,MIN,13,DET,20,Home,7,33
2011010210,2010,17,2011-01-02,Sunday,16:15,CHI,3,GB,10,Home,7,13
2011010211,2010,17,2011-01-02,Sunday,13:00,CAR,10,ATL,31,Home,21,41
2011010212,2010,17,2011-01-02,Sunday,13:00,TB,23,NO,13,Home,-10,36
2011010213,2010,17,2011-01-02,Sunday,16:15,SD,33,DEN,28,Home,-5,61
2011010214,2010,17,2011-01-02,Sunday,16:15,ARI,7,SF,38,Home,31,45
2011010215,2010,17,2011-01-02,Sunday,20:20,STL,6,SEA,16,Home,10,22
2011010800,2010,18,2011-01-08,Saturday,20:00,NYJ,17,IND,16,Home,-1,33
2011010801,2010,18,2011-01-08,Saturday,16:30,NO,36,SEA,41,Home,5,77
2011010900,2010,18,2011-01-09,Sunday,13:00,BAL,30,KC,7,Home,-23,37
2011010901,2010,18,2011-01-09,Sunday,16:30,GB,21,PHI,16,Home,-5,37
2011011500,2010,19,2011-01-15,Saturday,16:30,BAL,24,PIT,31,Home,7,55
2011011501,2010,19,2011-01-15,Saturday,20:00,GB,48,ATL,21,Home,-27,69
2011011600,2010,19,2011-01-16,Sunday,16:30,NYJ,28,NE,21,Home,-7,49
2011011601,2010,19,2011-01-16,Sunday,13:00,SEA,24,CHI,35,Home,11,59
2011012300,2010,20,2011-01-23,Sunday,18:30,NYJ,19,PIT,24,Home,5,43
2011012301,2010,20,2011-01-23,Sunday,15:00,GB,21,CHI,14,Home,-7,35
2011020600,2010,21,2011-02-06,Sunday,18:30,PIT,25,GB,31,Neutral,6,56
2011090800,2011,1,2011-09-08,Thursday,20:30,NO,34,GB,42,Home,8,76
2011091100,2011,1,2011-09-11,Sunday,13:00,PIT,7,BAL,35,Home,28,42
2011091101,2011,1,2011-09-11,Sunday,13:00,CIN,27,CLE,17,Home,-10,44
2011091102,2011,1,2011-09-11,Sunday,13:00,IND,7,HOU,34,Home,27,41
2011091103,2011,1,2011-09-11,Sunday,13:00,TEN,14,JAX,16,Home,2,30
2011091104,2011,1,2011-09-11,Sunday,13:00,BUF,41,KC,7,Home,-34,48
2011091105,2011,1,2011-09-11,Sunday,13:00,ATL,12,CHI,30,Home,18,42
2011091106,2011,1,2011-09-11,Sunday,13:00,DET,27,TB,20,Home,-7,47
2011091107,2011,1,2011-09-11,Sunday,13:00,PHI,31,STL,13,Home,-18,44
2011091108,2011,1,2011-09-11,Sunday,16:25,NYG,14,WAS,28,Home,14,42
2011091109,2011,1,2011-09-11,Sunday,16:15,CAR,21,ARI,28,Home,7,49
2011091110,2011,1,2011-09-11,Sunday,16:25,SEA,17,SF,33,Home,16,50
2011091111,2011,1,2011-09-11,Sunday,16:15,MIN,17,SD,24,Home,7,41
2011091112,2011,1,2011-09-11,Sunday,20:20,DAL,24,NYJ,27,Home,3,51
2011091200,2011,1,2011-09-12,Monday,19:00,NE,38,MIA,24,Home,-14,62
2011091201,2011,1,2011-09-12,Monday,22:15,OAK,23,DEN,20,Home,-3,43
2011091800,2011,2,2011-09-18,Sunday,13:00,KC,3,DET,48,Home,45,51
2011091801,2011,2,2011-09-18,Sunday,13:00,OAK,35,BUF,38,Home,3,73
2011091802,2011,2,2011-09-18,Sunday,13:00,BAL,13,TEN,26,Home,13,39
2011091803,2011,2,2011-09-18,Sunday,13:00,JAX,3,NYJ,32,Home,29,35
2011091804,2011,2,2011-09-18,Sunday,13:00,CLE,27,IND,19,Home,-8,46
2011091805,2011,2,2011-09-18,Sunday,13:00,ARI,21,WAS,22,Home,1,43
2011091806,2011,2,2011-09-18,Sunday,13:00,TB,24,MIN,20,Home,-4,44
2011091807,2011,2,2011-09-18,Sunday,13:00,GB,30,CAR,23,Home,-7,53
2011091808,2011,2,2011-09-18,Sunday,13:00,CHI,13,NO,30,Home,17,43
2011091809,2011,2,2011-09-18,Sunday,13:00,SEA,0,PIT,24,Home,24,24
2011091810,2011,2,2011-09-18,Sunday,16:05,DAL,27,SF,24,Home,-3,51
2011091811,2011,2,2011-09-18,Sunday,16:15,SD,21,NE,35,Home,14,56
2011091812,2011,2,2011-09-18,Sunday,16:15,CIN,22,DEN,24,Home,2,46
2011091813,2011,2,2011-09-18,Sunday,16:15,HOU,23,MIA,13,Home,-10,36
2011091814,2011,2,2011-09-18,Sunday,20:20,PHI,31,ATL,35,Home,4,66
2011091900,2011,2,2011-09-19,Monday,20:30,STL,16,NYG,28,Home,12,44
2011092500,2011,3,2011-09-25,Sunday,13:00,JAX,10,CAR,16,Home,6,26
2011092501,2011,3,2011-09-25,Sunday,13:00,HOU,33,NO,40,Home,7,73
2011092502,2011,3,2011-09-25,Sunday,13:00,NE,31,BUF,34,Home,3,65
2011092503,2011,3,2011-09-25,Sunday,13:00,MIA,16,CLE,17,Home,1,33
2011092504,2011,3,2011-09-25,Sunday,13:00,DEN,14,TEN,17,Home,3,31
2011092505,2011,3,2011-09-25,Sunday,13:00,NYG,29,PHI,16,Home,-13,45
2011092506,2011,3,2011-09-25,Sunday,13:00,DET,26,MIN,23,Home,-3,49
2011092507,2011,3,2011-09-25,Sunday,13:00,SF,13,CIN,8,Home,-5,21
2011092508,2011,3,2011-09-25,Sunday,16:05,NYJ,24,OAK,34,Home,10,58
2011092509,2011,3,2011-09-25,Sunday,16:05,KC,17,SD,20,Home,3,37
2011092510,2011,3,2011-09-25,Sunday,16:05,BAL,37,STL,7,Home,-30,44
2011092511,2011,3,2011-09-25,Sunday,16:15,GB,27,CHI,17,Home,-10,44
2011092512,2011,3,2011-09-25,Sunday,16:15,ARI,10,SEA,13,Home,3,23
2011092513,2011,3,2011-09-25,Sunday,16:15,ATL,13,TB,16,Home,3,29
2011092514,2011,3,2011-09-25,Sunday,20:20,PIT,23,IND,20,Home,-3,43
2011092600,2011,3,2011-09-26,Monday,20:30,WAS,16,DAL,18,Home,2,34
2011100200,2011,4,2011-10-02,Sunday,13:00,BUF,20,CIN,23,Home,3,43
2011100201,2011,4,2011-10-02,Sunday,13:00,TEN,31,CLE,13,Home,-18,44
2011100202,2011,4,2011-10-02,Sunday,13:00,PIT,10,HOU,17,Home,7,27
2011100203,2011,4,2011-10-02,Sunday,13:00,DET,34,DAL,30,Home,-4,64
2011100204,2011,4,2011-10-02,Sunday,13:00,SF,24,PHI,23,Home,-1,47
2011100205,2011,4,2011-10-02,Sunday,13:00,CAR,29,CHI,34,Home,5,63
2011100206,2011,4,2011-10-02,Sunday,13:00,WAS,17,STL,10,Home,-7,27
2011100207,2011,4,2011-10-02,Sunday,13:00,NO,23,JAX,10,Home,-13,33
2011100208,2011,4,2011-10-02,Sunday,13:00,MIN,17,KC,22,Home,5,39
2011100209,2011,4,2011-10-02,Sunday,16:05,NYG,31,ARI,27,Home,-4,58
2011100210,2011,4,2011-10-02,Sunday,16:05,ATL,30,SEA,28,Home,-2,58
2011100211,2011,4,2011-10-02,Sunday,16:15,DEN,23,GB,49,Home,26,72
2011100212,2011,4,2011-10-02,Sunday,16:15,NE,31,OAK,19,Home,-12,50
2011100213,2011,4,2011-10-02,Sunday,16:15,MIA,16,SD,26,Home,10,42
2011100214,2011,4,2011-10-02,Sunday,20:20,NYJ,17,BAL,34,Home,17,51
2011100300,2011,4,2011-10-03,Monday,20:30,IND,17,TB,24,Home,7,41
2011100900,2011,5,2011-10-09,Sunday,13:00,TEN,17,PIT,38,Home,21,55
2011100901,2011,5,2011-10-09,Sunday,13:00,OAK,25,HOU,20,Home,-5,45
2011100902,2011,5,2011-10-09,Sunday,13:00,KC,28,IND,24,Home,-4,52
2011100903,2011,5,2011-10-09,Sunday,13:00,CIN,30,JAX,20,Home,-10,50
2011100904,2011,5,2011-10-09,Sunday,13:00,SEA,36,NYG,25,Home,-11,61
2011100905,2011,5,2011-10-09,Sunday,13:00,ARI,10,MIN,34,Home,24,44
2011100906,2011,5,2011-10-09,Sunday,13:00,NO,30,CAR,27,Home,-3,57
2011100907,2011,5,2011-10-09,Sunday,13:00,PHI,24,BUF,31,Home,7,55
2011100908,2011,5,2011-10-09,Sunday,16:05,TB,3,SF,48,Home,45,51
2011100909,2011,5,2011-10-09,Sunday,16:15,NYJ,21,NE,30,Home,9,51
2011100910,2011,5,2011-10-09,Sunday,16:15,SD,29,DEN,24,Home,-5,53
2011100911,2011,5,2011-10-09,Sunday,20:20,GB,25,ATL,14,Home,-11,39
2011101000,2011,5,2011-10-10,Monday,20:30,CHI,13,DET,24,Home,11,37
2011101600,2011,6,2011-10-16,Sunday,13:00,BUF,24,NYG,27,Home,3,51
2011101601,2011,6,2011-10-16,Sunday,13:00,IND,17,CIN,27,Home,10,44
2011101602,2011,6,2011-10-16,Sunday,13:00,JAX,13,PIT,17,Home,4,30
2011101603,2011,6,2011-10-16,Sunday,13:00,PHI,20,WAS,13,Home,-7,33
2011101604,2011,6,2011-10-16,Sunday,13:00,SF,25,DET,19,Home,-6,44
2011101605,2011,6,2011-10-16,Sunday,13:00,STL,3,GB,24,Home,21,27
2011101606,2011,6,2011-10-16,Sunday,13:00,CAR,17,ATL,31,Home,14,48
2011101607,2011,6,2011-10-16,Sunday,16:05,CLE,17,OAK,24,Home,7,41
2011101608,2011,6,2011-10-16,Sunday,16:05,HOU,14,BAL,29,Home,15,43
2011101609,2011,6,2011-10-16,Sunday,16:15,NO,20,TB,26,Home,6,46
2011101610,2011,6,2011-10-16,Sunday,16:15,DAL,16,NE,20,Home,4,36
2011101611,2011,6,2011-10-16,Sunday,20:20,MIN,10,CHI,39,Home,29,49
2011101700,2011,6,2011-10-17,Monday,20:30,MIA,6,NYJ,24,Home,18,30
2011102300,2011,7,2011-10-23,Sunday,13:00,DEN,18,MIA,15,Home,-3,33
2011102301,2011,7,2011-10-23,Sunday,13:00,SD,21,NYJ,27,Home,6,48
2011102302,2011,7,2011-10-23,Sunday,13:00,HOU,41,TEN,7,Home,-34,48
2011102303,2011,7,2011-10-23,Sunday,13:00,ATL,23,DET,16,Home,-7,39
2011102304,2011,7,2011-10-23,Sunday,13:00,WAS,20,CAR,33,Home,13,53
2011102305,2011,7,2011-10-23,Sunday,13:00,CHI,24,TB,18,Neutral,-6,42
2011102306,2011,7,2011-10-23,Sunday,13:00,SEA,3,CLE,6,Home,3,9
2011102307,2011,7,2011-10-23,Sunday,16:05,PIT,32,ARI,20,Home,-12,52
2011102308,2011,7,2011-10-23,Sunday,16:05,KC,28,OAK,0,Home,-28,28
2011102309,2011,7,2011-10-23,Sunday,16:15,GB,33,MIN,27,Home,-6,60
2011102310,2011,7,2011-10-23,Sunday,16:15,STL,7,DAL,34,Home,27,41
2011102311,2011,7,2011-10-23,Sunday,20:20,IND,7,NO,62,Home,55,69
2011102400,2011,7,2011-10-24,Monday,20:30,BAL,7,JAX,12,Home,5,19
2011103000,2011,8,2011-10-30,Sunday,13:00,MIA,17,NYG,20,Home,3,37
2011103001,2011,8,2011-10-30,Sunday,13:00,JAX,14,HOU,24,Home,10,38
2011103002,2011,8,2011-10-30,Sunday,13:00,IND,10,TEN,27,Home,17,37
2011103003,2011,8,2011-10-30,Sunday,13:00,MIN,24,CAR,21,Home,-3,45
2011103004,2011,8,2011-10-30,Sunday,13:00,NO,21,STL,31,Home,10,52
2011103005,2011,8,2011-10-30,Sunday,13:00,ARI,27,BAL,30,Home,3,57
2011103006,2011,8,2011-10-30,Sunday,16:05,DET,45,DEN,10,Home,-35,55
2011103007,2011,8,2011-10-30,Sunday,16:05,WAS,0,BUF,23,Home,23,23
2011103008,2011,8,2011-10-30,Sunday,16:15,NE,17,PIT,25,Home,8,42
2011103009,2011,8,2011-10-30,Sunday,16:15,CLE,10,SF,20,Home,10,30
2011103010,2011,8,2011-10-30,Sunday,16:15,CIN,34,SEA,12,Home,-22,46
2011103011,2011,8,2011-10-30,Sunday,20:20,DAL,7,PHI,34,Home,27,41
2011103100,2011,8,2011-10-31,Monday,20:30,SD,20,KC,23,Home,3,43
2011110600,2011,9,2011-11-06,Sunday,13:00,NYJ,27,BUF,11,Home,-16,38
2011110601,2011,9,2011-11-06,Sunday,13:00,CLE,12,HOU,30,Home,18,42
2011110602,2011,9,2011-11-06,Sunday,13:00,MIA,31,KC,3,Home,-28,34
2011110603,2011,9,2011-11-06,Sunday,13:00,SEA,13,DAL,23,Home,10,36
2011110604,2011,9,2011-11-06,Sunday,13:00,SF,19,WAS,11,Home,-8,30
2011110605,2011,9,2011-11-06,Sunday,13:00,TB,16,NO,27,Home,11,43
2011110606,2011,9,2011-11-06,Sunday,13:00,ATL,31,IND,7,Home,-24,38
2011110607,2011,9,2011-11-06,Sunday,16:05,DEN,38,OAK,24,Home,-14,62
2011110608,2011,9,2011-11-06,Sunday,16:05,CIN,24,TEN,17,Home,-7,41
2011110609,2011,9,2011-11-06,Sunday,16:15,NYG,24,NE,20,Home,-4,44
2011110610,2011,9,2011-11-06,Sunday,16:15,GB,45,SD,38,Home,-7,83
2011110611,2011,9,2011-11-06,Sunday,16:15,STL,13,ARI,19,Home,6,32
2011110612,2011,9,2011-11-06,Sunday,20:20,BAL,23,PIT,20,Home,-3,43
2011110700,2011,9,2011-11-07,Monday,20:30,CHI,30,PHI,24,Home,-6,54
2011111000,2011,10,2011-11-10,Thursday,20:20,OAK,24,SD,17,Home,-7,41
2011111300,2011,10,2011-11-13,Sunday,13:00,BUF,7,DAL,44,Home,37,51
2011111301,2011,10,2011-11-13,Sunday,13:00,TEN,30,CAR,3,Home,-27,33
2011111302,2011,10,2011-11-13,Sunday,13:00,HOU,37,TB,9,Home,-28,46
2011111303,2011,10,2011-11-13,Sunday,13:00,PIT,24,CIN,17,Home,-7,41
2011111304,2011,10,2011-11-13,Sunday,13:00,JAX,17,IND,3,Home,-14,20
2011111305,2011,10,2011-11-13,Sunday,13:00,DEN,17,KC,10,Home,-7,27
2011111306,2011,10,2011-11-13,Sunday,13:00,ARI,21,PHI,17,Home,-4,38
2011111307,2011,10,2011-11-13,Sunday,16:15,DET,13,CHI,37,Home,24,50
2011111308,2011,10,2011-11-13,Sunday,13:00,NO,26,ATL,23,Home,-3,49
2011111309,2011,10,2011-11-13,Sunday,13:00,WAS,9,MIA,20,Home,11,29
2011111310,2011,10,2011-11-13,Sunday,13:00,STL,13,CLE,12,Home,-1,25
2011111311,2011,10,2011-11-13,Sunday,16:05,BAL,17,SEA,22,Home,5,39
2011111312,2011,10,2011-11-13,Sunday,16:15,NYG,20,SF,27,Home,7,47
2011111313,2011,10,2011-11-13,Sunday,20:20,NE,37,NYJ,16,Home,-21,53
2011111400,2011,10,2011-11-14,Monday,20:30,MIN,7,GB,45,Home,38,52
2011111700,2011,11,2011-11-17,Thursday,20:20,NYJ,13,DEN,17,Home,4,30
2011112000,2011,11,2011-11-20,Sunday,13:00,OAK,27,MIN,21,Home,-6,48
2011112001,2011,11,2011-11-20,Sunday,16:15,TEN,17,ATL,23,Home,6,40
2011112002,2011,11,2011-11-20,Sunday,13:00,BUF,8,MIA,35,Home,27,43
2011112003,2011,11,2011-11-20,Sunday,13:00,JAX,10,CLE,14,Home,4,24
2011112004,2011,11,2011-11-20,Sunday,13:00,CIN,24,BAL,31,Home,7,55
2011112005,2011,11,2011-11-20,Sunday,13:00,DAL,27,WAS,24,Home,-3,51
2011112006,2011,11,2011-11-20,Sunday,13:00,CAR,35,DET,49,Home,14,84
2011112007,2011,11,2011-11-20,Sunday,13:00,TB,26,GB,35,Home,9,61
2011112008,2011,11,2011-11-20,Sunday,16:05,ARI,7,SF,23,Home,16,30
2011112009,2011,11,2011-11-20,Sunday,16:05,SEA,24,STL,7,Home,-17,31
2011112010,2011,11,2011-11-20,Sunday,16:15,SD,20,CHI,31,Home,11,51
2011112011,2011,11,2011-11-20,Sunday,20:20,PHI,17,NYG,10,Home,-7,27
2011112100,2011,11,2011-11-21,Monday,20:30,KC,3,NE,34,Home,31,37
2011112400,2011,12,2011-11-24,Thursday,12:30,GB,27,DET,15,Home,-12,42
2011112401,2011,12,2011-11-24,Thursday,16:15,MIA,19,DAL,20,Home,1,39
2011112402,2011,12,2011-11-24,Thursday,20:20,SF,6,BAL,16,Home,10,22
2011112700,2011,12,2011-11-27,Sunday,13:00,BUF,24,NYJ,28,Home,4,52
2011112701,2011,12,2011-11-27,Sunday,13:00,CLE,20,CIN,23,Home,3,43
2011112702,2011,12,2011-11-27,Sunday,13:00,HOU,20,JAX,13,Home,-7,33
2011112703,2011,12,2011-11-27,Sunday,13:00,MIN,14,ATL,24,Home,10,38
2011112704,2011,12,2011-11-27,Sunday,13:00,ARI,23,STL,20,Home,-3,43
2011112705,2011,12,2011-11-27,Sunday,13:00,CAR,27,IND,19,Home,-8,46
2011112706,2011,12,2011-11-27,Sunday,13:00,TB,17,TEN,23,Home,6,40
2011112707,2011,12,2011-11-27,Sunday,16:05,WAS,23,SEA,17,Home,-6,40
2011112708,2011,12,2011-11-27,Sunday,16:05,CHI,20,OAK,25,Home,5,45
2011112709,2011,12,2011-11-27,Sunday,16:15,NE,38,PHI,20,Home,-18,58
2011112710,2011,12,2011-11-27,Sunday,16:15,DEN,16,SD,13,Home,-3,29
2011112711,2011,12,2011-11-27,Sunday,20:20,PIT,13,KC,9,Home,-4,22
2011112800,2011,12,2011-11-28,Monday,20:30,NYG,24,NO,49,Home,25,73
2011120100,2011,13,2011-12-01,Thursday,20:20,PHI,14,SEA,31,Home,17,45
2011120400,2011,13,2011-12-04,Sunday,13:00,NYJ,34,WAS,19,Home,-15,53
2011120401,2011,13,2011-12-04,Sunday,13:00,KC,10,CHI,3,Home,-7,13
2011120402,2011,13,2011-12-04,Sunday,13:00,TEN,23,BUF,17,Home,-6,40
2011120403,2011,13,2011-12-04,Sunday,13:00,OAK,14,MIA,34,Home,20,48
2011120404,2011,13,2011-12-04,Sunday,16:05,BAL,24,CLE,10,Home,-14,34
2011120405,2011,13,2011-12-04,Sunday,13:00,CIN,7,PIT,35,Home,28,42
2011120406,2011,13,2011-12-04,Sunday,20:20,DET,17,NO,31,Home,14,48
2011120407,2011,13,2011-12-04,Sunday,13:00,CAR,38,TB,19,Home,-19,57
2011120408,2011,13,2011-12-04,Sunday,13:00,ATL,10,HOU,17,Home,7,27
2011120409,2011,13,2011-12-04,Sunday,13:00,DEN,35,MIN,32,Home,-3,67
2011120410,2011,13,2011-12-04,Sunday,16:15,GB,38,NYG,35,Home,-3,73
2011120411,2011,13,2011-12-04,Sunday,16:15,DAL,13,ARI,19,Home,6,32
2011120412,2011,13,2011-12-04,Sunday,16:15,STL,0,SF,26,Home,26,26
2011120413,2011,13,2011-12-04,Sunday,13:00,IND,24,NE,31,Home,7,55
2011120500,2011,13,2011-12-05,Monday,20:30,SD,38,JAX,14,Home,-24,52
2011120800,2011,14,2011-12-08,Thursday,20:20,CLE,3,PIT,14,Home,11,17
2011121100,2011,14,2011-12-11,Sunday,13:00,NE,34,WAS,27,Home,-7,61
2011121101,2011,14,2011-12-11,Sunday,16:15,OAK,16,GB,46,Home,30,62
2011121102,2011,14,2011-12-11,Sunday,13:00,KC,10,NYJ,37,Home,27,47
2011121103,2011,14,2011-12-11,Sunday,13:00,HOU,20,CIN,19,Home,-1,39
2011121104,2011,14,2011-12-11,Sunday,13:00,IND,10,BAL,24,Home,14,34
2011121105,2011,14,2011-12-11,Sunday,13:00,MIN,28,DET,34,Home,6,62
2011121106,2011,14,2011-12-11,Sunday,13:00,ATL,31,CAR,23,Home,-8,54
2011121107,2011,14,2011-12-11,Sunday,13:00,PHI,26,MIA,10,Home,-16,36
2011121108,2011,14,2011-12-11,Sunday,13:00,TB,14,JAX,41,Home,27,55
2011121109,2011,14,2011-12-11,Sunday,13:00,NO,22,TEN,17,Home,-5,39
2011121110,2011,14,2011-12-11,Sunday,16:05,SF,19,ARI,21,Home,2,40
2011121111,2011,14,2011-12-11,Sunday,16:05,CHI,10,DEN,13,Home,3,23
2011121112,2011,14,2011-12-11,Sunday,16:15,BUF,10,SD,37,Home,27,47
2011121113,2011,14,2011-12-11,Sunday,20:20,NYG,37,DAL,34,Home,-3,71
2011121200,2011,14,2011-12-12,Monday,20:30,STL,13,SEA,30,Home,17,43
2011121500,2011,15,2011-12-15,Thursday,20:20,JAX,14,ATL,41,Home,27,55
2011121700,2011,15,2011-12-17,Saturday,20:20,DAL,31,TB,15,Home,-16,46
2011121800,2011,15,2011-12-18,Sunday,13:00,CIN,20,STL,13,Home,-7,33
2011121801,2011,15,2011-12-18,Sunday,13:00,MIA,30,BUF,23,Home,-7,53
2011121802,2011,15,2011-12-18,Sunday,13:00,TEN,13,IND,27,Home,14,40
2011121803,2011,15,2011-12-18,Sunday,13:00,WAS,23,NYG,10,Home,-13,33
2011121804,2011,15,2011-12-18,Sunday,13:00,SEA,38,CHI,14,Home,-24,52
2011121805,2011,15,2011-12-18,Sunday,13:00,NO,42,MIN,20,Home,-22,62
2011121806,2011,15,2011-12-18,Sunday,13:00,CAR,28,HOU,13,Home,-15,41
2011121807,2011,15,2011-12-18,Sunday,13:00,GB,14,KC,19,Home,5,33
2011121808,2011,15,2011-12-18,Sunday,16:05,DET,28,OAK,27,Home,-1,55
2011121809,2011,15,2011-12-18,Sunday,16:15,NYJ,19,PHI,45,Home,26,64
2011121810,2011,15,2011-12-18,Sunday,16:15,CLE,17,ARI,20,Home,3,37
2011121811,2011,15,2011-12-18,Sunday,16:15,NE,41,DEN,23,Home,-18,64
2011121812,2011,15,2011-12-18,Sunday,20:20,BAL,14,SD,34,Home,20,48
2011121900,2011,15,2011-12-19,Monday,20:30,PIT,3,SF,20,Home,17,23
2011122200,2011,16,2011-12-22,Thursday,20:20,HOU,16,IND,19,Home,3,35
2011122400,2011,16,2011-12-24,Saturday,13:00,DEN,14,BUF,40,Home,26,54
2011122401,2011,16,2011-12-24,Saturday,13:00,MIA,24,NE,27,Home,3,51
2011122402,2011,16,2011-12-24,Saturday,13:00,CLE,14,BAL,20,Home,6,34
2011122403,2011,16,2011-12-24,Saturday,13:00,JAX,17,TEN,23,Home,6,40
2011122404,2011,16,2011-12-24,Saturday,13:00,OAK,16,KC,13,Home,-3,29
2011122405,2011,16,2011-12-24,Saturday,13:00,NYG,29,NYJ,14,Home,-15,43
2011122406,2011,16,2011-12-24,Saturday,13:00,MIN,33,WAS,26,Home,-7,59
2011122407,2011,16,2011-12-24,Saturday,13:00,TB,16,CAR,48,Home,32,64
2011122408,2011,16,2011-12-24,Saturday,13:00,ARI,16,CIN,23,Home,7,39
2011122409,2011,16,2011-12-24,Saturday,13:00,STL,0,PIT,27,Home,27,27
2011122410,2011,16,2011-12-24,Saturday,16:05,SD,10,DET,38,Home,28,48
2011122411,2011,16,2011-12-24,Saturday,16:15,PHI,20,DAL,7,Home,-13,27
2011122412,2011,16,2011-12-24,Saturday,16:15,SF,19,SEA,17,Home,-2,36
2011122500,2011,16,2011-12-25,Sunday,20:20,CHI,21,GB,35,Home,14,56
2011122600,2011,16,2011-12-26,Monday,20:30,ATL,16,NO,45,Home,29,61
2012010100,2011,17,2012-01-01,Sunday,13:00,NYJ,17,MIA,19,Home,2,36
2012010101,2011,17,2012-01-01,Sunday,13:00,BUF,21,NE,49,Home,28,70
2012010102,2011,17,2012-01-01,Sunday,16:15,BAL,24,CIN,16,Home,-8,40
2012010103,2011,17,2012-01-01,Sunday,16:15,PIT,13,CLE,9,Home,-4,22
2012010104,2011,17,2012-01-01,Sunday,13:00,TEN,23,HOU,22,Home,-1,45
2012010105,2011,17,2012-01-01,Sunday,13:00,IND,13,JAX,19,Home,6,32
2012010106,2011,17,2012-01-01,Sunday,20:20,DAL,14,NYG,31,Home,17,45
2012010107,2011,17,2012-01-01,Sunday,13:00,WAS,10,PHI,34,Home,24,44
2012010108,2011,17,2012-01-01,Sunday,13:00,DET,41,GB,45,Home,4,86
2012010109,2011,17,2012-01-01,Sunday,13:00,CHI,17,MIN,13,Home,-4,30
2012010110,2011,17,2012-01-01,Sunday,16:15,TB,24,ATL,45,Home,21,69
2012010111,2011,17,2012-01-01,Sunday,13:00,CAR,17,NO,45,Home,28,62
2012010112,2011,17,2012-01-01,Sunday,13:00,SF,34,STL,27,Home,-7,61
2012010113,2011,17,2012-01-01,Sunday,16:15,KC,7,DEN,3,Home,-4,10
2012010114,2011,17,2012-01-01,Sunday,16:15,SD,38,OAK,26,Home,-12,64
2012010115,2011,17,2012-01-01,Sunday,16:15,SEA,20,ARI,23,Home,3,43
2012010700,2011,18,2012-01-07,Saturday,16:30,CIN,10,HOU,31,Home,21,41
2012010701,2011,18,2012-01-07,Saturday,20:00,DET,28,NO,45,Home,17,73
2012010800,2011,18,2012-01-08,Sunday,16:30,PIT,23,DEN,29,Home,6,52
2012010801,2011,18,2012-01-08,Sunday,13:00,ATL,2,NYG,24,Home,22,26
2012011400,2011,19,2012-01-14,Saturday,20:00,DEN,10,NE,45,Home,35,55
2012011401,2011,19,2012-01-14,Saturday,16:30,NO,32,SF,36,Home,4,68
2012011500,2011,19,2012-01-15,Sunday,13:00,HOU,13,BAL,20,Home,7,33
2012011501,2011,19,2012-01-15,Sunday,16:30,NYG,37,GB,20,Home,-17,57
2012012200,2011,20,2012-01-22,Sunday,15:00,BAL,20,NE,23,Home,3,43
2012012201,2011,20,2012-01-22,Sunday,18:30,NYG,20,SF,17,Home,-3,37
2012020500,2011,21,2012-02-05,Sunday,18:30,NYG,21,NE,17,Neutral,-4,38
2012090500,2012,1,2012-09-05,Wednesday,20:30,DAL,24,NYG,17,Home,-7,41
2012090900,2012,1,2012-09-09,Sunday,13:00,IND,21,CHI,41,Home,20,62
2012090901,2012,1,2012-09-09,Sunday,13:00,JAX,23,MIN,26,Home,3,49
2012090902,2012,1,2012-09-09,Sunday,13:00,BUF,28,NYJ,48,Home,20,76
2012090903,2012,1,2012-09-09,Sunday,13:00,MIA,10,HOU,30,Home,20,40
2012090904,2012,1,2012-09-09,Sunday,13:00,NE,34,TEN,13,Home,-21,47
2012090905,2012,1,2012-09-09,Sunday,13:00,STL,23,DET,27,Home,4,50
2012090906,2012,1,2012-09-09,Sunday,13:00,WAS,40,NO,32,Home,-8,72
2012090907,2012,1,2012-09-09,Sunday,13:00,PHI,17,CLE,16,Home,-1,33
2012090908,2012,1,2012-09-09,Sunday,13:00,ATL,40,KC,24,Home,-16,64
2012090909,2012,1,2012-09-09,Sunday,16:25,SF,30,GB,22,Home,-8,52
2012090910,2012,1,2012-09-09,Sunday,16:25,SEA,16,ARI,20,Home,4,36
2012090911,2012,1,2012-09-09,Sunday,16:25,CAR,10,TB,16,Home,6,26
2012090912,2012,1,2012-09-09,Sunday,20:20,PIT,19,DEN,31,Home,12,50
2012091000,2012,1,2012-09-10,Monday,19:00,CIN,13,BAL,44,Home,31,57
2012091001,2012,1,2012-09-10,Monday,22:15,SD,22,OAK,14,Home,-8,36
2012091300,2012,2,2012-09-13,Thursday,20:20,CHI,10,GB,23,Home,13,33
2012091600,2012,2,2012-09-16,Sunday,13:00,TB,34,NYG,41,Home,7,75
2012091601,2012,2,2012-09-16,Sunday,13:00,NO,27,CAR,35,Home,8,62
2012091602,2012,2,2012-09-16,Sunday,13:00,ARI,20,NE,18,Home,-2,38
2012091603,2012,2,2012-09-16,Sunday,13:00,MIN,20,IND,23,Home,3,43
2012091604,2012,2,2012-09-16,Sunday,13:00,BAL,23,PHI,24,Home,1,47
2012091605,2012,2,2012-09-16,Sunday,13:00,KC,17,BUF,35,Home,18,52
2012091606,2012,2,2012-09-16,Sunday,13:00,CLE,27,CIN,34,Home,7,61
2012091607,2012,2,2012-09-16,Sunday,13:00,HOU,27,JAX,7,Home,-20,34
2012091608,2012,2,2012-09-16,Sunday,16:05,DAL,7,SEA,27,Home,20,34
2012091609,2012,2,2012-09-16,Sunday,16:05,WAS,28,STL,31,Home,3,59
2012091610,2012,2,2012-09-16,Sunday,16:25,NYJ,10,PIT,27,Home,17,37
2012091611,2012,2,2012-09-16,Sunday,16:25,TEN,10,SD,38,Home,28,48
2012091612,2012,2,2012-09-16,Sunday,13:00,OAK,13,MIA,35,Home,22,48
2012091613,2012,2,2012-09-16,Sunday,20:20,DET,19,SF,27,Home,8,46
2012091700,2012,2,2012-09-17,Monday,20:30,DEN,21,ATL,27,Home,6,48
2012092000,2012,3,2012-09-20,Thursday,20:20,NYG,36,CAR,7,Home,-29,43
2012092300,2012,3,2012-09-23,Sunday,13:00,TB,10,DAL,16,Home,6,26
2012092301,2012,3,2012-09-23,Sunday,13:00,STL,6,CHI,23,Home,17,29
2012092302,2012,3,2012-09-23,Sunday,13:00,SF,13,MIN,24,Home,11,37
2012092303,2012,3,2012-09-23,Sunday,13:00,DET,41,TEN,44,Home,3,85
2012092304,2012,3,2012-09-23,Sunday,13:00,CIN,38,WAS,31,Home,-7,69
2012092305,2012,3,2012-09-23,Sunday,13:00,KC,27,NO,24,Home,-3,51
2012092306,2012,3,2012-09-23,Sunday,13:00,NYJ,23,MIA,20,Home,-3,43
2012092307,2012,3,2012-09-23,Sunday,13:00,BUF,24,CLE,14,Home,-10,38
2012092308,2012,3,2012-09-23,Sunday,13:00,JAX,22,IND,17,Home,-5,39
2012092309,2012,3,2012-09-23,Sunday,16:05,PHI,6,ARI,27,Home,21,33
2012092310,2012,3,2012-09-23,Sunday,16:05,ATL,27,SD,3,Home,-24,30
2012092311,2012,3,2012-09-23,Sunday,16:25,HOU,31,DEN,25,Home,-6,56
2012092312,2012,3,2012-09-23,Sunday,16:25,PIT,31,OAK,34,Home,3,65
2012092313,2012,3,2012-09-23,Sunday,20:20,NE,30,BAL,31,Home,1,61
2012092400,2012,3,2012-09-24,Monday,20:30,GB,12,SEA,14,Home,2,26
2012092700,2012,4,2012-09-27,Thursday,20:20,CLE,16,BAL,23,Home,7,39
2012093000,2012,4,2012-09-30,Sunday,13:00,NE,52,BUF,28,Home,-24,80
2012093001,2012,4,2012-09-30,Sunday,13:00,TEN,14,HOU,38,Home,24,52
2012093002,2012,4,2012-09-30,Sunday,13:00,SD,37,KC,20,Home,-17,57
2012093003,2012,4,2012-09-30,Sunday,13:00,MIN,20,DET,13,Home,-7,33
2012093004,2012,4,2012-09-30,Sunday,13:00,CAR,28,ATL,30,Home,2,58
2012093005,2012,4,2012-09-30,Sunday,13:00,SEA,13,STL,19,Home,6,32
2012093006,2012,4,2012-09-30,Sunday,13:00,SF,34,NYJ,0,Home,-34,34
2012093007,2012,4,2012-09-30,Sunday,16:05,MIA,21,ARI,24,Home,3,45
2012093008,2012,4,2012-09-30,Sunday,16:05,OAK,6,DEN,37,Home,31,43
2012093009,2012,4,2012-09-30,Sunday,16:05,CIN,27,JAX,10,Home,-17,37
2012093010,2012,4,2012-09-30,Sunday,16:25,NO,27,GB,28,Home,1,55
2012093011,2012,4,2012-09-30,Sunday,16:25,WAS,24,TB,22,Home,-2,46
2012093012,2012,4,2012-09-30,Sunday,20:20,NYG,17,PHI,19,Home,2,36
2012100100,2012,4,2012-10-01,Monday,20:30,CHI,34,DAL,18,Home,-16,52
2012100400,2012,5,2012-10-04,Thursday,20:20,ARI,3,STL,17,Home,14,20
2012100700,2012,5,2012-10-07,Sunday,13:00,ATL,24,WAS,17,Home,-7,41
2012100701,2012,5,2012-10-07,Sunday,13:00,PHI,14,PIT,16,Home,2,30
2012100702,2012,5,2012-10-07,Sunday,13:00,GB,27,IND,30,Home,3,57
2012100703,2012,5,2012-10-07,Sunday,13:00,CLE,27,NYG,41,Home,14,68
2012100704,2012,5,2012-10-07,Sunday,16:15,TEN,7,MIN,30,Home,23,37
2012100705,2012,5,2012-10-07,Sunday,13:00,MIA,17,CIN,13,Home,-4,30
2012100706,2012,5,2012-10-07,Sunday,13:00,BAL,9,KC,6,Home,-3,15
2012100707,2012,5,2012-10-07,Sunday,16:05,SEA,16,CAR,12,Home,-4,28
2012100708,2012,5,2012-10-07,Sunday,16:05,CHI,41,JAX,3,Home,-38,44
2012100709,2012,5,2012-10-07,Sunday,16:25,DEN,21,NE,31,Home,10,52
2012100710,2012,5,2012-10-07,Sunday,16:25,BUF,3,SF,45,Home,42,48
2012100711,2012,5,2012-10-07,Sunday,20:20,SD,24,NO,31,Home,7,55
2012100800,2012,5,2012-10-08,Monday,20:30,HOU,23,NYJ,17,Home,-6,40
2012101100,2012,6,2012-10-11,Thursday,20:20,PIT,23,TEN,26,Home,3,49
2012101400,2012,6,2012-10-14,Sunday,13:00,OAK,20,ATL,23,Home,3,43
2012101401,2012,6,2012-10-14,Sunday,13:00,KC,10,TB,38,Home,28,48
2012101402,2012,6,2012-10-14,Sunday,13:00,IND,9,NYJ,35,Home,26,44
2012101403,2012,6,2012-10-14,Sunday,13:00,CIN,24,CLE,34,Home,10,58
2012101404,2012,6,2012-10-14,Sunday,13:00,DET,26,PHI,23,Home,-3,49
2012101405,2012,6,2012-10-14,Sunday,13:00,STL,14,MIA,17,Home,3,31
2012101406,2012,6,2012-10-14,Sunday,13:00,DAL,29,BAL,31,Home,2,60
2012101407,2012,6,2012-10-14,Sunday,16:05,BUF,19,ARI,16,Home,-3,35
2012101408,2012,6,2012-10-14,Sunday,16:05,NE,23,SEA,24,Home,1,47
2012101409,2012,6,2012-10-14,Sunday,16:25,NYG,26,SF,3,Home,-23,29
2012101410,2012,6,2012-10-14,Sunday,16:25,MIN,26,WAS,38,Home,12,64
2012101411,2012,6,2012-10-14,Sunday,20:20,GB,42,HOU,24,Home,-18,66
2012101500,2012,6,2012-10-15,Monday,20:30,DEN,35,SD,24,Home,-11,59
2012101800,2012,7,2012-10-18,Thursday,20:20,SEA,6,SF,13,Home,7,19
2012102100,2012,7,2012-10-21,Sunday,13:00,WAS,23,NYG,27,Home,4,50
2012102101,2012,7,2012-10-21,Sunday,13:00,ARI,14,MIN,21,Home,7,35
2012102102,2012,7,2012-10-21,Sunday,13:00,DAL,19,CAR,14,Home,-5,33
2012102103,2012,7,2012-10-21,Sunday,13:00,NO,35,TB,28,Home,-7,63
2012102104,2012,7,2012-10-21,Sunday,13:00,GB,30,STL,20,Home,-10,50
2012102105,2012,7,2012-10-21,Sunday,13:00,BAL,13,HOU,43,Home,30,56
2012102106,2012,7,2012-10-21,Sunday,13:00,CLE,13,IND,17,Home,4,30
2012102107,2012,7,2012-10-21,Sunday,13:00,TEN,35,BUF,34,Home,-1,69
2012102108,2012,7,2012-10-21,Sunday,16:25,NYJ,26,NE,29,Home,3,55
2012102109,2012,7,2012-10-21,Sunday,16:25,JAX,23,OAK,26,Home,3,49
2012102110,2012,7,2012-10-21,Sunday,20:20,PIT,24,CIN,17,Home,-7,41
2012102200,2012,7,2012-10-22,Monday,20:30,DET,7,CHI,13,Home,6,20
2012102500,2012,8,2012-10-25,Thursday,20:20,TB,36,MIN,17,Home,-19,53
2012102800,2012,8,2012-10-28,Sunday,13:00,JAX,15,GB,24,Home,9,39
2012102801,2012,8,2012-10-28,Sunday,13:00,MIA,30,NYJ,9,Home,-21,39
2012102802,2012,8,2012-10-28,Sunday,13:00,SD,6,CLE,7,Home,1,13
2012102803,2012,8,2012-10-28,Sunday,13:00,IND,19,TEN,13,Home,-6,32
2012102804,2012,8,2012-10-28,Sunday,13:00,NE,45,STL,7,Neutral,-38,52
2012102805,2012,8,2012-10-28,Sunday,13:00,ATL,30,PHI,17,Home,-13,47
2012102806,2012,8,2012-10-28,Sunday,13:00,CAR,22,CHI,23,Home,1,45
2012102807,2012,8,2012-10-28,Sunday,13:00,SEA,24,DET,28,Home,4,52
2012102808,2012,8,2012-10-28,Sunday,13:00,WAS,12,PIT,27,Home,15,39
2012102809,2012,8,2012-10-28,Sunday,16:05,OAK,26,KC,16,Home,-10,42
2012102810,2012,8,2012-10-28,Sunday,16:25,NYG,29,DAL,24,Home,-5,53
2012102811,2012,8,2012-10-28,Sunday,20:20,NO,14,DEN,34,Home,20,48
2012102900,2012,8,2012-10-29,Monday,20:30,SF,24,ARI,3,Home,-21,27
2012110100,2012,9,2012-11-01,Thursday,20:20,KC,13,SD,31,Home,18,44
2012110400,2012,9,2012-11-04,Sunday,13:00,CAR,21,WAS,13,Home,-8,34
2012110401,2012,9,2012-11-04,Sunday,13:00,ARI,17,GB,31,Home,14,48
2012110402,2012,9,2012-11-04,Sunday,13:00,DET,31,JAX,14,Home,-17,45
2012110403,2012,9,2012-11-04,Sunday,13:00,CHI,51,TEN,20,Home,-31,71
2012110404,2012,9,2012-11-04,Sunday,13:00,DEN,31,CIN,23,Home,-8,54
2012110405,2012,9,2012-11-04,Sunday,13:00,BAL,25,CLE,15,Home,-10,40
2012110406,2012,9,2012-11-04,Sunday,13:00,BUF,9,HOU,21,Home,12,30
2012110407,2012,9,2012-11-04,Sunday,13:00,MIA,20,IND,23,Home,3,43
2012110408,2012,9,2012-11-04,Sunday,16:05,MIN,20,SEA,30,Home,10,50
2012110409,2012,9,2012-11-04,Sunday,16:05,TB,42,OAK,32,Home,-10,74
2012110410,2012,9,2012-11-04,Sunday,16:25,PIT,24,NYG,20,Home,-4,44
2012110411,2012,9,2012-11-04,Sunday,20:20,DAL,13,ATL,19,Home,6,32
2012110500,2012,9,2012-11-05,Monday,20:30,PHI,13,NO,28,Home,15,41
2012110800,2012,10,2012-11-08,Thursday,20:20,IND,27,JAX,10,Home,-17,37
2012111100,2012,10,2012-11-11,Sunday,13:00,DEN,36,CAR,14,Home,-22,50
2012111101,2012,10,2012-11-11,Sunday,13:00,SD,24,TB,34,Home,10,58
2012111102,2012,10,2012-11-11,Sunday,13:00,TEN,37,MIA,3,Home,-34,40
2012111103,2012,10,2012-11-11,Sunday,13:00,BUF,31,NE,37,Home,6,68
2012111104,2012,10,2012-11-11,Sunday,13:00,OAK,20,BAL,55,Home,35,75
2012111105,2012,10,2012-11-11,Sunday,13:00,NYG,13,CIN,31,Home,18,44
2012111106,2012,10,2012-11-11,Sunday,13:00,ATL,27,NO,31,Home,4,58
2012111107,2012,10,2012-11-11,Sunday,13:00,DET,24,MIN,34,Home,10,58
2012111108,2012,10,2012-11-11,Sunday,16:05,NYJ,7,SEA,28,Home,21,35
2012111109,2012,10,2012-11-11,Sunday,16:25,DAL,38,PHI,23,Home,-15,61
2012111110,2012,10,2012-11-11,Sunday,16:25,STL,24,SF,24,Home,0,48
2012111111,2012,10,2012-11-11,Sunday,20:20,HOU,13,CHI,6,Home,-7,19
2012111200,2012,10,2012-11-12,Monday,20:30,KC,13,PIT,16,Home,3,29
2012111500,2012,11,2012-11-15,Thursday,20:20,MIA,14,BUF,19,Home,5,33
2012111800,2012,11,2012-11-18,Sunday,13:00,PHI,6,WAS,31,Home,25,37
2012111801,2012,11,2012-11-18,Sunday,13:00,GB,24,DET,20,Home,-4,44
2012111802,2012,11,2012-11-18,Sunday,13:00,ARI,19,ATL,23,Home,4,42
2012111803,2012,11,2012-11-18,Sunday,13:00,TB,27,CAR,21,Home,-6,48
2012111804,2012,11,2012-11-18,Sunday,13:00,CLE,20,DAL,23,Home,3,43
2012111805,2012,11,2012-11-18,Sunday,13:00,NYJ,27,STL,13,Home,-14,40
2012111806,2012,11,2012-11-18,Sunday,16:25,IND,24,NE,59,Home,35,83
2012111807,2012,11,2012-11-18,Sunday,13:00,JAX,37,HOU,43,Home,6,80
2012111808,2012,11,2012-11-18,Sunday,13:00,CIN,28,KC,6,Home,-22,34
2012111809,2012,11,2012-11-18,Sunday,16:05,NO,38,OAK,17,Home,-21,55
2012111810,2012,11,2012-11-18,Sunday,16:25,SD,23,DEN,30,Home,7,53
2012111811,2012,11,2012-11-18,Sunday,20:20,BAL,13,PIT,10,Home,-3,23
2012111900,2012,11,2012-11-19,Monday,20:30,CHI,7,SF,32,Home,25,39
2012112200,2012,12,2012-11-22,Thursday,12:30,HOU,34,DET,31,Home,-3,65
2012112201,2012,12,2012-11-22,Thursday,16:15,WAS,38,DAL,31,Home,-7,69
2012112202,2012,12,2012-11-22,Thursday,20:20,NE,49,NYJ,19,Home,-30,68
2012112500,2012,12,2012-11-25,Sunday,13:00,OAK,10,CIN,34,Home,24,44
2012112501,2012,12,2012-11-25,Sunday,13:00,PIT,14,CLE,20,Home,6,34
2012112502,2012,12,2012-11-25,Sunday,13:00,BUF,13,IND,20,Home,7,33
2012112503,2012,12,2012-11-25,Sunday,13:00,TEN,19,JAX,24,Home,5,43
2012112504,2012,12,2012-11-25,Sunday,13:00,DEN,17,KC,9,Home,-8,26
2012112505,2012,12,2012-11-25,Sunday,13:00,MIN,10,CHI,28,Home,18,38
2012112506,2012,12,2012-11-25,Sunday,13:00,ATL,24,TB,23,Home,-1,47
2012112507,2012,12,2012-11-25,Sunday,13:00,SEA,21,MIA,24,Home,3,45
2012112508,2012,12,2012-11-25,Sunday,16:05,BAL,16,SD,13,Home,-3,29
2012112509,2012,12,2012-11-25,Sunday,16:25,SF,31,NO,21,Home,-10,52
2012112510,2012,12,2012-11-25,Sunday,16:25,STL,31,ARI,17,Home,-14,48
2012112511,2012,12,2012-11-25,Sunday,20:20,GB,10,NYG,38,Home,28,48
2012112600,2012,12,2012-11-26,Monday,20:30,CAR,30,PHI,22,Home,-8,52
2012112900,2012,13,2012-11-29,Thursday,20:20,NO,13,ATL,23,Home,10,36
2012120200,2012,13,2012-12-02,Sunday,13:00,SEA,23,CHI,17,Home,-6,40
2012120201,2012,13,2012-12-02,Sunday,13:00,MIN,14,GB,23,Home,9,37
2012120202,2012,13,2012-12-02,Sunday,13:00,SF,13,STL,16,Home,3,29
2012120203,2012,13,2012-12-02,Sunday,13:00,ARI,6,NYJ,7,Home,1,13
2012120204,2012,13,2012-12-02,Sunday,13:00,CAR,21,KC,27,Home,6,48
2012120205,2012,13,2012-12-02,Sunday,13:00,IND,35,DET,33,Home,-2,68
2012120206,2012,13,2012-12-02,Sunday,13:00,JAX,18,BUF,34,Home,16,52
2012120207,2012,13,2012-12-02,Sunday,13:00,NE,23,MIA,16,Home,-7,39
2012120208,2012,13,2012-12-02,Sunday,13:00,HOU,24,TEN,10,Home,-14,34
2012120209,2012,13,2012-12-02,Sunday,16:05,TB,23,DEN,31,Home,8,54
2012120210,2012,13,2012-12-02,Sunday,16:25,PIT,23,BAL,20,Home,-3,43
2012120211,2012,13,2012-12-02,Sunday,16:25,CLE,20,OAK,17,Home,-3,37
2012120212,2012,13,2012-12-02,Sunday,16:25,CIN,20,SD,13,Home,-7,33
2012120213,2012,13,2012-12-02,Sunday,20:20,PHI,33,DAL,38,Home,5,71
2012120300,2012,13,2012-12-03,Monday,20:30,NYG,16,WAS,17,Home,1,33
2012120600,2012,14,2012-12-06,Thursday,20:20,DEN,26,OAK,13,Home,-13,39
2012120900,2012,14,2012-12-09,Sunday,13:00,BAL,28,WAS,31,Home,3,59
2012120901,2012,14,2012-12-09,Sunday,13:00,KC,7,CLE,30,Home,23,37
2012120902,2012,14,2012-12-09,Sunday,13:00,SD,34,PIT,24,Home,-10,58
2012120903,2012,14,2012-12-09,Sunday,13:00,TEN,23,IND,27,Home,4,50
2012120904,2012,14,2012-12-09,Sunday,13:00,NYJ,17,JAX,10,Home,-7,27
2012120905,2012,14,2012-12-09,Sunday,13:00,CHI,14,MIN,21,Home,7,35
2012120906,2012,14,2012-12-09,Sunday,13:00,ATL,20,CAR,30,Home,10,50
2012120907,2012,14,2012-12-09,Sunday,13:00,PHI,23,TB,21,Home,-2,44
2012120908,2012,14,2012-12-09,Sunday,13:00,STL,15,BUF,12,Home,-3,27
2012120909,2012,14,2012-12-09,Sunday,13:00,DAL,20,CIN,19,Home,-1,39
2012120910,2012,14,2012-12-09,Sunday,16:05,MIA,13,SF,27,Home,14,40
2012120911,2012,14,2012-12-09,Sunday,16:25,NO,27,NYG,52,Home,25,79
2012120912,2012,14,2012-12-09,Sunday,16:25,ARI,0,SEA,58,Home,58,58
2012120913,2012,14,2012-12-09,Sunday,20:20,DET,20,GB,27,Home,7,47
2012121000,2012,14,2012-12-10,Monday,20:30,HOU,14,NE,42,Home,28,56
2012121300,2012,15,2012-12-13,Thursday,20:20,CIN,34,PHI,13,Home,-21,47
2012121600,2012,15,2012-12-16,Sunday,13:00,GB,21,CHI,13,Home,-8,34
2012121601,2012,15,2012-12-16,Sunday,13:00,NYG,0,ATL,34,Home,34,34
2012121602,2012,15,2012-12-16,Sunday,13:00,TB,0,NO,41,Home,41,41
2012121603,2012,15,2012-12-16,Sunday,13:00,MIN,36,STL,22,Home,-14,58
2012121604,2012,15,2012-12-16,Sunday,13:00,WAS,38,CLE,21,Home,-17,59
2012121605,2012,15,2012-12-16,Sunday,13:00,JAX,3,MIA,24,Home,21,27
2012121606,2012,15,2012-12-16,Sunday,13:00,DEN,34,BAL,17,Home,-17,51
2012121607,2012,15,2012-12-16,Sunday,13:00,IND,17,HOU,29,Home,12,46
2012121608,2012,15,2012-12-16,Sunday,16:05,DET,10,ARI,38,Home,28,48
2012121609,2012,15,2012-12-16,Sunday,16:05,CAR,31,SD,7,Home,-24,38
2012121610,2012,15,2012-12-16,Sunday,16:05,SEA,50,BUF,17,Home,-33,67
2012121611,2012,15,2012-12-16,Sunday,16:25,PIT,24,DAL,27,Home,3,51
2012121612,2012,15,2012-12-16,Sunday,16:25,KC,0,OAK,15,Home,15,15
2012121613,2012,15,2012-12-16,Sunday,20:20,SF,41,NE,34,Home,-7,75
2012121700,2012,15,2012-12-17,Monday,20:30,NYJ,10,TEN,14,Home,4,24
2012122200,2012,16,2012-12-22,Saturday,20:30,ATL,31,DET,18,Home,-13,49
2012122300,2012,16,2012-12-23,Sunday,13:00,TEN,7,GB,55,Home,48,62
2012122301,2012,16,2012-12-23,Sunday,13:00,OAK,6,CAR,17,Home,11,23
2012122302,2012,16,2012-12-23,Sunday,13:00,BUF,10,MIA,24,Home,14,34
2012122303,2012,16,2012-12-23,Sunday,13:00,CIN,13,PIT,10,Home,-3,23
2012122304,2012,16,2012-12-23,Sunday,13:00,NE,23,JAX,16,Home,-7,39
2012122305,2012,16,2012-12-23,Sunday,13:00,IND,20,KC,13,Home,-7,33
2012122306,2012,16,2012-12-23,Sunday,13:00,NO,34,DAL,31,Home,-3,65
2012122307,2012,16,2012-12-23,Sunday,13:00,WAS,27,PHI,20,Home,-7,47
2012122308,2012,16,2012-12-23,Sunday,13:00,STL,28,TB,13,Home,-15,41
2012122309,2012,16,2012-12-23,Sunday,16:25,NYG,14,BAL,33,Home,19,47
2012122310,2012,16,2012-12-23,Sunday,13:00,MIN,23,HOU,6,Home,-17,29
2012122311,2012,16,2012-12-23,Sunday,16:05,CLE,12,DEN,34,Home,22,46
2012122312,2012,16,2012-12-23,Sunday,16:25,CHI,28,ARI,13,Home,-15,41
2012122313,2012,16,2012-12-23,Sunday,20:20,SF,13,SEA,42,Home,29,55
2012122314,2012,16,2012-12-23,Sunday,13:00,SD,27,NYJ,17,Home,-10,44
2012123000,2012,17,2012-12-30,Sunday,13:00,NYJ,9,BUF,28,Home,19,37
2012123001,2012,17,2012-12-30,Sunday,16:25,MIA,0,NE,28,Home,28,28
2012123002,2012,17,2012-12-30,Sunday,13:00,BAL,17,CIN,23,Home,6,40
2012123003,2012,17,2012-12-30,Sunday,13:00,CLE,10,PIT,24,Home,14,34
2012123004,2012,17,2012-12-30,Sunday,13:00,HOU,16,IND,28,Home,12,44
2012123005,2012,17,2012-12-30,Sunday,13:00,JAX,20,TEN,38,Home,18,58
2012123006,2012,17,2012-12-30,Sunday,13:00,PHI,7,NYG,42,Home,35,49
2012123007,2012,17,2012-12-30,Sunday,20:20,DAL,18,WAS,28,Home,10,46
2012123008,2012,17,2012-12-30,Sunday,13:00,CHI,26,DET,24,Home,-2,50
2012123009,2012,17,2012-12-30,Sunday,16:25,GB,34,MIN,37,Home,3,71
2012123010,2012,17,2012-12-30,Sunday,13:00,TB,22,ATL,17,Home,-5,39
2012123011,2012,17,2012-12-30,Sunday,13:00,CAR,44,NO,38,Home,-6,82
2012123012,2012,17,2012-12-30,Sunday,16:25,KC,3,DEN,38,Home,35,41
2012123013,2012,17,2012-12-30,Sunday,16:25,OAK,21,SD,24,Home,3,45
2012123014,2012,17,2012-12-30,Sunday,16:25,ARI,13,SF,27,Home,14,40
2012123015,2012,17,2012-12-30,Sunday,16:25,STL,13,SEA,20,Home,7,33
2013010500,2012,18,2013-01-05,Saturday,16:30,CIN,13,HOU,19,Home,6,32
2013010501,2012,18,2013-01-05,Saturday,20:00,MIN,10,GB,24,Home,14,34
2013010600,2012,18,2013-01-06,Sunday,13:00,IND,9,BAL,24,Home,15,33
2013010601,2012,18,2013-01-06,Sunday,16:30,SEA,24,WAS,14,Home,-10,38
2013011200,2012,19,2013-01-12,Saturday,16:30,BAL,38,DEN,35,Home,-3,73
2013011201,2012,19,2013-01-12,Saturday,20:00,GB,31,SF,45,Home,14,76
2013011300,2012,19,2013-01-13,Sunday,16:30,HOU,28,NE,41,Home,13,69
2013011301,2012,19,2013-01-13,Sunday,13:00,SEA,28,ATL,30,Home,2,58
2013012000,2012,20,2013-01-20,Sunday,18:30,BAL,28,NE,13,Home,-15,41
2013012001,2012,20,2013-01-20,Sunday,15:00,SF,28,ATL,24,Home,-4,52
2013020300,2012,21,2013-02-03,Sunday,18:30,BAL,34,SF,31,Neutral,-3,65
2013090500,2013,1,2013-09-05,Thursday,20:30,BAL,27,DEN,49,Home,22,76
2013090800,2013,1,2013-09-08,Sunday,13:00,NE,23,BUF,21,Home,-2,44
2013090801,2013,1,2013-09-08,Sunday,13:00,SEA,12,CAR,7,Home,-5,19
2013090802,2013,1,2013-09-08,Sunday,13:00,CIN,21,CHI,24,Home,3,45
2013090803,2013,1,2013-09-08,Sunday,13:00,MIA,23,CLE,10,Home,-13,33
2013090804,2013,1,2013-09-08,Sunday,13:00,MIN,24,DET,34,Home,10,58
2013090805,2013,1,2013-09-08,Sunday,13:00,OAK,17,IND,21,Home,4,38
2013090806,2013,1,2013-09-08,Sunday,13:00,KC,28,JAX,2,Home,-26,30
2013090807,2013,1,2013-09-08,Sunday,13:00,TB,17,NYJ,18,Home,1,35
2013090808,2013,1,2013-09-08,Sunday,13:00,ATL,17,NO,23,Home,6,40
2013090809,2013,1,2013-09-08,Sunday,13:00,TEN,16,PIT,9,Home,-7,25
2013090810,2013,1,2013-09-08,Sunday,16:25,ARI,24,STL,27,Home,3,51
2013090811,2013,1,2013-09-08,Sunday,16:25,GB,28,SF,34,Home,6,62
2013090812,2013,1,2013-09-08,Sunday,20:30,NYG,31,DAL,36,Home,5,67
2013090900,2013,1,2013-09-09,Monday,19:00,PHI,33,WAS,27,Home,-6,60
2013090901,2013,1,2013-09-09,Monday,22:15,HOU,31,SD,28,Home,-3,59
2013091200,2013,2,2013-09-12,Thursday,20:25,NYJ,10,NE,13,Home,3,23
2013091500,2013,2,2013-09-15,Sunday,13:00,STL,24,ATL,31,Home,7,55
2013091501,2013,2,2013-09-15,Sunday,13:00,CLE,6,BAL,14,Home,8,20
2013091502,2013,2,2013-09-15,Sunday,13:00,CAR,23,BUF,24,Home,1,47
2013091503,2013,2,2013-09-15,Sunday,13:00,MIN,30,CHI,31,Home,1,61
2013091504,2013,2,2013-09-15,Sunday,13:00,WAS,20,GB,38,Home,18,58
2013091505,2013,2,2013-09-15,Sunday,13:00,TEN,24,HOU,30,Home,6,54
2013091506,2013,2,2013-09-15,Sunday,13:00,MIA,24,IND,20,Home,-4,44
2013091507,2013,2,2013-09-15,Sunday,13:00,DAL,16,KC,17,Home,1,33
2013091508,2013,2,2013-09-15,Sunday,13:00,SD,33,PHI,30,Home,-3,63
2013091509,2013,2,2013-09-15,Sunday,16:05,DET,21,ARI,25,Home,4,46
2013091510,2013,2,2013-09-15,Sunday,16:05,NO,16,TB,14,Home,-2,30
2013091511,2013,2,2013-09-15,Sunday,16:25,DEN,41,NYG,23,Home,-18,64
2013091512,2013,2,2013-09-15,Sunday,16:25,JAX,9,OAK,19,Home,10,28
2013091513,2013,2,2013-09-15,Sunday,20:30,SF,3,SEA,29,Home,26,32
2013091600,2013,2,2013-09-16,Monday,20:30,PIT,10,CIN,20,Home,10,30
2013091900,2013,3,2013-09-19,Thursday,20:25,KC,26,PHI,16,Home,-10,42
2013092200,2013,3,2013-09-22,Sunday,13:00,HOU,9,BAL,30,Home,21,39
2013092201,2013,3,2013-09-22,Sunday,13:00,GB,30,CIN,34,Home,4,64
2013092202,2013,3,2013-09-22,Sunday,13:00,STL,7,DAL,31,Home,24,38
2013092203,2013,3,2013-09-22,Sunday,16:05,ATL,23,MIA,27,Home,4,50
2013092204,2013,3,2013-09-22,Sunday,13:00,CLE,31,MIN,27,Home,-4,58
2013092205,2013,3,2013-09-22,Sunday,16:25,BUF,20,NYJ,27,Home,7,47
2013092206,2013,3,2013-09-22,Sunday,13:00,TB,3,NE,23,Home,20,26
2013092207,2013,3,2013-09-22,Sunday,13:00,ARI,7,NO,31,Home,24,38
2013092208,2013,3,2013-09-22,Sunday,13:00,SD,17,TEN,20,Home,3,37
2013092209,2013,3,2013-09-22,Sunday,13:00,DET,27,WAS,20,Home,-7,47
2013092210,2013,3,2013-09-22,Sunday,13:00,NYG,0,CAR,38,Home,38,38
2013092211,2013,3,2013-09-22,Sunday,16:25,IND,27,SF,7,Home,-20,34
2013092212,2013,3,2013-09-22,Sunday,16:25,JAX,17,SEA,45,Home,28,62
2013092213,2013,3,2013-09-22,Sunday,20:30,CHI,40,PIT,23,Home,-17,63
2013092300,2013,3,2013-09-23,Monday,20:30,OAK,21,DEN,37,Home,16,58
2013092600,2013,4,2013-09-26,Thursday,20:25,SF,35,STL,11,Home,-24,46
2013092900,2013,4,2013-09-29,Sunday,13:00,BAL,20,BUF,23,Home,3,43
2013092901,2013,4,2013-09-29,Sunday,13:00,CIN,6,CLE,17,Home,11,23
2013092902,2013,4,2013-09-29,Sunday,13:00,CHI,32,DET,40,Home,8,72
2013092903,2013,4,2013-09-29,Sunday,13:00,SEA,23,HOU,20,Home,-3,43
2013092904,2013,4,2013-09-29,Sunday,13:00,IND,37,JAX,3,Home,-34,40
2013092905,2013,4,2013-09-29,Sunday,13:00,NYG,7,KC,31,Home,24,38
2013092906,2013,4,2013-09-29,Sunday,13:00,PIT,27,MIN,34,Neutral,7,61
2013092907,2013,4,2013-09-29,Sunday,13:00,ARI,13,TB,10,Home,-3,23
2013092908,2013,4,2013-09-29,Sunday,16:05,NYJ,13,TEN,38,Home,25,51
2013092909,2013,4,2013-09-29,Sunday,16:25,PHI,20,DEN,52,Home,32,72
2013092910,2013,4,2013-09-29,Sunday,16:25,WAS,24,OAK,14,Home,-10,38
2013092911,2013,4,2013-09-29,Sunday,16:25,DAL,21,SD,30,Home,9,51
2013092912,2013,4,2013-09-29,Sunday,20:30,NE,30,ATL,23,Home,-7,53
2013093000,2013,4,2013-09-30,Monday,20:30,MIA,17,NO,38,Home,21,55
2013100300,2013,5,2013-10-03,Thursday,20:25,BUF,24,CLE,37,Home,13,61
2013100600,2013,5,2013-10-06,Sunday,13:00,NO,26,CHI,18,Home,-8,44
2013100601,2013,5,2013-10-06,Sunday,13:00,NE,6,CIN,13,Home,7,19
2013100602,2013,5,2013-10-06,Sunday,13:00,DET,9,GB,22,Home,13,31
2013100603,2013,5,2013-10-06,Sunday,13:00,SEA,28,IND,34,Home,6,62
2013100604,2013,5,2013-10-06,Sunday,13:00,BAL,26,MIA,23,Home,-3,49
2013100605,2013,5,2013-10-06,Sunday,13:00,PHI,36,NYG,21,Home,-15,57
2013100606,2013,5,2013-10-06,Sunday,13:00,JAX,20,STL,34,Home,14,54
2013100607,2013,5,2013-10-06,Sunday,13:00,KC,26,TEN,17,Home,-9,43
2013100608,2013,5,2013-10-06,Sunday,16:05,CAR,6,ARI,22,Home,16,28
2013100609,2013,5,2013-10-06,Sunday,16:25,DEN,51,DAL,48,Home,-3,99
2013100610,2013,5,2013-10-06,Sunday,23:30,SD,17,OAK,27,Home,10,44
2013100611,2013,5,2013-10-06,Sunday,20:30,HOU,3,SF,34,Home,31,37
2013100700,2013,5,2013-10-07,Monday,20:30,NYJ,30,ATL,28,Home,-2,58
2013101000,2013,6,2013-10-10,Thursday,20:25,NYG,21,CHI,27,Home,6,48
2013101300,2013,6,2013-10-13,Sunday,13:00,GB,19,BAL,17,Home,-2,36
2013101301,2013,6,2013-10-13,Sunday,13:00,CIN,27,BUF,24,Home,-3,51
2013101302,2013,6,2013-10-13,Sunday,13:00,DET,31,CLE,17,Home,-14,48
2013101303,2013,6,2013-10-13,Sunday,13:00,STL,38,HOU,13,Home,-25,51
2013101304,2013,6,2013-10-13,Sunday,13:00,OAK,7,KC,24,Home,17,31
2013101305,2013,6,2013-10-13,Sunday,13:00,CAR,35,MIN,10,Home,-25,45
2013101306,2013,6,2013-10-13,Sunday,13:00,PIT,19,NYJ,6,Home,-13,25
2013101307,2013,6,2013-10-13,Sunday,13:00,PHI,31,TB,20,Home,-11,51
2013101308,2013,6,2013-10-13,Sunday,16:05,JAX,19,DEN,35,Home,16,54
2013101309,2013,6,2013-10-13,Sunday,16:05,TEN,13,SEA,20,Home,7,33
2013101310,2013,6,2013-10-13,Sunday,16:25,NO,27,NE,30,Home,3,57
2013101311,2013,6,2013-10-13,Sunday,16:25,ARI,20,SF,32,Home,12,52
2013101312,2013,6,2013-10-13,Sunday,20:30,WAS,16,DAL,31,Home,15,47
2013101400,2013,6,2013-10-14,Monday,20:30,IND,9,SD,19,Home,10,28
2013101700,2013,7,2013-10-17,Thursday,20:25,SEA,34,ARI,22,Home,-12,56
2013102000,2013,7,2013-10-20,Sunday,13:00,TB,23,ATL,31,Home,8,54
2013102001,2013,7,2013-10-20,Sunday,13:00,STL,15,CAR,30,Home,15,45
2013102002,2013,7,2013-10-20,Sunday,13:00,CIN,13,DET,31,Home,18,44
2013102003,2013,7,2013-10-20,Sunday,16:25,CLE,13,GB,31,Home,18,44
2013102004,2013,7,2013-10-20,Sunday,13:00,SD,24,JAX,6,Home,-18,30
2013102005,2013,7,2013-10-20,Sunday,16:25,HOU,16,KC,17,Home,1,33
2013102006,2013,7,2013-10-20,Sunday,13:00,BUF,23,MIA,21,Home,-2,44
2013102007,2013,7,2013-10-20,Sunday,13:00,NE,27,NYJ,30,Home,3,57
2013102008,2013,7,2013-10-20,Sunday,13:00,DAL,17,PHI,3,Home,-14,20
2013102009,2013,7,2013-10-20,Sunday,13:00,CHI,41,WAS,45,Home,4,86
2013102010,2013,7,2013-10-20,Sunday,16:05,SF,31,TEN,17,Home,-14,48
2013102011,2013,7,2013-10-20,Sunday,16:25,BAL,16,PIT,19,Home,3,35
2013102012,2013,7,2013-10-20,Sunday,20:30,DEN,33,IND,39,Home,6,72
2013102100,2013,7,2013-10-21,Monday,20:30,MIN,7,NYG,23,Home,16,30
2013102400,2013,8,2013-10-24,Thursday,20:25,CAR,31,TB,13,Home,-18,44
2013102700,2013,8,2013-10-27,Sunday,13:00,DAL,30,DET,31,Home,1,61
2013102701,2013,8,2013-10-27,Sunday,13:00,SF,42,JAX,10,Neutral,-32,52
2013102702,2013,8,2013-10-27,Sunday,13:00,CLE,17,KC,23,Home,6,40
2013102703,2013,8,2013-10-27,Sunday,13:00,MIA,17,NE,27,Home,10,44
2013102704,2013,8,2013-10-27,Sunday,13:00,BUF,17,NO,35,Home,18,52
2013102705,2013,8,2013-10-27,Sunday,13:00,NYG,15,PHI,7,Home,-8,22
2013102706,2013,8,2013-10-27,Sunday,16:05,PIT,18,OAK,21,Home,3,39
2013102707,2013,8,2013-10-27,Sunday,16:05,NYJ,9,CIN,49,Home,40,58
2013102708,2013,8,2013-10-27,Sunday,16:25,ATL,13,ARI,27,Home,14,40
2013102709,2013,8,2013-10-27,Sunday,16:25,WAS,21,DEN,45,Home,24,66
2013102710,2013,8,2013-10-27,Sunday,20:30,GB,44,MIN,31,Home,-13,75
2013102800,2013,8,2013-10-28,Monday,20:30,SEA,14,STL,9,Home,-5,23
2013103100,2013,9,2013-10-31,Thursday,20:25,CIN,20,MIA,22,Home,2,42
2013110300,2013,9,2013-11-03,Sunday,13:00,KC,23,BUF,13,Home,-10,36
2013110301,2013,9,2013-11-03,Sunday,13:00,ATL,10,CAR,34,Home,24,44
2013110302,2013,9,2013-11-03,Sunday,13:00,MIN,23,DAL,27,Home,4,50
2013110303,2013,9,2013-11-03,Sunday,13:00,NO,20,NYJ,26,Home,6,46
2013110304,2013,9,2013-11-03,Sunday,13:00,TEN,28,STL,21,Home,-7,49
2013110305,2013,9,2013-11-03,Sunday,13:00,SD,24,WAS,30,Home,6,54
2013110306,2013,9,2013-11-03,Sunday,16:05,PHI,49,OAK,20,Home,-29,69
2013110307,2013,9,2013-11-03,Sunday,16:05,TB,24,SEA,27,Home,3,51
2013110308,2013,9,2013-11-03,Sunday,16:25,BAL,18,CLE,24,Home,6,42
2013110309,2013,9,2013-11-03,Sunday,16:25,PIT,31,NE,55,Home,24,86
2013110310,2013,9,2013-11-03,Sunday,20:30,IND,27,HOU,24,Home,-3,51
2013110400,2013,9,2013-11-04,Monday,20:30,CHI,27,GB,20,Home,-7,47
2013110700,2013,10,2013-11-07,Thursday,20:25,WAS,27,MIN,34,Home,7,61
2013111000,2013,10,2013-11-10,Sunday,13:00,SEA,33,ATL,10,Home,-23,43
2013111001,2013,10,2013-11-10,Sunday,13:00,CIN,17,BAL,20,Home,3,37
2013111002,2013,10,2013-11-10,Sunday,13:00,DET,21,CHI,19,Home,-2,40
2013111003,2013,10,2013-11-10,Sunday,13:00,PHI,27,GB,13,Home,-14,40
2013111004,2013,10,2013-11-10,Sunday,13:00,STL,38,IND,8,Home,-30,46
2013111005,2013,10,2013-11-10,Sunday,13:00,OAK,20,NYG,24,Home,4,44
2013111006,2013,10,2013-11-10,Sunday,13:00,BUF,10,PIT,23,Home,13,33
2013111007,2013,10,2013-11-10,Sunday,13:00,JAX,29,TEN,27,Home,-2,56
2013111008,2013,10,2013-11-10,Sunday,16:05,CAR,10,SF,9,Home,-1,19
2013111009,2013,10,2013-11-10,Sunday,16:25,HOU,24,ARI,27,Home,3,51
2013111010,2013,10,2013-11-10,Sunday,16:25,DEN,28,SD,20,Home,-8,48
2013111011,2013,10,2013-11-10,Sunday,20:30,DAL,17,NO,49,Home,32,66
2013111100,2013,10,2013-11-11,Monday,20:30,MIA,19,TB,22,Home,3,41
2013111400,2013,11,2013-11-14,Thursday,20:25,IND,30,TEN,27,Home,-3,57
2013111700,2013,11,2013-11-17,Sunday,13:00,NYJ,14,BUF,37,Home,23,51
2013111701,2013,11,2013-11-17,Sunday,13:00,BAL,20,CHI,23,Home,3,43
2013111702,2013,11,2013-11-17,Sunday,13:00,CLE,20,CIN,41,Home,21,61
2013111703,2013,11,2013-11-17,Sunday,13:00,OAK,28,HOU,23,Home,-5,51
2013111704,2013,11,2013-11-17,Sunday,13:00,ARI,27,JAX,14,Home,-13,41
2013111705,2013,11,2013-11-17,Sunday,16:05,SD,16,MIA,20,Home,4,36
2013111706,2013,11,2013-11-17,Sunday,13:00,WAS,16,PHI,24,Home,8,40
2013111707,2013,11,2013-11-17,Sunday,13:00,DET,27,PIT,37,Home,10,64
2013111708,2013,11,2013-11-17,Sunday,13:00,ATL,28,TB,41,Home,13,69
2013111709,2013,11,2013-11-17,Sunday,20:30,KC,17,DEN,27,Home,10,44
2013111710,2013,11,2013-11-17,Sunday,16:25,SF,20,NO,23,Home,3,43
2013111711,2013,11,2013-11-17,Sunday,16:25,MIN,20,SEA,41,Home,21,61
2013111712,2013,11,2013-11-17,Sunday,16:25,GB,13,NYG,27,Home,14,40
2013111800,2013,11,2013-11-18,Monday,20:30,NE,20,CAR,24,Home,4,44
2013112100,2013,12,2013-11-21,Thursday,20:25,NO,17,ATL,13,Home,-4,30
2013112400,2013,12,2013-11-24,Sunday,13:00,NYJ,3,BAL,19,Home,16,22
2013112401,2013,12,2013-11-24,Sunday,13:00,PIT,27,CLE,11,Home,-16,38
2013112402,2013,12,2013-11-24,Sunday,13:00,TB,24,DET,21,Home,-3,45
2013112403,2013,12,2013-11-24,Sunday,13:00,MIN,26,GB,26,Home,0,52
2013112404,2013,12,2013-11-24,Sunday,13:00,JAX,13,HOU,6,Home,-7,19
2013112405,2013,12,2013-11-24,Sunday,13:00,SD,41,KC,38,Home,-3,79
2013112406,2013,12,2013-11-24,Sunday,13:00,CAR,20,MIA,16,Home,-4,36
2013112407,2013,12,2013-11-24,Sunday,13:00,CHI,21,STL,42,Home,21,63
2013112408,2013,12,2013-11-24,Sunday,16:05,IND,11,ARI,40,Home,29,51
2013112409,2013,12,2013-11-24,Sunday,16:05,TEN,23,OAK,19,Home,-4,42
2013112410,2013,12,2013-11-24,Sunday,16:25,DAL,24,NYG,21,Home,-3,45
2013112411,2013,12,2013-11-24,Sunday,20:30,DEN,31,NE,34,Home,3,65
2013112500,2013,12,2013-11-25,Monday,20:30,SF,27,WAS,6,Home,-21,33
2013112800,2013,13,2013-11-28,Thursday,12:30,GB,10,DET,40,Home,30,50
2013112801,2013,13,2013-11-28,Thursday,16:30,OAK,24,DAL,31,Home,7,55
2013112802,2013,13,2013-11-28,Thursday,20:30,PIT,20,BAL,22,Home,2,42
2013120100,2013,13,2013-12-01,Sunday,13:00,TB,6,CAR,27,Home,21,33
2013120101,2013,13,2013-12-01,Sunday,13:00,JAX,32,CLE,28,Home,-4,60
2013120102,2013,13,2013-12-01,Sunday,13:00,TEN,14,IND,22,Home,8,36
2013120103,2013,13,2013-12-01,Sunday,16:25,DEN,35,KC,28,Home,-7,63
2013120104,2013,13,2013-12-01,Sunday,13:00,CHI,20,MIN,23,Home,3,43
2013120105,2013,13,2013-12-01,Sunday,13:00,MIA,23,NYJ,3,Home,-20,26
2013120106,2013,13,2013-12-01,Sunday,13:00,ARI,21,PHI,24,Home,3,45
2013120107,2013,13,2013-12-01,Sunday,16:05,ATL,34,BUF,31,Neutral,-3,65
2013120108,2013,13,2013-12-01,Sunday,16:05,STL,13,SF,23,Home,10,36
2013120109,2013,13,2013-12-01,Sunday,13:00,NE,34,HOU,31,Home,-3,65
2013120110,2013,13,2013-12-01,Sunday,16:25,CIN,17,SD,10,Home,-7,27
2013120111,2013,13,2013-12-01,Sunday,20:30,NYG,24,WAS,17,Home,-7,41
2013120200,2013,13,2013-12-02,Monday,20:30,NO,7,SEA,34,Home,27,41
2013120500,2013,14,2013-12-05,Thursday,20:25,HOU,20,JAX,27,Home,7,47
2013120800,2013,14,2013-12-08,Sunday,13:00,MIN,26,BAL,29,Home,3,55
2013120801,2013,14,2013-12-08,Sunday,13:00,IND,28,CIN,42,Home,14,70
2013120802,2013,14,2013-12-08,Sunday,13:00,CLE,26,NE,27,Home,1,53
2013120803,2013,14,2013-12-08,Sunday,13:00,OAK,27,NYJ,37,Home,10,64
2013120804,2013,14,2013-12-08,Sunday,20:30,CAR,13,NO,31,Home,18,44
2013120805,2013,14,2013-12-08,Sunday,13:00,DET,20,PHI,34,Home,14,54
2013120806,2013,14,2013-12-08,Sunday,13:00,MIA,34,PIT,28,Home,-6,62
2013120807,2013,14,2013-12-08,Sunday,13:00,BUF,6,TB,27,Home,21,33
2013120808,2013,14,2013-12-08,Sunday,13:00,KC,45,WAS,10,Home,-35,55
2013120809,2013,14,2013-12-08,Sunday,16:05,TEN,28,DEN,51,Home,23,79
2013120810,2013,14,2013-12-08,Sunday,16:25,STL,10,ARI,30,Home,20,40
2013120811,2013,14,2013-12-08,Sunday,16:25,NYG,14,SD,37,Home,23,51
2013120812,2013,14,2013-12-08,Sunday,16:25,SEA,17,SF,19,Home,2,36
2013120813,2013,14,2013-12-08,Sunday,13:00,ATL,21,GB,22,Home,1,43
2013120900,2013,14,2013-12-09,Monday,20:30,DAL,28,CHI,45,Home,17,73
2013121200,2013,15,2013-12-12,Thursday,20:25,SD,27,DEN,20,Home,-7,47
2013121500,2013,15,2013-12-15,Sunday,13:00,WAS,26,ATL,27,Home,1,53
2013121501,2013,15,2013-12-15,Sunday,13:00,CHI,38,CLE,31,Home,-7,69
2013121502,2013,15,2013-12-15,Sunday,13:00,HOU,3,IND,25,Home,22,28
2013121503,2013,15,2013-12-15,Sunday,13:00,BUF,27,JAX,20,Home,-7,47
2013121504,2013,15,2013-12-15,Sunday,13:00,NE,20,MIA,24,Home,4,44
2013121505,2013,15,2013-12-15,Sunday,13:00,PHI,30,MIN,48,Home,18,78
2013121506,2013,15,2013-12-15,Sunday,13:00,SEA,23,NYG,0,Home,-23,23
2013121507,2013,15,2013-12-15,Sunday,16:25,NO,16,STL,27,Home,11,43
2013121508,2013,15,2013-12-15,Sunday,13:00,SF,33,TB,14,Home,-19,47
2013121509,2013,15,2013-12-15,Sunday,16:25,ARI,37,TEN,34,Home,-3,71
2013121510,2013,15,2013-12-15,Sunday,16:05,NYJ,20,CAR,30,Home,10,50
2013121511,2013,15,2013-12-15,Sunday,16:05,KC,56,OAK,31,Home,-25,87
2013121512,2013,15,2013-12-15,Sunday,16:25,GB,37,DAL,36,Home,-1,73
2013121513,2013,15,2013-12-15,Sunday,20:30,CIN,20,PIT,30,Home,10,50
2013121600,2013,15,2013-12-16,Monday,20:30,BAL,18,DET,16,Home,-2,34
2013122200,2013,16,2013-12-22,Sunday,13:00,MIA,0,BUF,19,Home,19,19
2013122201,2013,16,2013-12-22,Sunday,13:00,NO,13,CAR,17,Home,4,30
2013122202,2013,16,2013-12-22,Sunday,13:00,MIN,14,CIN,42,Home,28,56
2013122203,2013,16,2013-12-22,Sunday,13:00,DEN,37,HOU,13,Home,-24,50
2013122204,2013,16,2013-12-22,Sunday,13:00,TEN,20,JAX,16,Home,-4,36
2013122205,2013,16,2013-12-22,Sunday,13:00,IND,23,KC,7,Home,-16,30
2013122206,2013,16,2013-12-22,Sunday,13:00,CLE,13,NYJ,24,Home,11,37
2013122207,2013,16,2013-12-22,Sunday,20:30,CHI,11,PHI,54,Home,43,65
2013122208,2013,16,2013-12-22,Sunday,13:00,TB,13,STL,23,Home,10,36
2013122209,2013,16,2013-12-22,Sunday,13:00,DAL,24,WAS,23,Home,-1,47
2013122210,2013,16,2013-12-22,Sunday,16:05,NYG,23,DET,20,Home,-3,43
2013122211,2013,16,2013-12-22,Sunday,16:05,ARI,17,SEA,10,Home,-7,27
2013122212,2013,16,2013-12-22,Sunday,16:25,PIT,38,GB,31,Home,-7,69
2013122213,2013,16,2013-12-22,Sunday,16:25,OAK,13,SD,26,Home,13,39
2013122214,2013,16,2013-12-22,Sunday,16:25,NE,41,BAL,7,Home,-34,48
2013122300,2013,16,2013-12-23,Monday,20:30,ATL,24,SF,34,Home,10,58
2013122900,2013,17,2013-12-29,Sunday,13:00,CAR,21,ATL,20,Home,-1,41
2013122901,2013,17,2013-12-29,Sunday,16:25,GB,33,CHI,28,Home,-5,61
2013122902,2013,17,2013-12-29,Sunday,13:00,BAL,17,CIN,34,Home,17,51
2013122903,2013,17,2013-12-29,Sunday,20:30,PHI,24,DAL,22,Home,-2,46
2013122904,2013,17,2013-12-29,Sunday,13:00,JAX,10,IND,30,Home,20,40
2013122905,2013,17,2013-12-29,Sunday,13:00,NYJ,20,MIA,7,Home,-13,27
2013122906,2013,17,2013-12-29,Sunday,13:00,DET,13,MIN,14,Home,1,27
2013122907,2013,17,2013-12-29,Sunday,16:25,BUF,20,NE,34,Home,14,54
2013122908,2013,17,2013-12-29,Sunday,16:25,TB,17,NO,42,Home,25,59
2013122909,2013,17,2013-12-29,Sunday,13:00,WAS,6,NYG,20,Home,14,26
2013122910,2013,17,2013-12-29,Sunday,13:00,CLE,7,PIT,20,Home,13,27
2013122911,2013,17,2013-12-29,Sunday,13:00,HOU,10,TEN,16,Home,6,26
2013122912,2013,17,2013-12-29,Sunday,16:25,SF,23,ARI,20,Home,-3,43
2013122913,2013,17,2013-12-29,Sunday,16:25,DEN,34,OAK,14,Home,-20,48
2013122914,2013,17,2013-12-29,Sunday,16:25,KC,24,SD,27,Home,3,51
2013122915,2013,17,2013-12-29,Sunday,16:25,STL,9,SEA,27,Home,18,36
2014010400,2013,18,2014-01-04,Saturday,16:35,KC,44,IND,45,Home,1,89
2014010401,2013,18,2014-01-04,Saturday,20:10,NO,26,PHI,24,Home,-2,50
2014010500,2013,18,2014-01-05,Sunday,13:05,SD,27,CIN,10,Home,-17,37
2014010501,2013,18,2014-01-05,Sunday,16:40,SF,23,GB,20,Home,-3,43
2014011100,2013,19,2014-01-11,Saturday,16:35,NO,15,SEA,23,Home,8,38
2014011101,2013,19,2014-01-11,Saturday,20:15,IND,22,NE,43,Home,21,65
2014011200,2013,19,2014-01-12,Sunday,13:05,SF,23,CAR,10,Home,-13,33
2014011201,2013,19,2014-01-12,Sunday,16:40,SD,17,DEN,24,Home,7,41
2014011900,2013,20,2014-01-19,Sunday,15:00,NE,16,DEN,26,Home,10,42
2014011901,2013,20,2014-01-19,Sunday,18:30,SF,17,SEA,23,Home,6,40
2014020200,2013,21,2014-02-02,Sunday,18:25,SEA,43,DEN,8,Neutral,-35,51
2014090400,2014,1,2014-09-04,Thursday,20:30,GB,16,SEA,36,Home,20,52
2014090700,2014,1,2014-09-07,Sunday,13:00,NO,34,ATL,37,Home,3,71
2014090701,2014,1,2014-09-07,Sunday,13:00,CIN,23,BAL,16,Home,-7,39
2014090702,2014,1,2014-09-07,Sunday,13:00,BUF,23,CHI,20,Home,-3,43
2014090703,2014,1,2014-09-07,Sunday,13:00,WAS,6,HOU,17,Home,11,23
2014090704,2014,1,2014-09-07,Sunday,13:00,TEN,26,KC,10,Home,-16,36
2014090705,2014,1,2014-09-07,Sunday,13:00,NE,20,MIA,33,Home,13,53
2014090706,2014,1,2014-09-07,Sunday,13:00,OAK,14,NYJ,19,Home,5,33
2014090707,2014,1,2014-09-07,Sunday,13:00,JAX,17,PHI,34,Home,17,51
2014090708,2014,1,2014-09-07,Sunday,13:00,CLE,27,PIT,30,Home,3,57
2014090709,2014,1,2014-09-07,Sunday,13:00,MIN,34,STL,6,Home,-28,40
2014090710,2014,1,2014-09-07,Sunday,16:25,SF,28,DAL,17,Home,-11,45
2014090711,2014,1,2014-09-07,Sunday,16:25,CAR,20,TB,14,Home,-6,34
2014090712,2014,1,2014-09-07,Sunday,20:30,IND,24,DEN,31,Home,7,55
2014090800,2014,1,2014-09-08,Monday,19:10,NYG,14,DET,35,Home,21,49
2014090801,2014,1,2014-09-08,Monday,21:20,SD,17,ARI,18,Home,1,35
2014091100,2014,2,2014-09-11,Thursday,20:25,PIT,6,BAL,26,Home,20,32
2014091400,2014,2,2014-09-14,Sunday,13:00,MIA,10,BUF,29,Home,19,39
2014091401,2014,2,2014-09-14,Sunday,13:00,DET,7,CAR,24,Home,17,31
2014091402,2014,2,2014-09-14,Sunday,13:00,ATL,10,CIN,24,Home,14,34
2014091403,2014,2,2014-09-14,Sunday,13:00,NO,24,CLE,26,Home,2,50
2014091404,2014,2,2014-09-14,Sunday,13:00,NE,30,MIN,7,Home,-23,37
2014091405,2014,2,2014-09-14,Sunday,13:00,ARI,25,NYG,14,Home,-11,39
2014091406,2014,2,2014-09-14,Sunday,13:00,DAL,26,TEN,10,Home,-16,36
2014091407,2014,2,2014-09-14,Sunday,13:00,JAX,10,WAS,41,Home,31,51
2014091408,2014,2,2014-09-14,Sunday,16:05,SEA,21,SD,30,Home,9,51
2014091409,2014,2,2014-09-14,Sunday,16:05,STL,19,TB,17,Home,-2,36
2014091410,2014,2,2014-09-14,Sunday,16:25,KC,17,DEN,24,Home,7,41
2014091411,2014,2,2014-09-14,Sunday,16:25,NYJ,24,GB,31,Home,7,55
2014091412,2014,2,2014-09-14,Sunday,16:25,HOU,30,OAK,14,Home,-16,44
2014091413,2014,2,2014-09-14,Sunday,20:30,CHI,28,SF,20,Home,-8,48
2014091500,2014,2,2014-09-15,Monday,20:30,PHI,30,IND,27,Home,-3,57
2014091800,2014,3,2014-09-18,Thursday,20:25,TB,14,ATL,56,Home,42,70
2014092100,2014,3,2014-09-21,Sunday,13:00,SD,22,BUF,10,Home,-12,32
2014092101,2014,3,2014-09-21,Sunday,13:00,TEN,7,CIN,33,Home,26,40
2014092102,2014,3,2014-09-21,Sunday,13:00,BAL,23,CLE,21,Home,-2,44
2014092103,2014,3,2014-09-21,Sunday,13:00,GB,7,DET,19,Home,12,26
2014092104,2014,3,2014-09-21,Sunday,13:00,IND,44,JAX,17,Home,-27,61
2014092105,2014,3,2014-09-21,Sunday,13:00,OAK,9,NE,16,Home,7,25
2014092106,2014,3,2014-09-21,Sunday,13:00,MIN,9,NO,20,Home,11,29
2014092107,2014,3,2014-09-21,Sunday,13:00,HOU,17,NYG,30,Home,13,47
2014092108,2014,3,2014-09-21,Sunday,13:00,WAS,34,PHI,37,Home,3,71
2014092109,2014,3,2014-09-21,Sunday,13:00,DAL,34,STL,31,Home,-3,65
2014092110,2014,3,2014-09-21,Sunday,16:05,SF,14,ARI,23,Home,9,37
2014092111,2014,3,2014-09-21,Sunday,16:25,KC,34,MIA,15,Home,-19,49
2014092112,2014,3,2014-09-21,Sunday,16:25,DEN,20,SEA,26,Home,6,46
2014092113,2014,3,2014-09-21,Sunday,20:30,PIT,37,CAR,19,Home,-18,56
2014092200,2014,3,2014-09-22,Monday,20:30,CHI,27,NYJ,19,Home,-8,46
2014092500,2014,4,2014-09-25,Thursday,20:25,NYG,45,WAS,14,Home,-31,59
2014092800,2014,4,2014-09-28,Sunday,13:00,CAR,10,BAL,38,Home,28,48
2014092801,2014,4,2014-09-28,Sunday,13:00,GB,38,CHI,17,Home,-21,55
2014092802,2014,4,2014-09-28,Sunday,13:00,BUF,17,HOU,23,Home,6,40
2014092803,2014,4,2014-09-28,Sunday,13:00,TEN,17,IND,41,Home,24,58
2014092804,2014,4,2014-09-28,Sunday,16:25,ATL,28,MIN,41,Home,13,69
2014092805,2014,4,2014-09-28,Sunday,13:00,DET,24,NYJ,17,Home,-7,41
2014092806,2014,4,2014-09-28,Sunday,13:00,MIA,38,OAK,14,Neutral,-24,52
2014092807,2014,4,2014-09-28,Sunday,13:00,TB,27,PIT,24,Home,-3,51
2014092808,2014,4,2014-09-28,Sunday,16:05,JAX,14,SD,33,Home,19,47
2014092809,2014,4,2014-09-28,Sunday,16:25,PHI,21,SF,26,Home,5,47
2014092810,2014,4,2014-09-28,Sunday,20:30,NO,17,DAL,38,Home,21,55
2014092900,2014,4,2014-09-29,Monday,20:30,NE,14,KC,41,Home,27,55
2014100200,2014,5,2014-10-02,Thursday,20:25,MIN,10,GB,42,Home,32,52
2014100500,2014,5,2014-10-05,Sunday,13:00,CHI,24,CAR,31,Home,7,55
2014100501,2014,5,2014-10-05,Sunday,13:00,HOU,17,DAL,20,Home,3,37
2014100502,2014,5,2014-10-05,Sunday,13:00,BUF,17,DET,14,Home,-3,31
2014100503,2014,5,2014-10-05,Sunday,13:00,BAL,13,IND,20,Home,7,33
2014100504,2014,5,2014-10-05,Sunday,13:00,PIT,17,JAX,9,Home,-8,26
2014100505,2014,5,2014-10-05,Sunday,13:00,TB,31,NO,37,Home,6,68
2014100506,2014,5,2014-10-05,Sunday,13:00,ATL,20,NYG,30,Home,10,50
2014100507,2014,5,2014-10-05,Sunday,13:00,STL,28,PHI,34,Home,6,62
2014100508,2014,5,2014-10-05,Sunday,13:00,CLE,29,TEN,28,Home,-1,57
2014100509,2014,5,2014-10-05,Sunday,16:05,ARI,20,DEN,41,Home,21,61
2014100510,2014,5,2014-10-05,Sunday,16:25,NYJ,0,SD,31,Home,31,31
2014100511,2014,5,2014-10-05,Sunday,16:25,KC,17,SF,22,Home,5,39
2014100512,2014,5,2014-10-05,Sunday,20:30,CIN,17,NE,43,Home,26,60
2014100600,2014,5,2014-10-06,Monday,20:30,SEA,27,WAS,17,Home,-10,44
2014100900,2014,6,2014-10-09,Thursday,20:25,IND,33,HOU,28,Home,-5,61
2014101200,2014,6,2014-10-12,Sunday,16:25,CHI,27,ATL,13,Home,-14,40
2014101201,2014,6,2014-10-12,Sunday,13:00,NE,37,BUF,22,Home,-15,59
2014101202,2014,6,2014-10-12,Sunday,13:00,CAR,37,CIN,37,Home,0,74
2014101203,2014,6,2014-10-12,Sunday,13:00,PIT,10,CLE,31,Home,21,41
2014101204,2014,6,2014-10-12,Sunday,13:00,GB,27,MIA,24,Home,-3,51
2014101205,2014,6,2014-10-12,Sunday,13:00,DET,17,MIN,3,Home,-14,20
2014101206,2014,6,2014-10-12,Sunday,13:00,DEN,31,NYJ,17,Home,-14,48
2014101207,2014,6,2014-10-12,Sunday,13:00,BAL,48,TB,17,Home,-31,65
2014101208,2014,6,2014-10-12,Sunday,13:00,JAX,14,TEN,16,Home,2,30
2014101209,2014,6,2014-10-12,Sunday,16:05,SD,31,OAK,28,Home,-3,59
2014101210,2014,6,2014-10-12,Sunday,16:25,WAS,20,ARI,30,Home,10,50
2014101211,2014,6,2014-10-12,Sunday,16:25,DAL,30,SEA,23,Home,-7,53
2014101212,2014,6,2014-10-12,Sunday,20:30,NYG,0,PHI,27,Home,27,27
2014101300,2014,6,2014-10-13,Monday,20:30,SF,31,STL,17,Home,-14,48
2014101600,2014,7,2014-10-16,Thursday,20:25,NYJ,25,NE,27,Home,2,52
2014101900,2014,7,2014-10-19,Sunday,13:00,ATL,7,BAL,29,Home,22,36
2014101901,2014,7,2014-10-19,Sunday,13:00,MIN,16,BUF,17,Home,1,33
2014101902,2014,7,2014-10-19,Sunday,13:00,MIA,27,CHI,14,Home,-13,41
2014101903,2014,7,2014-10-19,Sunday,13:00,NO,23,DET,24,Home,1,47
2014101904,2014,7,2014-10-19,Sunday,13:00,CAR,17,GB,38,Home,21,55
2014101905,2014,7,2014-10-19,Sunday,13:00,CIN,0,IND,27,Home,27,27
2014101906,2014,7,2014-10-19,Sunday,13:00,CLE,6,JAX,24,Home,18,30
2014101907,2014,7,2014-10-19,Sunday,13:00,SEA,26,STL,28,Home,2,54
2014101908,2014,7,2014-10-19,Sunday,13:00,TEN,17,WAS,19,Home,2,36
2014101909,2014,7,2014-10-19,Sunday,16:05,KC,23,SD,20,Home,-3,43
2014101910,2014,7,2014-10-19,Sunday,16:25,NYG,21,DAL,31,Home,10,52
2014101911,2014,7,2014-10-19,Sunday,16:25,ARI,24,OAK,13,Home,-11,37
2014101912,2014,7,2014-10-19,Sunday,20:30,SF,17,DEN,42,Home,25,59
2014102000,2014,7,2014-10-20,Monday,20:30,HOU,23,PIT,30,Home,7,53
2014102300,2014,8,2014-10-23,Thursday,20:25,SD,21,DEN,35,Home,14,56
2014102600,2014,8,2014-10-26,Sunday,09:30,DET,22,ATL,21,Neutral,-1,43
2014102601,2014,8,2014-10-26,Sunday,13:00,SEA,13,CAR,9,Home,-4,22
2014102602,2014,8,2014-10-26,Sunday,13:00,BAL,24,CIN,27,Home,3,51
2014102603,2014,8,2014-10-26,Sunday,13:00,MIA,27,JAX,13,Home,-14,40
2014102604,2014,8,2014-10-26,Sunday,13:00,STL,7,KC,34,Home,27,41
2014102605,2014,8,2014-10-26,Sunday,13:00,CHI,23,NE,51,Home,28,74
2014102606,2014,8,2014-10-26,Sunday,13:00,BUF,43,NYJ,23,Home,-20,66
2014102607,2014,8,2014-10-26,Sunday,13:00,MIN,19,TB,13,Home,-6,32
2014102608,2014,8,2014-10-26,Sunday,13:00,HOU,30,TEN,16,Home,-14,46
2014102609,2014,8,2014-10-26,Sunday,16:05,PHI,20,ARI,24,Home,4,44
2014102610,2014,8,2014-10-26,Sunday,16:25,OAK,13,CLE,23,Home,10,36
2014102611,2014,8,2014-10-26,Sunday,16:25,IND,34,PIT,51,Home,17,85
2014102612,2014,8,2014-10-26,Sunday,20:30,GB,23,NO,44,Home,21,67
2014102700,2014,8,2014-10-27,Monday,20:30,WAS,20,DAL,17,Home,-3,37
2014103000,2014,9,2014-10-30,Thursday,20:25,NO,28,CAR,10,Home,-18,38
2014110200,2014,9,2014-11-02,Sunday,13:00,JAX,23,CIN,33,Home,10,56
2014110201,2014,9,2014-11-02,Sunday,13:00,TB,17,CLE,22,Home,5,39
2014110202,2014,9,2014-11-02,Sunday,13:00,ARI,28,DAL,17,Home,-11,45
2014110203,2014,9,2014-11-02,Sunday,13:00,PHI,31,HOU,21,Home,-10,52
2014110204,2014,9,2014-11-02,Sunday,13:00,NYJ,10,KC,24,Home,14,34
2014110205,2014,9,2014-11-02,Sunday,13:00,SD,0,MIA,37,Home,37,37
2014110206,2014,9,2014-11-02,Sunday,13:00,WAS,26,MIN,29,Home,3,55
2014110207,2014,9,2014-11-02,Sunday,16:05,STL,13,SF,10,Home,-3,23
2014110208,2014,9,2014-11-02,Sunday,16:25,DEN,21,NE,43,Home,22,64
2014110209,2014,9,2014-11-02,Sunday,16:25,OAK,24,SEA,30,Home,6,54
2014110210,2014,9,2014-11-02,Sunday,20:30,BAL,23,PIT,43,Home,20,66
2014110300,2014,9,2014-11-03,Monday,20:30,IND,40,NYG,24,Home,-16,64
2014110600,2014,10,2014-11-06,Thursday,20:25,CLE,24,CIN,3,Home,-21,27
2014110900,2014,10,2014-11-09,Sunday,13:00,TEN,7,BAL,21,Home,14,28
2014110901,2014,10,2014-11-09,Sunday,13:00,KC,17,BUF,13,Home,-4,30
2014110902,2014,10,2014-11-09,Sunday,13:00,MIA,16,DET,20,Home,4,36
2014110903,2014,10,2014-11-09,Sunday,13:00,DAL,31,JAX,17,Neutral,-14,48
2014110904,2014,10,2014-11-09,Sunday,13:00,SF,27,NO,24,Home,-3,51
2014110905,2014,10,2014-11-09,Sunday,13:00,PIT,13,NYJ,20,Home,7,33
2014110906,2014,10,2014-11-09,Sunday,13:00,ATL,27,TB,17,Home,-10,44
2014110907,2014,10,2014-11-09,Sunday,16:05,DEN,41,OAK,17,Home,-24,58
2014110908,2014,10,2014-11-09,Sunday,16:25,STL,14,ARI,31,Home,17,45
2014110909,2014,10,2014-11-09,Sunday,16:25,NYG,17,SEA,38,Home,21,55
2014110910,2014,10,2014-11-09,Sunday,20:30,CHI,14,GB,55,Home,41,69
2014111000,2014,10,2014-11-10,Monday,20:30,CAR,21,PHI,45,Home,24,66
2014111300,2014,11,2014-11-13,Thursday,20:25,BUF,9,MIA,22,Home,13,31
2014111600,2014,11,2014-11-16,Sunday,13:00,ATL,19,CAR,17,Home,-2,36
2014111601,2014,11,2014-11-16,Sunday,13:00,MIN,13,CHI,21,Home,8,34
2014111602,2014,11,2014-11-16,Sunday,13:00,HOU,23,CLE,7,Home,-16,30
2014111603,2014,11,2014-11-16,Sunday,16:25,PHI,20,GB,53,Home,33,73
2014111604,2014,11,2014-11-16,Sunday,13:00,SEA,20,KC,24,Home,4,44
2014111605,2014,11,2014-11-16,Sunday,13:00,CIN,27,NO,10,Home,-17,37
2014111606,2014,11,2014-11-16,Sunday,13:00,SF,16,NYG,10,Home,-6,26
2014111607,2014,11,2014-11-16,Sunday,13:00,DEN,7,STL,22,Home,15,29
2014111608,2014,11,2014-11-16,Sunday,13:00,TB,27,WAS,7,Home,-20,34
2014111609,2014,11,2014-11-16,Sunday,16:05,OAK,6,SD,13,Home,7,19
2014111610,2014,11,2014-11-16,Sunday,16:25,DET,6,ARI,14,Home,8,20
2014111611,2014,11,2014-11-16,Sunday,20:30,NE,42,IND,20,Home,-22,62
2014111700,2014,11,2014-11-17,Monday,20:30,PIT,27,TEN,24,Home,-3,51
2014112000,2014,12,2014-11-20,Thursday,20:25,KC,20,OAK,24,Home,4,44
2014112300,2014,12,2014-11-23,Sunday,13:00,CLE,26,ATL,24,Home,-2,50
2014112301,2014,12,2014-11-24,Monday,19:00,NYJ,3,BUF,38,Neutral,35,41
2014112302,2014,12,2014-11-23,Sunday,13:00,TB,13,CHI,21,Home,8,34
2014112303,2014,12,2014-11-23,Sunday,13:00,CIN,22,HOU,13,Home,-9,35
2014112304,2014,12,2014-11-23,Sunday,13:00,JAX,3,IND,23,Home,20,26
2014112305,2014,12,2014-11-23,Sunday,13:00,GB,24,MIN,21,Home,-3,45
2014112306,2014,12,2014-11-23,Sunday,13:00,DET,9,NE,34,Home,25,43
2014112307,2014,12,2014-11-23,Sunday,13:00,TEN,24,PHI,43,Home,19,67
2014112308,2014,12,2014-11-23,Sunday,16:05,STL,24,SD,27,Home,3,51
2014112309,2014,12,2014-11-23,Sunday,16:05,ARI,3,SEA,19,Home,16,22
2014112310,2014,12,2014-11-23,Sunday,16:25,MIA,36,DEN,39,Home,3,75
2014112311,2014,12,2014-11-23,Sunday,16:25,WAS,13,SF,17,Home,4,30
2014112312,2014,12,2014-11-23,Sunday,20:30,DAL,31,NYG,28,Home,-3,59
2014112400,2014,12,2014-11-24,Monday,20:30,BAL,34,NO,27,Home,-7,61
2014112700,2014,13,2014-11-27,Thursday,12:30,CHI,17,DET,34,Home,17,51
2014112701,2014,13,2014-11-27,Thursday,16:30,PHI,33,DAL,10,Home,-23,43
2014112702,2014,13,2014-11-27,Thursday,20:30,SEA,19,SF,3,Home,-16,22
2014113000,2014,13,2014-11-30,Sunday,13:00,SD,34,BAL,33,Home,-1,67
2014113001,2014,13,2014-11-30,Sunday,13:00,CLE,10,BUF,26,Home,16,36
2014113002,2014,13,2014-11-30,Sunday,13:00,TEN,21,HOU,45,Home,24,66
2014113003,2014,13,2014-11-30,Sunday,13:00,WAS,27,IND,49,Home,22,76
2014113004,2014,13,2014-11-30,Sunday,13:00,NYG,24,JAX,25,Home,1,49
2014113005,2014,13,2014-11-30,Sunday,13:00,CAR,13,MIN,31,Home,18,44
2014113006,2014,13,2014-11-30,Sunday,13:00,NO,35,PIT,32,Home,-3,67
2014113007,2014,13,2014-11-30,Sunday,13:00,OAK,0,STL,52,Home,52,52
2014113008,2014,13,2014-11-30,Sunday,13:00,CIN,14,TB,13,Home,-1,27
2014113009,2014,13,2014-11-30,Sunday,16:05,ARI,18,ATL,29,Home,11,47
2014113010,2014,13,2014-11-30,Sunday,16:25,NE,21,GB,26,Home,5,47
2014113011,2014,13,2014-11-30,Sunday,20:30,DEN,29,KC,16,Home,-13,45
2014120100,2014,13,2014-12-01,Monday,20:30,MIA,16,NYJ,13,Home,-3,29
2014120400,2014,14,2014-12-04,Thursday,20:25,DAL,41,CHI,28,Home,-13,69
2014120700,2014,14,2014-12-07,Sunday,13:00,PIT,42,CIN,21,Home,-21,63
2014120701,2014,14,2014-12-07,Sunday,13:00,IND,25,CLE,24,Home,-1,49
2014120702,2014,14,2014-12-07,Sunday,13:00,TB,17,DET,34,Home,17,51
2014120703,2014,14,2014-12-07,Sunday,13:00,HOU,27,JAX,13,Home,-14,40
2014120704,2014,14,2014-12-07,Sunday,13:00,BAL,28,MIA,13,Home,-15,41
2014120705,2014,14,2014-12-07,Sunday,13:00,NYJ,24,MIN,30,Home,6,54
2014120706,2014,14,2014-12-07,Sunday,13:00,CAR,41,NO,10,Home,-31,51
2014120707,2014,14,2014-12-07,Sunday,13:00,NYG,36,TEN,7,Home,-29,43
2014120708,2014,14,2014-12-07,Sunday,13:00,STL,24,WAS,0,Home,-24,24
2014120709,2014,14,2014-12-07,Sunday,16:05,KC,14,ARI,17,Home,3,31
2014120710,2014,14,2014-12-07,Sunday,16:05,BUF,17,DEN,24,Home,7,41
2014120711,2014,14,2014-12-07,Sunday,16:25,SF,13,OAK,24,Home,11,37
2014120712,2014,14,2014-12-07,Sunday,16:25,SEA,24,PHI,14,Home,-10,38
2014120713,2014,14,2014-12-07,Sunday,20:30,NE,23,SD,14,Home,-9,37
2014120800,2014,14,2014-12-08,Monday,20:30,ATL,37,GB,43,Home,6,80
2014121100,2014,15,2014-12-11,Thursday,20:25,ARI,12,STL,6,Home,-6,18
2014121400,2014,15,2014-12-14,Sunday,13:00,PIT,27,ATL,20,Home,-7,47
2014121401,2014,15,2014-12-14,Sunday,13:00,JAX,12,BAL,20,Home,8,32
2014121402,2014,15,2014-12-14,Sunday,13:00,GB,13,BUF,21,Home,8,34
2014121403,2014,15,2014-12-14,Sunday,13:00,TB,17,CAR,19,Home,2,36
2014121404,2014,15,2014-12-14,Sunday,13:00,CIN,30,CLE,0,Home,-30,30
2014121405,2014,15,2014-12-14,Sunday,16:25,MIN,14,DET,16,Home,2,30
2014121406,2014,15,2014-12-14,Sunday,13:00,HOU,10,IND,17,Home,7,27
2014121407,2014,15,2014-12-14,Sunday,13:00,OAK,13,KC,31,Home,18,44
2014121408,2014,15,2014-12-14,Sunday,13:00,MIA,13,NE,41,Home,28,54
2014121409,2014,15,2014-12-14,Sunday,13:00,WAS,13,NYG,24,Home,11,37
2014121410,2014,15,2014-12-14,Sunday,16:05,DEN,22,SD,10,Home,-12,32
2014121411,2014,15,2014-12-14,Sunday,16:05,NYJ,16,TEN,11,Home,-5,27
2014121412,2014,15,2014-12-14,Sunday,16:25,SF,7,SEA,17,Home,10,24
2014121413,2014,15,2014-12-14,Sunday,20:30,DAL,38,PHI,27,Home,-11,65
2014121500,2014,15,2014-12-15,Monday,20:30,NO,31,CHI,15,Home,-16,46
2014121800,2014,16,2014-12-18,Thursday,20:25,TEN,13,JAX,21,Home,8,34
2014122000,2014,16,2014-12-20,Saturday,16:25,PHI,24,WAS,27,Home,3,51
2014122001,2014,16,2014-12-20,Saturday,20:25,SD,38,SF,35,Home,-3,73
2014122100,2014,16,2014-12-21,Sunday,13:00,CLE,13,CAR,17,Home,4,30
2014122101,2014,16,2014-12-21,Sunday,13:00,DET,20,CHI,14,Home,-6,34
2014122102,2014,16,2014-12-21,Sunday,13:00,BAL,13,HOU,25,Home,12,38
2014122103,2014,16,2014-12-21,Sunday,13:00,MIN,35,MIA,37,Home,2,72
2014122104,2014,16,2014-12-21,Sunday,13:00,ATL,30,NO,14,Home,-16,44
2014122105,2014,16,2014-12-21,Sunday,13:00,NE,17,NYJ,16,Home,-1,33
2014122106,2014,16,2014-12-21,Sunday,13:00,KC,12,PIT,20,Home,8,32
2014122107,2014,16,2014-12-21,Sunday,13:00,GB,20,TB,3,Home,-17,23
2014122108,2014,16,2014-12-21,Sunday,16:05,NYG,37,STL,27,Home,-10,64
2014122109,2014,16,2014-12-21,Sunday,16:25,IND,7,DAL,42,Home,35,49
2014122110,2014,16,2014-12-21,Sunday,16:25,BUF,24,OAK,26,Home,2,50
2014122111,2014,16,2014-12-21,Sunday,20:30,SEA,35,ARI,6,Home,-29,41
2014122200,2014,16,2014-12-22,Monday,20:30,DEN,28,CIN,37,Home,9,65
2014122800,2014,17,2014-12-28,Sunday,16:25,CAR,34,ATL,3,Home,-31,37
2014122801,2014,17,2014-12-28,Sunday,13:00,CLE,10,BAL,20,Home,10,30
2014122802,2014,17,2014-12-28,Sunday,16:25,DET,20,GB,30,Home,10,50
2014122803,2014,17,2014-12-28,Sunday,13:00,JAX,17,HOU,23,Home,6,40
2014122804,2014,17,2014-12-28,Sunday,13:00,SD,7,KC,19,Home,12,26
2014122805,2014,17,2014-12-28,Sunday,13:00,NYJ,37,MIA,24,Home,-13,61
2014122806,2014,17,2014-12-28,Sunday,13:00,CHI,9,MIN,13,Home,4,22
2014122807,2014,17,2014-12-28,Sunday,13:00,BUF,17,NE,9,Home,-8,26
2014122808,2014,17,2014-12-28,Sunday,13:00,PHI,34,NYG,26,Home,-8,60
2014122809,2014,17,2014-12-28,Sunday,20:30,CIN,17,PIT,27,Home,10,44
2014122810,2014,17,2014-12-28,Sunday,13:00,NO,23,TB,20,Home,-3,43
2014122811,2014,17,2014-12-28,Sunday,13:00,IND,27,TEN,10,Home,-17,37
2014122812,2014,17,2014-12-28,Sunday,13:00,DAL,44,WAS,17,Home,-27,61
2014122813,2014,17,2014-12-28,Sunday,16:25,OAK,14,DEN,47,Home,33,61
2014122814,2014,17,2014-12-28,Sunday,16:25,ARI,17,SF,20,Home,3,37
2014122815,2014,17,2014-12-28,Sunday,16:25,STL,6,SEA,20,Home,14,26
2015010300,2014,18,2015-01-03,Saturday,16:35,ARI,16,CAR,27,Home,11,43
2015010301,2014,18,2015-01-03,Saturday,20:15,BAL,30,PIT,17,Home,-13,47
2015010400,2014,18,2015-01-04,Sunday,13:05,CIN,10,IND,26,Home,16,36
2015010401,2014,18,2015-01-04,Sunday,16:40,DET,20,DAL,24,Home,4,44
2015011000,2014,19,2015-01-10,Saturday,16:35,BAL,31,NE,35,Home,4,66
2015011001,2014,19,2015-01-10,Saturday,20:15,CAR,17,SEA,31,Home,14,48
2015011100,2014,19,2015-01-11,Sunday,13:05,DAL,21,GB,26,Home,5,47
2015011101,2014,19,2015-01-11,Sunday,16:40,IND,24,DEN,13,Home,-11,37
2015011800,2014,20,2015-01-18,Sunday,15:05,GB,22,SEA,28,Home,6,50
2015011801,2014,20,2015-01-18,Sunday,18:50,IND,7,NE,45,Home,38,52
2015020100,2014,21,2015-02-01,Sunday,18:30,NE,28,SEA,24,Neutral,-4,52
2015091000,2015,1,2015-09-10,Thursday,20:30,PIT,21,NE,28,Home,7,49
2015091300,2015,1,2015-09-13,Sunday,13:00,GB,31,CHI,23,Home,-8,54
2015091301,2015,1,2015-09-13,Sunday,13:00,SEA,31,STL,34,Home,3,65
2015091302,2015,1,2015-09-13,Sunday,13:00,CAR,20,JAX,9,Home,-11,29
2015091303,2015,1,2015-09-13,Sunday,13:00,MIA,17,WAS,10,Home,-7,27
2015091304,2015,1,2015-09-13,Sunday,13:00,IND,14,BUF,27,Home,13,41
2015091305,2015,1,2015-09-13,Sunday,13:00,CLE,10,NYJ,31,Home,21,41
2015091306,2015,1,2015-09-13,Sunday,13:00,KC,27,HOU,20,Home,-7,47
2015091307,2015,1,2015-09-13,Sunday,16:05,NO,19,ARI,31,Home,12,50
2015091308,2015,1,2015-09-13,Sunday,16:05,DET,28,SD,33,Home,5,61
2015091309,2015,1,2015-09-13,Sunday,16:25,BAL,13,DEN,19,Home,6,32
2015091310,2015,1,2015-09-13,Sunday,16:25,CIN,33,OAK,13,Home,-20,46
2015091311,2015,1,2015-09-13,Sunday,16:25,TEN,42,TB,14,Home,-28,56
2015091312,2015,1,2015-09-13,Sunday,20:30,NYG,26,DAL,27,Home,1,53
2015091400,2015,1,2015-09-14,Monday,19:10,PHI,24,ATL,26,Home,2,50
2015091401,2015,1,2015-09-14,Monday,22:20,MIN,3,SF,20,Home,17,23
2015091700,2015,2,2015-09-17,Thursday,20:25,DEN,31,KC,24,Home,-7,55
2015092000,2015,2,2015-09-20,Sunday,13:00,HOU,17,CAR,24,Home,7,41
2015092001,2015,2,2015-09-20,Sunday,13:00,NE,40,BUF,32,Home,-8,72
2015092002,2015,2,2015-09-20,Sunday,13:00,SD,19,CIN,24,Home,5,43
2015092003,2015,2,2015-09-20,Sunday,13:00,TEN,14,CLE,28,Home,14,42
2015092004,2015,2,2015-09-20,Sunday,13:00,ATL,24,NYG,20,Home,-4,44
2015092005,2015,2,2015-09-20,Sunday,13:00,STL,10,WAS,24,Home,14,34
2015092006,2015,2,2015-09-20,Sunday,13:00,ARI,48,CHI,23,Home,-25,71
2015092007,2015,2,2015-09-20,Sunday,13:00,DET,16,MIN,26,Home,10,42
2015092008,2015,2,2015-09-20,Sunday,13:00,TB,26,NO,19,Home,-7,45
2015092009,2015,2,2015-09-20,Sunday,13:00,SF,18,PIT,43,Home,25,61
2015092010,2015,2,2015-09-20,Sunday,16:05,BAL,33,OAK,37,Home,4,70
2015092011,2015,2,2015-09-20,Sunday,16:05,MIA,20,JAX,23,Home,3,43
2015092012,2015,2,2015-09-20,Sunday,16:25,DAL,20,PHI,10,Home,-10,30
2015092013,2015,2,2015-09-20,Sunday,20:30,SEA,17,GB,27,Home,10,44
2015092100,2015,2,2015-09-21,Monday,20:30,NYJ,20,IND,7,Home,-13,27
2015092400,2015,3,2015-09-24,Thursday,20:25,WAS,21,NYG,32,Home,11,53
2015092700,2015,3,2015-09-27,Sunday,13:00,ATL,39,DAL,28,Home,-11,67
2015092701,2015,3,2015-09-27,Sunday,13:00,NO,22,CAR,27,Home,5,49
2015092702,2015,3,2015-09-27,Sunday,13:00,PHI,24,NYJ,17,Home,-7,41
2015092703,2015,3,2015-09-27,Sunday,13:00,TB,9,HOU,19,Home,10,28
2015092704,2015,3,2015-09-27,Sunday,13:00,SD,14,MIN,31,Home,17,45
2015092705,2015,3,2015-09-27,Sunday,13:00,PIT,12,STL,6,Home,-6,18
2015092706,2015,3,2015-09-27,Sunday,13:00,JAX,17,NE,51,Home,34,68
2015092707,2015,3,2015-09-27,Sunday,13:00,CIN,28,BAL,24,Home,-4,52
2015092708,2015,3,2015-09-27,Sunday,13:00,OAK,27,CLE,20,Home,-7,47
2015092709,2015,3,2015-09-27,Sunday,13:00,IND,35,TEN,33,Home,-2,68
2015092710,2015,3,2015-09-27,Sunday,16:05,SF,7,ARI,47,Home,40,54
2015092711,2015,3,2015-09-27,Sunday,16:25,CHI,0,SEA,26,Home,26,26
2015092712,2015,3,2015-09-27,Sunday,16:25,BUF,41,MIA,14,Home,-27,55
2015092713,2015,3,2015-09-27,Sunday,20:30,DEN,24,DET,12,Home,-12,36
2015092800,2015,3,2015-09-28,Monday,20:30,KC,28,GB,38,Home,10,66
2015100100,2015,4,2015-10-01,Thursday,20:25,BAL,23,PIT,20,Home,-3,43
2015100400,2015,4,2015-10-04,Sunday,09:30,NYJ,27,MIA,14,Neutral,-13,41
2015100401,2015,4,2015-10-04,Sunday,13:00,OAK,20,CHI,22,Home,2,42
2015100402,2015,4,2015-10-04,Sunday,13:00,HOU,21,ATL,48,Home,27,69
2015100403,2015,4,2015-10-04,Sunday,13:00,KC,21,CIN,36,Home,15,57
2015100404,2015,4,2015-10-04,Sunday,13:00,JAX,13,IND,16,Home,3,29
2015100405,2015,4,2015-10-04,Sunday,13:00,PHI,20,WAS,23,Home,3,43
2015100406,2015,4,2015-10-04,Sunday,13:00,CAR,37,TB,23,Home,-14,60
2015100407,2015,4,2015-10-04,Sunday,13:00,NYG,24,BUF,10,Home,-14,34
2015100408,2015,4,2015-10-04,Sunday,16:05,CLE,27,SD,30,Home,3,57
2015100409,2015,4,2015-10-04,Sunday,16:25,GB,17,SF,3,Home,-14,20
2015100410,2015,4,2015-10-04,Sunday,16:25,STL,24,ARI,22,Home,-2,46
2015100411,2015,4,2015-10-04,Sunday,16:25,MIN,20,DEN,23,Home,3,43
2015100412,2015,4,2015-10-04,Sunday,20:30,DAL,20,NO,26,Home,6,46
2015100500,2015,4,2015-10-05,Monday,20:30,DET,10,SEA,13,Home,3,23
2015100800,2015,5,2015-10-08,Thursday,20:25,IND,27,HOU,20,Home,-7,47
2015101100,2015,5,2015-10-11,Sunday,13:00,NO,17,PHI,39,Home,22,56
2015101101,2015,5,2015-10-11,Sunday,13:00,CHI,18,KC,17,Home,-1,35
2015101102,2015,5,2015-10-11,Sunday,13:00,SEA,24,CIN,27,Home,3,51
2015101103,2015,5,2015-10-11,Sunday,13:00,WAS,19,ATL,25,Home,6,44
2015101104,2015,5,2015-10-11,Sunday,13:00,JAX,31,TB,38,Home,7,69
2015101105,2015,5,2015-10-11,Sunday,13:00,CLE,33,BAL,30,Home,-3,63
2015101106,2015,5,2015-10-11,Sunday,13:00,BUF,14,TEN,13,Home,-1,27
2015101107,2015,5,2015-10-11,Sunday,13:00,STL,10,GB,24,Home,14,34
2015101108,2015,5,2015-10-11,Sunday,16:05,ARI,42,DET,17,Home,-25,59
2015101109,2015,5,2015-10-11,Sunday,16:25,NE,30,DAL,6,Home,-24,36
2015101110,2015,5,2015-10-11,Sunday,16:25,DEN,16,OAK,10,Home,-6,26
2015101111,2015,5,2015-10-11,Sunday,20:30,SF,27,NYG,30,Home,3,57
2015101200,2015,5,2015-10-12,Monday,20:30,PIT,24,SD,20,Home,-4,44
2015101500,2015,6,2015-10-15,Thursday,20:25,ATL,21,NO,31,Home,10,52
2015101800,2015,6,2015-10-18,Sunday,13:00,CHI,34,DET,37,Home,3,71
2015101801,2015,6,2015-10-18,Sunday,13:00,WAS,20,NYJ,34,Home,14,54
2015101802,2015,6,2015-10-18,Sunday,13:00,ARI,21,PIT,31,Home,10,52
2015101803,2015,6,2015-10-18,Sunday,13:00,KC,10,MIN,16,Home,6,26
2015101804,2015,6,2015-10-18,Sunday,13:00,CIN,34,BUF,21,Home,-13,55
2015101805,2015,6,2015-10-18,Sunday,13:00,DEN,26,CLE,23,Home,-3,49
2015101806,2015,6,2015-10-18,Sunday,13:00,MIA,38,TEN,10,Home,-28,48
2015101807,2015,6,2015-10-18,Sunday,13:00,HOU,31,JAX,20,Home,-11,51
2015101808,2015,6,2015-10-18,Sunday,16:05,CAR,27,SEA,23,Home,-4,50
2015101809,2015,6,2015-10-18,Sunday,16:25,SD,20,GB,27,Home,7,47
2015101810,2015,6,2015-10-18,Sunday,16:25,BAL,20,SF,25,Home,5,45
2015101811,2015,6,2015-10-18,Sunday,20:30,NE,34,IND,27,Home,-7,61
2015101900,2015,6,2015-10-19,Monday,20:30,NYG,7,PHI,27,Home,20,34
2015102200,2015,7,2015-10-22,Thursday,20:25,SEA,20,SF,3,Home,-17,23
2015102500,2015,7,2015-10-25,Sunday,09:30,BUF,31,JAX,34,Neutral,3,65
2015102501,2015,7,2015-10-25,Sunday,13:00,CLE,6,STL,24,Home,18,30
2015102502,2015,7,2015-10-25,Sunday,13:00,HOU,26,MIA,44,Home,18,70
2015102503,2015,7,2015-10-25,Sunday,13:00,NYJ,23,NE,30,Home,7,53
2015102504,2015,7,2015-10-25,Sunday,13:00,PIT,13,KC,23,Home,10,36
2015102505,2015,7,2015-10-25,Sunday,13:00,TB,30,WAS,31,Home,1,61
2015102506,2015,7,2015-10-25,Sunday,13:00,MIN,28,DET,19,Home,-9,47
2015102507,2015,7,2015-10-25,Sunday,13:00,NO,27,IND,21,Home,-6,48
2015102508,2015,7,2015-10-25,Sunday,13:00,ATL,10,TEN,7,Home,-3,17
2015102509,2015,7,2015-10-25,Sunday,16:05,OAK,37,SD,29,Home,-8,66
2015102510,2015,7,2015-10-25,Sunday,16:25,DAL,20,NYG,27,Home,7,47
2015102511,2015,7,2015-10-25,Sunday,20:30,PHI,16,CAR,27,Home,11,43
2015102600,2015,7,2015-10-26,Monday,20:30,BAL,18,ARI,26,Home,8,44
2015102900,2015,8,2015-10-29,Thursday,20:25,MIA,7,NE,36,Home,29,43
2015110100,2015,8,2015-11-01,Sunday,09:30,DET,10,KC,45,Neutral,35,55
2015110101,2015,8,2015-11-01,Sunday,13:00,SD,26,BAL,29,Home,3,55
2015110102,2015,8,2015-11-01,Sunday,13:00,CIN,16,PIT,10,Home,-6,26
2015110103,2015,8,2015-11-01,Sunday,13:00,TEN,6,HOU,20,Home,14,26
2015110104,2015,8,2015-11-01,Sunday,13:00,MIN,23,CHI,20,Home,-3,43
2015110105,2015,8,2015-11-01,Sunday,13:00,TB,23,ATL,20,Home,-3,43
2015110106,2015,8,2015-11-01,Sunday,13:00,NYG,49,NO,52,Home,3,101
2015110107,2015,8,2015-11-01,Sunday,13:00,SF,6,STL,27,Home,21,33
2015110108,2015,8,2015-11-01,Sunday,13:00,ARI,34,CLE,20,Home,-14,54
2015110109,2015,8,2015-11-01,Sunday,16:05,NYJ,20,OAK,34,Home,14,54
2015110110,2015,8,2015-11-01,Sunday,16:25,SEA,13,DAL,12,Home,-1,25
2015110111,2015,8,2015-11-01,Sunday,20:30,GB,10,DEN,29,Home,19,39
2015110200,2015,8,2015-11-02,Monday,20:30,IND,26,CAR,29,Home,3,55
2015110500,2015,9,2015-11-05,Thursday,20:25,CLE,10,CIN,31,Home,21,41
2015110800,2015,9,2015-11-08,Sunday,13:00,STL,18,MIN,21,Home,3,39
2015110801,2015,9,2015-11-08,Sunday,13:00,GB,29,CAR,37,Home,8,66
2015110802,2015,9,2015-11-08,Sunday,13:00,WAS,10,NE,27,Home,17,37
2015110803,2015,9,2015-11-08,Sunday,13:00,TEN,34,NO,28,Home,-6,62
2015110804,2015,9,2015-11-08,Sunday,13:00,MIA,17,BUF,33,Home,16,50
2015110805,2015,9,2015-11-08,Sunday,13:00,JAX,23,NYJ,28,Home,5,51
2015110806,2015,9,2015-11-08,Sunday,13:00,OAK,35,PIT,38,Home,3,73
2015110807,2015,9,2015-11-08,Sunday,16:05,NYG,32,TB,18,Home,-14,50
2015110808,2015,9,2015-11-08,Sunday,16:05,ATL,16,SF,17,Home,1,33
2015110809,2015,9,2015-11-08,Sunday,16:25,DEN,24,IND,27,Home,3,51
2015110810,2015,9,2015-11-08,Sunday,20:30,PHI,18,DAL,21,Home,3,39
2015110900,2015,9,2015-11-09,Monday,20:30,CHI,22,SD,19,Home,-3,41
2015111200,2015,10,2015-11-12,Thursday,20:25,BUF,22,NYJ,17,Home,-5,39
2015111500,2015,10,2015-11-15,Sunday,13:00,NO,14,WAS,47,Home,33,61
2015111501,2015,10,2015-11-15,Sunday,13:00,DET,18,GB,16,Home,-2,34
2015111502,2015,10,2015-11-15,Sunday,13:00,DAL,6,TB,10,Home,4,16
2015111503,2015,10,2015-11-15,Sunday,13:00,CAR,27,TEN,10,Home,-17,37
2015111504,2015,10,2015-11-15,Sunday,13:00,CHI,37,STL,13,Home,-24,50
2015111505,2015,10,2015-11-15,Sunday,13:00,MIA,20,PHI,19,Home,-1,39
2015111506,2015,10,2015-11-15,Sunday,13:00,JAX,22,BAL,20,Home,-2,42
2015111507,2015,10,2015-11-15,Sunday,13:00,CLE,9,PIT,30,Home,21,39
2015111508,2015,10,2015-11-15,Sunday,16:05,MIN,30,OAK,14,Home,-16,44
2015111509,2015,10,2015-11-15,Sunday,16:25,NE,27,NYG,26,Home,-1,53
2015111510,2015,10,2015-11-15,Sunday,16:25,KC,29,DEN,13,Home,-16,42
2015111511,2015,10,2015-11-15,Sunday,20:30,ARI,39,SEA,32,Home,-7,71
2015111600,2015,10,2015-11-16,Monday,20:30,HOU,10,CIN,6,Home,-4,16
2015111900,2015,11,2015-11-19,Thursday,20:25,TEN,13,JAX,19,Home,6,32
2015112200,2015,11,2015-11-22,Sunday,13:00,DEN,17,CHI,15,Home,-2,32
2015112201,2015,11,2015-11-22,Sunday,13:00,OAK,13,DET,18,Home,5,31
2015112202,2015,11,2015-11-22,Sunday,13:00,IND,24,ATL,21,Home,-3,45
2015112203,2015,11,2015-11-22,Sunday,13:00,NYJ,17,HOU,24,Home,7,41
2015112204,2015,11,2015-11-22,Sunday,13:00,TB,45,PHI,17,Home,-28,62
2015112205,2015,11,2015-11-22,Sunday,16:25,GB,30,MIN,13,Home,-17,43
2015112206,2015,11,2015-11-22,Sunday,13:00,WAS,16,CAR,44,Home,28,60
2015112207,2015,11,2015-11-22,Sunday,13:00,DAL,24,MIA,14,Home,-10,38
2015112208,2015,11,2015-11-22,Sunday,13:00,STL,13,BAL,16,Home,3,29
2015112209,2015,11,2015-11-22,Sunday,20:30,CIN,31,ARI,34,Home,3,65
2015112210,2015,11,2015-11-22,Sunday,16:25,SF,13,SEA,29,Home,16,42
2015112211,2015,11,2015-11-22,Sunday,16:05,KC,33,SD,3,Home,-30,36
2015112300,2015,11,2015-11-23,Monday,20:30,BUF,13,NE,20,Home,7,33
2015112600,2015,12,2015-11-26,Thursday,12:30,PHI,14,DET,45,Home,31,59
2015112601,2015,12,2015-11-26,Thursday,16:30,CAR,33,DAL,14,Home,-19,47
2015112602,2015,12,2015-11-26,Thursday,20:30,CHI,17,GB,13,Home,-4,30
2015112900,2015,12,2015-11-29,Sunday,13:00,NYG,14,WAS,20,Home,6,34
2015112901,2015,12,2015-11-29,Sunday,13:00,MIN,20,ATL,10,Home,-10,30
2015112902,2015,12,2015-11-29,Sunday,13:00,STL,7,CIN,31,Home,24,38
2015112903,2015,12,2015-11-29,Sunday,13:00,NO,6,HOU,24,Home,18,30
2015112904,2015,12,2015-11-29,Sunday,13:00,TB,12,IND,25,Home,13,37
2015112905,2015,12,2015-11-29,Sunday,13:00,MIA,20,NYJ,38,Home,18,58
2015112906,2015,12,2015-11-29,Sunday,13:00,SD,31,JAX,25,Home,-6,56
2015112907,2015,12,2015-11-29,Sunday,13:00,OAK,24,TEN,21,Home,-3,45
2015112908,2015,12,2015-11-29,Sunday,13:00,BUF,22,KC,30,Home,8,52
2015112909,2015,12,2015-11-29,Sunday,16:05,ARI,19,SF,13,Home,-6,32
2015112910,2015,12,2015-11-29,Sunday,16:25,PIT,30,SEA,39,Home,9,69
2015112911,2015,12,2015-11-29,Sunday,20:30,NE,24,DEN,30,Home,6,54
2015113000,2015,12,2015-11-30,Monday,20:30,BAL,33,CLE,27,Home,-6,60
2015120300,2015,13,2015-12-03,Thursday,20:25,GB,27,DET,23,Home,-4,50
2015120600,2015,13,2015-12-06,Sunday,13:00,NYJ,23,NYG,20,Home,-3,43
2015120601,2015,13,2015-12-06,Sunday,13:00,HOU,21,BUF,30,Home,9,51
2015120602,2015,13,2015-12-06,Sunday,13:00,BAL,13,MIA,15,Home,2,28
2015120603,2015,13,2015-12-06,Sunday,13:00,CIN,37,CLE,3,Home,-34,40
2015120604,2015,13,2015-12-06,Sunday,13:00,JAX,39,TEN,42,Home,3,81
2015120605,2015,13,2015-12-06,Sunday,13:00,SF,26,CHI,20,Home,-6,46
2015120606,2015,13,2015-12-06,Sunday,13:00,SEA,38,MIN,7,Home,-31,45
2015120607,2015,13,2015-12-06,Sunday,16:25,CAR,41,NO,38,Home,-3,79
2015120608,2015,13,2015-12-06,Sunday,13:00,ATL,19,TB,23,Home,4,42
2015120609,2015,13,2015-12-06,Sunday,13:00,ARI,27,STL,3,Home,-24,30
2015120610,2015,13,2015-12-06,Sunday,16:05,KC,34,OAK,20,Home,-14,54
2015120611,2015,13,2015-12-06,Sunday,16:05,DEN,17,SD,3,Home,-14,20
2015120612,2015,13,2015-12-06,Sunday,16:25,PHI,35,NE,28,Home,-7,63
2015120613,2015,13,2015-12-06,Sunday,20:30,IND,10,PIT,45,Home,35,55
2015120700,2015,13,2015-12-07,Monday,20:30,DAL,19,WAS,16,Home,-3,35
2015121000,2015,14,2015-12-10,Thursday,20:25,MIN,20,ARI,23,Home,3,43
2015121300,2015,14,2015-12-13,Sunday,13:00,BUF,20,PHI,23,Home,3,43
2015121301,2015,14,2015-12-13,Sunday,13:00,TEN,8,NYJ,30,Home,22,38
2015121302,2015,14,2015-12-13,Sunday,13:00,PIT,33,CIN,20,Home,-13,53
2015121303,2015,14,2015-12-13,Sunday,20:30,NE,27,HOU,6,Home,-21,33
2015121304,2015,14,2015-12-13,Sunday,13:00,IND,16,JAX,51,Home,35,67
2015121305,2015,14,2015-12-13,Sunday,13:00,SD,3,KC,10,Home,7,13
2015121306,2015,14,2015-12-13,Sunday,13:00,WAS,24,CHI,21,Home,-3,45
2015121307,2015,14,2015-12-13,Sunday,13:00,ATL,0,CAR,38,Home,38,38
2015121308,2015,14,2015-12-13,Sunday,13:00,NO,24,TB,17,Home,-7,41
2015121309,2015,14,2015-12-13,Sunday,13:00,DET,14,STL,21,Home,7,35
2015121310,2015,14,2015-12-13,Sunday,13:00,SF,10,CLE,24,Home,14,34
2015121311,2015,14,2015-12-13,Sunday,16:05,OAK,15,DEN,12,Home,-3,27
2015121312,2015,14,2015-12-13,Sunday,16:25,DAL,7,GB,28,Home,21,35
2015121313,2015,14,2015-12-13,Sunday,13:00,SEA,35,BAL,6,Home,-29,41
2015121400,2015,14,2015-12-14,Monday,20:30,NYG,31,MIA,24,Home,-7,55
2015121700,2015,15,2015-12-17,Thursday,20:25,TB,23,STL,31,Home,8,54
2015121900,2015,15,2015-12-19,Saturday,20:25,NYJ,19,DAL,16,Home,-3,35
2015122000,2015,15,2015-12-20,Sunday,13:00,CAR,38,NYG,35,Home,-3,73
2015122001,2015,15,2015-12-20,Sunday,20:30,ARI,40,PHI,17,Home,-23,57
2015122002,2015,15,2015-12-20,Sunday,13:00,CHI,17,MIN,38,Home,21,55
2015122003,2015,15,2015-12-20,Sunday,13:00,ATL,23,JAX,17,Home,-6,40
2015122004,2015,15,2015-12-20,Sunday,13:00,HOU,16,IND,10,Home,-6,26
2015122005,2015,15,2015-12-20,Sunday,13:00,TEN,16,NE,33,Home,17,49
2015122006,2015,15,2015-12-20,Sunday,13:00,KC,38,BAL,35,Home,-3,73
2015122007,2015,15,2015-12-20,Sunday,13:00,BUF,25,WAS,35,Home,10,60
2015122008,2015,15,2015-12-20,Sunday,16:05,CLE,13,SEA,30,Home,17,43
2015122009,2015,15,2015-12-20,Sunday,16:05,GB,30,OAK,20,Home,-10,50
2015122010,2015,15,2015-12-20,Sunday,16:25,DEN,27,PIT,34,Home,7,61
2015122011,2015,15,2015-12-20,Sunday,16:25,MIA,14,SD,30,Home,16,44
2015122012,2015,15,2015-12-20,Sunday,16:25,CIN,24,SF,14,Home,-10,38
2015122100,2015,15,2015-12-21,Monday,20:30,DET,35,NO,27,Home,-8,62
2015122400,2015,16,2015-12-24,Thursday,20:25,SD,20,OAK,23,Home,3,43
2015122600,2015,16,2015-12-26,Saturday,20:25,WAS,38,PHI,24,Home,-14,62
2015122700,2015,16,2015-12-27,Sunday,16:05,JAX,27,NO,38,Home,11,65
2015122701,2015,16,2015-12-27,Sunday,13:00,IND,18,MIA,12,Home,-6,30
2015122702,2015,16,2015-12-27,Sunday,13:00,NE,20,NYJ,26,Home,6,46
2015122703,2015,16,2015-12-27,Sunday,13:00,HOU,34,TEN,6,Home,-28,40
2015122704,2015,16,2015-12-27,Sunday,13:00,CLE,13,KC,17,Home,4,30
2015122705,2015,16,2015-12-27,Sunday,13:00,SF,17,DET,32,Home,15,49
2015122706,2015,16,2015-12-27,Sunday,20:30,NYG,17,MIN,49,Home,32,66
2015122707,2015,16,2015-12-27,Sunday,13:00,CAR,13,ATL,20,Home,7,33
2015122708,2015,16,2015-12-27,Sunday,13:00,CHI,26,TB,21,Home,-5,47
2015122709,2015,16,2015-12-27,Sunday,13:00,DAL,6,BUF,16,Home,10,22
2015122710,2015,16,2015-12-27,Sunday,16:25,GB,8,ARI,38,Home,30,46
2015122711,2015,16,2015-12-27,Sunday,16:25,STL,23,SEA,17,Home,-6,40
2015122712,2015,16,2015-12-27,Sunday,13:00,PIT,17,BAL,20,Home,3,37
2015122800,2015,16,2015-12-28,Monday,20:30,CIN,17,DEN,20,Home,3,37
2016010300,2015,17,2016-01-03,Sunday,13:00,NYJ,17,BUF,22,Home,5,39
2016010301,2015,17,2016-01-03,Sunday,13:00,NE,10,MIA,20,Home,10,30
2016010302,2015,17,2016-01-03,Sunday,13:00,BAL,16,CIN,24,Home,8,40
2016010303,2015,17,2016-01-03,Sunday,13:00,PIT,28,CLE,12,Home,-16,40
2016010304,2015,17,2016-01-03,Sunday,13:00,JAX,6,HOU,30,Home,24,36
2016010305,2015,17,2016-01-03,Sunday,13:00,TEN,24,IND,30,Home,6,54
2016010306,2015,17,2016-01-03,Sunday,16:25,OAK,17,KC,23,Home,6,40
2016010307,2015,17,2016-01-03,Sunday,13:00,WAS,34,DAL,23,Home,-11,57
2016010308,2015,17,2016-01-03,Sunday,13:00,PHI,35,NYG,30,Home,-5,65
2016010309,2015,17,2016-01-03,Sunday,13:00,DET,24,CHI,20,Home,-4,44
2016010310,2015,17,2016-01-03,Sunday,20:30,MIN,20,GB,13,Home,-7,33
2016010311,2015,17,2016-01-03,Sunday,13:00,NO,20,ATL,17,Home,-3,37
2016010312,2015,17,2016-01-03,Sunday,16:25,TB,10,CAR,38,Home,28,48
2016010313,2015,17,2016-01-03,Sunday,16:25,SD,20,DEN,27,Home,7,47
2016010314,2015,17,2016-01-03,Sunday,16:25,SEA,36,ARI,6,Home,-30,42
2016010315,2015,17,2016-01-03,Sunday,16:25,STL,16,SF,19,Home,3,35
2016010900,2015,18,2016-01-09,Saturday,16:35,KC,30,HOU,0,Home,-30,30
2016010901,2015,18,2016-01-09,Saturday,20:15,PIT,18,CIN,16,Home,-2,34
2016011000,2015,18,2016-01-10,Sunday,13:05,SEA,10,MIN,9,Home,-1,19
2016011001,2015,18,2016-01-10,Sunday,16:40,GB,35,WAS,18,Home,-17,53
2016011600,2015,19,2016-01-16,Saturday,16:35,KC,20,NE,27,Home,7,47
2016011601,2015,19,2016-01-16,Saturday,20:15,GB,20,ARI,26,Home,6,46
2016011700,2015,19,2016-01-17,Sunday,13:05,SEA,24,CAR,31,Home,7,55
2016011701,2015,19,2016-01-17,Sunday,16:40,PIT,16,DEN,23,Home,7,39
2016012400,2015,20,2016-01-24,Sunday,15:05,NE,18,DEN,20,Home,2,38
2016012401,2015,20,2016-01-24,Sunday,18:40,ARI,15,CAR,49,Home,34,64
2016020700,2015,21,2016-02-07,Sunday,18:30,CAR,10,DEN,24,Neutral,14,34
2016090800,2016,1,2016-09-08,Thursday,20:30,CAR,20,DEN,21,Home,1,41
2016091100,2016,1,2016-09-11,Sunday,13:00,TB,31,ATL,24,Home,-7,55
2016091101,2016,1,2016-09-11,Sunday,13:00,BUF,7,BAL,13,Home,6,20
2016091102,2016,1,2016-09-11,Sunday,13:00,CHI,14,HOU,23,Home,9,37
2016091103,2016,1,2016-09-11,Sunday,13:00,GB,27,JAX,23,Home,-4,50
2016091104,2016,1,2016-09-11,Sunday,13:00,SD,27,KC,33,Home,6,60
2016091105,2016,1,2016-09-11,Sunday,13:00,OAK,35,NO,34,Home,-1,69
2016091106,2016,1,2016-09-11,Sunday,13:00,CIN,23,NYJ,22,Home,-1,45
2016091107,2016,1,2016-09-11,Sunday,13:00,CLE,10,PHI,29,Home,19,39
2016091108,2016,1,2016-09-11,Sunday,13:00,MIN,25,TEN,21,Home,-4,46
2016091109,2016,1,2016-09-11,Sunday,16:05,MIA,10,SEA,12,Home,2,22
2016091110,2016,1,2016-09-11,Sunday,16:25,NYG,20,DAL,19,Home,-1,39
2016091111,2016,1,2016-09-11,Sunday,16:25,DET,39,IND,35,Home,-4,74
2016091112,2016,1,2016-09-11,Sunday,20:30,NE,23,ARI,21,Home,-2,44
2016091200,2016,1,2016-09-12,Monday,19:10,PIT,38,WAS,16,Home,-22,54
2016091201,2016,1,2016-09-12,Monday,22:20,LAR,0,SF,28,Home,28,28
2016091500,2016,2,2016-09-15,Thursday,20:25,NYJ,37,BUF,31,Home,-6,68
2016091800,2016,2,2016-09-18,Sunday,13:00,SF,27,CAR,46,Home,19,73
2016091801,2016,2,2016-09-18,Sunday,13:00,BAL,25,CLE,20,Home,-5,45
2016091802,2016,2,2016-09-18,Sunday,13:00,TEN,16,DET,15,Home,-1,31
2016091803,2016,2,2016-09-18,Sunday,13:00,KC,12,HOU,19,Home,7,31
2016091804,2016,2,2016-09-18,Sunday,13:00,MIA,24,NE,31,Home,7,55
2016091805,2016,2,2016-09-18,Sunday,13:00,NO,13,NYG,16,Home,3,29
2016091806,2016,2,2016-09-18,Sunday,13:00,CIN,16,PIT,24,Home,8,40
2016091807,2016,2,2016-09-18,Sunday,13:00,DAL,27,WAS,23,Home,-4,50
2016091808,2016,2,2016-09-18,Sunday,13:00,TB,7,ARI,40,Home,33,47
2016091809,2016,2,2016-09-18,Sunday,16:05,SEA,3,LAR,9,Home,6,12
2016091810,2016,2,2016-09-18,Sunday,16:25,IND,20,DEN,34,Home,14,54
2016091811,2016,2,2016-09-18,Sunday,16:25,ATL,35,OAK,28,Home,-7,63
2016091812,2016,2,2016-09-18,Sunday,16:25,JAX,14,SD,38,Home,24,52
2016091813,2016,2,2016-09-18,Sunday,20:30,GB,14,MIN,17,Home,3,31
2016091900,2016,2,2016-09-19,Monday,20:30,PHI,29,CHI,14,Home,-15,43
2016092200,2016,3,2016-09-22,Thursday,20:25,HOU,0,NE,27,Home,27,27
2016092500,2016,3,2016-09-25,Sunday,13:00,ARI,18,BUF,33,Home,15,51
2016092501,2016,3,2016-09-25,Sunday,13:00,MIN,22,CAR,10,Home,-12,32
2016092502,2016,3,2016-09-25,Sunday,13:00,DEN,29,CIN,17,Home,-12,46
2016092503,2016,3,2016-09-25,Sunday,13:00,DET,27,GB,34,Home,7,61
2016092504,2016,3,2016-09-25,Sunday,13:00,BAL,19,JAX,17,Home,-2,36
2016092505,2016,3,2016-09-25,Sunday,13:00,CLE,24,MIA,30,Home,6,54
2016092506,2016,3,2016-09-25,Sunday,13:00,WAS,29,NYG,27,Home,-2,56
2016092507,2016,3,2016-09-25,Sunday,13:00,OAK,17,TEN,10,Home,-7,27
2016092508,2016,3,2016-09-25,Sunday,16:05,SF,18,SEA,37,Home,19,55
2016092509,2016,3,2016-09-25,Sunday,16:05,LAR,37,TB,32,Home,-5,69
2016092510,2016,3,2016-09-25,Sunday,16:25,PIT,3,PHI,34,Home,31,37
2016092511,2016,3,2016-09-25,Sunday,16:25,SD,22,IND,26,Home,4,48
2016092512,2016,3,2016-09-25,Sunday,16:25,NYJ,3,KC,24,Home,21,27
2016092513,2016,3,2016-09-25,Sunday,20:30,CHI,17,DAL,31,Home,14,48
2016092600,2016,3,2016-09-26,Monday,20:30,ATL,45,NO,32,Home,-13,77
2016092900,2016,4,2016-09-29,Thursday,20:25,MIA,7,CIN,22,Home,15,29
2016100200,2016,4,2016-10-02,Sunday,09:30,IND,27,JAX,30,Neutral,3,57
2016100201,2016,4,2016-10-02,Sunday,13:00,CAR,33,ATL,48,Home,15,81
2016100202,2016,4,2016-10-02,Sunday,13:00,OAK,28,BAL,27,Home,-1,55
2016100203,2016,4,2016-10-02,Sunday,13:00,DET,14,CHI,17,Home,3,31
2016100204,2016,4,2016-10-02,Sunday,13:00,TEN,20,HOU,27,Home,7,47
2016100205,2016,4,2016-10-02,Sunday,13:00,BUF,16,NE,0,Home,-16,16
2016100206,2016,4,2016-10-02,Sunday,13:00,SEA,27,NYJ,17,Home,-10,44
2016100207,2016,4,2016-10-02,Sunday,13:00,CLE,20,WAS,31,Home,11,51
2016100208,2016,4,2016-10-02,Sunday,16:05,DEN,27,TB,7,Home,-20,34
2016100209,2016,4,2016-10-02,Sunday,16:25,LAR,17,ARI,13,Home,-4,30
2016100210,2016,4,2016-10-02,Sunday,16:25,NO,35,SD,34,Home,-1,69
2016100211,2016,4,2016-10-02,Sunday,16:25,DAL,24,SF,17,Home,-7,41
2016100212,2016,4,2016-10-02,Sunday,20:30,KC,14,PIT,43,Home,29,57
2016100300,2016,4,2016-10-03,Monday,20:30,NYG,10,MIN,24,Home,14,34
2016100600,2016,5,2016-10-06,Thursday,20:25,ARI,33,SF,21,Home,-12,54
2016100900,2016,5,2016-10-09,Sunday,13:00,WAS,16,BAL,10,Home,-6,26
2016100901,2016,5,2016-10-09,Sunday,13:00,NE,33,CLE,21,Home,-12,54
2016100902,2016,5,2016-10-09,Sunday,13:00,PHI,23,DET,24,Home,1,47
2016100903,2016,5,2016-10-09,Sunday,13:00,CHI,23,IND,29,Home,6,52
2016100904,2016,5,2016-10-09,Sunday,13:00,TEN,30,MIA,17,Home,-13,47
2016100905,2016,5,2016-10-09,Sunday,13:00,HOU,13,MIN,31,Home,18,44
2016100906,2016,5,2016-10-09,Sunday,13:00,NYJ,13,PIT,31,Home,18,44
2016100907,2016,5,2016-10-09,Sunday,16:05,ATL,23,DEN,16,Home,-7,39
2016100908,2016,5,2016-10-09,Sunday,16:25,CIN,14,DAL,28,Home,14,42
2016100909,2016,5,2016-10-09,Sunday,16:25,BUF,30,LAR,19,Home,-11,49
2016100910,2016,5,2016-10-09,Sunday,16:25,SD,31,OAK,34,Home,3,65
2016100911,2016,5,2016-10-09,Sunday,20:30,NYG,16,GB,23,Home,7,39
2016101000,2016,5,2016-10-10,Monday,20:30,TB,17,CAR,14,Home,-3,31
2016101300,2016,6,2016-10-13,Thursday,20:25,DEN,13,SD,21,Home,8,34
2016101600,2016,6,2016-10-16,Sunday,13:00,SF,16,BUF,45,Home,29,61
2016101601,2016,6,2016-10-16,Sunday,13:00,JAX,17,CHI,16,Home,-1,33
2016101602,2016,6,2016-10-16,Sunday,13:00,LAR,28,DET,31,Home,3,59
2016101603,2016,6,2016-10-16,Sunday,13:00,PIT,15,MIA,30,Home,15,45
2016101604,2016,6,2016-10-16,Sunday,13:00,CIN,17,NE,35,Home,18,52
2016101605,2016,6,2016-10-16,Sunday,13:00,CAR,38,NO,41,Home,3,79
2016101606,2016,6,2016-10-16,Sunday,13:00,BAL,23,NYG,27,Home,4,50
2016101607,2016,6,2016-10-16,Sunday,13:00,CLE,26,TEN,28,Home,2,54
2016101608,2016,6,2016-10-16,Sunday,13:00,PHI,20,WAS,27,Home,7,47
2016101609,2016,6,2016-10-16,Sunday,16:05,KC,26,OAK,10,Home,-16,36
2016101610,2016,6,2016-10-16,Sunday,16:25,DAL,30,GB,16,Home,-14,46
2016101611,2016,6,2016-10-16,Sunday,16:25,ATL,24,SEA,26,Home,2,50
2016101612,2016,6,2016-10-16,Sunday,20:30,IND,23,HOU,26,Home,3,49
2016101700,2016,6,2016-10-17,Monday,20:30,NYJ,3,ARI,28,Home,25,31
2016102000,2016,7,2016-10-20,Thursday,20:25,CHI,10,GB,26,Home,16,36
2016102300,2016,7,2016-10-23,Sunday,09:30,NYG,17,LAR,10,Neutral,-7,27
2016102301,2016,7,2016-10-23,Sunday,13:00,CLE,17,CIN,31,Home,14,48
2016102302,2016,7,2016-10-23,Sunday,13:00,WAS,17,DET,20,Home,3,37
2016102303,2016,7,2016-10-23,Sunday,13:00,OAK,33,JAX,16,Home,-17,49
2016102304,2016,7,2016-10-23,Sunday,13:00,NO,21,KC,27,Home,6,48
2016102305,2016,7,2016-10-23,Sunday,13:00,BUF,25,MIA,28,Home,3,53
2016102306,2016,7,2016-10-23,Sunday,13:00,BAL,16,NYJ,24,Home,8,40
2016102307,2016,7,2016-10-23,Sunday,13:00,MIN,10,PHI,21,Home,11,31
2016102308,2016,7,2016-10-23,Sunday,13:00,IND,34,TEN,26,Home,-8,60
2016102309,2016,7,2016-10-23,Sunday,16:05,SD,33,ATL,30,Home,-3,63
2016102310,2016,7,2016-10-23,Sunday,16:05,TB,34,SF,17,Home,-17,51
2016102311,2016,7,2016-10-23,Sunday,16:25,NE,27,PIT,16,Home,-11,43
2016102312,2016,7,2016-10-23,Sunday,20:30,SEA,6,ARI,6,Home,0,12
2016102400,2016,7,2016-10-24,Monday,20:30,HOU,9,DEN,27,Home,18,36
2016102700,2016,8,2016-10-27,Thursday,20:25,JAX,22,TEN,36,Home,14,58
2016103000,2016,8,2016-10-30,Sunday,09:30,WAS,27,CIN,27,Neutral,0,54
2016103001,2016,8,2016-10-30,Sunday,16:25,GB,32,ATL,33,Home,1,65
2016103002,2016,8,2016-10-30,Sunday,13:00,NE,41,BUF,25,Home,-16,66
2016103003,2016,8,2016-10-30,Sunday,13:00,NYJ,31,CLE,28,Home,-3,59
2016103004,2016,8,2016-10-30,Sunday,13:00,DET,13,HOU,20,Home,7,33
2016103005,2016,8,2016-10-30,Sunday,13:00,KC,30,IND,14,Home,-16,44
2016103006,2016,8,2016-10-30,Sunday,13:00,SEA,20,NO,25,Home,5,45
2016103007,2016,8,2016-10-30,Sunday,13:00,OAK,30,TB,24,Home,-6,54
2016103008,2016,8,2016-10-30,Sunday,16:05,SD,19,DEN,27,Home,8,46
2016103009,2016,8,2016-10-30,Sunday,13:00,ARI,20,CAR,30,Home,10,50
2016103010,2016,8,2016-10-30,Sunday,20:30,PHI,23,DAL,29,Home,6,52
2016103100,2016,8,2016-10-31,Monday,20:30,MIN,10,CHI,20,Home,10,30
2016110300,2016,9,2016-11-03,Thursday,20:25,ATL,43,TB,28,Home,-15,71
2016110600,2016,9,2016-11-06,Sunday,20:30,DEN,20,OAK,30,Home,10,50
2016110601,2016,9,2016-11-06,Sunday,13:00,PIT,14,BAL,21,Home,7,35
2016110602,2016,9,2016-11-06,Sunday,13:00,DAL,35,CLE,10,Home,-25,45
2016110603,2016,9,2016-11-06,Sunday,13:00,JAX,14,KC,19,Home,5,33
2016110604,2016,9,2016-11-06,Sunday,13:00,NYJ,23,MIA,27,Home,4,50
2016110605,2016,9,2016-11-06,Sunday,13:00,DET,22,MIN,16,Home,-6,38
2016110606,2016,9,2016-11-06,Sunday,13:00,PHI,23,NYG,28,Home,5,51
2016110607,2016,9,2016-11-06,Sunday,16:05,CAR,13,LAR,10,Home,-3,23
2016110608,2016,9,2016-11-06,Sunday,16:05,NO,41,SF,23,Home,-18,64
2016110609,2016,9,2016-11-06,Sunday,16:25,IND,31,GB,26,Home,-5,57
2016110610,2016,9,2016-11-06,Sunday,16:25,TEN,35,SD,43,Home,8,78
2016110700,2016,9,2016-11-07,Monday,20:30,BUF,25,SEA,31,Home,6,56
2016111000,2016,10,2016-11-10,Thursday,20:25,CLE,7,BAL,28,Home,21,35
2016111301,2016,10,2016-11-13,Sunday,13:00,KC,20,CAR,17,Home,-3,37
2016111302,2016,10,2016-11-13,Sunday,13:00,HOU,24,JAX,21,Home,-3,45
2016111303,2016,10,2016-11-13,Sunday,13:00,DEN,25,NO,23,Home,-2,48
2016111304,2016,10,2016-11-13,Sunday,13:00,LAR,9,NYJ,6,Home,-3,15
2016111305,2016,10,2016-11-13,Sunday,13:00,ATL,15,PHI,24,Home,9,39
2016111306,2016,10,2016-11-13,Sunday,13:00,CHI,10,TB,36,Home,26,46
2016111307,2016,10,2016-11-13,Sunday,13:00,GB,25,TEN,47,Home,22,72
2016111308,2016,10,2016-11-13,Sunday,13:00,MIN,20,WAS,26,Home,6,46
2016111309,2016,10,2016-11-13,Sunday,16:05,MIA,31,SD,24,Home,-7,55
2016111310,2016,10,2016-11-13,Sunday,16:25,SF,20,ARI,23,Home,3,43
2016111311,2016,10,2016-11-13,Sunday,16:25,DAL,35,PIT,30,Home,-5,65
2016111312,2016,10,2016-11-13,Sunday,20:30,SEA,31,NE,24,Home,-7,55
2016111400,2016,10,2016-11-14,Monday,20:30,CIN,20,NYG,21,Home,1,41
2016111700,2016,11,2016-11-17,Thursday,20:25,NO,20,CAR,23,Home,3,43
2016112000,2016,11,2016-11-20,Sunday,13:00,BUF,16,CIN,12,Home,-4,28
2016112001,2016,11,2016-11-20,Sunday,13:00,PIT,24,CLE,9,Home,-15,33
2016112002,2016,11,2016-11-20,Sunday,13:00,BAL,17,DAL,27,Home,10,44
2016112003,2016,11,2016-11-20,Sunday,13:00,JAX,19,DET,26,Home,7,45
2016112004,2016,11,2016-11-20,Sunday,13:00,TEN,17,IND,24,Home,7,41
2016112005,2016,11,2016-11-20,Sunday,13:00,TB,19,KC,17,Home,-2,36
2016112006,2016,11,2016-11-20,Sunday,13:00,ARI,24,MIN,30,Home,6,54
2016112007,2016,11,2016-11-20,Sunday,13:00,CHI,16,NYG,22,Home,6,38
2016112008,2016,11,2016-11-20,Sunday,16:05,MIA,14,LAR,10,Home,-4,24
2016112009,2016,11,2016-11-20,Sunday,16:25,NE,30,SF,17,Home,-13,47
2016112010,2016,11,2016-11-20,Sunday,16:25,PHI,15,SEA,26,Home,11,41
2016112011,2016,11,2016-11-20,Sunday,20:30,GB,24,WAS,42,Home,18,66
2016112100,2016,11,2016-11-21,Monday,20:30,HOU,20,OAK,27,Neutral,7,47
2016112400,2016,12,2016-11-24,Thursday,12:30,MIN,13,DET,16,Home,3,29
2016112401,2016,12,2016-11-24,Thursday,16:30,WAS,26,DAL,31,Home,5,57
2016112402,2016,12,2016-11-24,Thursday,20:30,PIT,28,IND,7,Home,-21,35
2016112700,2016,12,2016-11-27,Sunday,13:00,ARI,19,ATL,38,Home,19,57
2016112701,2016,12,2016-11-27,Sunday,13:00,CIN,14,BAL,19,Home,5,33
2016112702,2016,12,2016-11-27,Sunday,13:00,JAX,21,BUF,28,Home,7,49
2016112703,2016,12,2016-11-27,Sunday,13:00,TEN,27,CHI,21,Home,-6,48
2016112704,2016,12,2016-11-27,Sunday,13:00,NYG,27,CLE,13,Home,-14,40
2016112705,2016,12,2016-11-27,Sunday,13:00,SD,21,HOU,13,Home,-8,34
2016112706,2016,12,2016-11-27,Sunday,13:00,SF,24,MIA,31,Home,7,55
2016112707,2016,12,2016-11-27,Sunday,13:00,LAR,21,NO,49,Home,28,70
2016112708,2016,12,2016-11-27,Sunday,16:05,SEA,5,TB,14,Home,9,19
2016112709,2016,12,2016-11-27,Sunday,20:30,KC,30,DEN,27,Home,-3,57
2016112710,2016,12,2016-11-27,Sunday,16:25,CAR,32,OAK,35,Home,3,67
2016112711,2016,12,2016-11-27,Sunday,16:25,NE,22,NYJ,17,Home,-5,39
2016112800,2016,12,2016-11-28,Monday,20:30,GB,27,PHI,13,Home,-14,40
2016120100,2016,13,2016-12-01,Thursday,20:25,DAL,17,MIN,15,Home,-2,32
2016120400,2016,13,2016-12-04,Sunday,13:00,KC,29,ATL,28,Home,-1,57
2016120401,2016,13,2016-12-04,Sunday,13:00,MIA,6,BAL,38,Home,32,44
2016120402,2016,13,2016-12-04,Sunday,13:00,SF,6,CHI,26,Home,20,32
2016120403,2016,13,2016-12-04,Sunday,13:00,PHI,14,CIN,32,Home,18,46
2016120404,2016,13,2016-12-04,Sunday,13:00,HOU,13,GB,21,Home,8,34
2016120405,2016,13,2016-12-04,Sunday,13:00,DEN,20,JAX,10,Home,-10,30
2016120406,2016,13,2016-12-04,Sunday,13:00,LAR,10,NE,26,Home,16,36
2016120407,2016,13,2016-12-04,Sunday,13:00,DET,28,NO,13,Home,-15,41
2016120408,2016,13,2016-12-04,Sunday,16:05,BUF,24,OAK,38,Home,14,62
2016120409,2016,13,2016-12-04,Sunday,16:25,WAS,23,ARI,31,Home,8,54
2016120410,2016,13,2016-12-04,Sunday,16:25,NYG,14,PIT,24,Home,10,38
2016120411,2016,13,2016-12-04,Sunday,16:25,TB,28,SD,21,Home,-7,49
2016120412,2016,13,2016-12-04,Sunday,20:30,CAR,7,SEA,40,Home,33,47
2016120500,2016,13,2016-12-05,Monday,20:30,IND,41,NYJ,10,Home,-31,51
2016120800,2016,14,2016-12-08,Thursday,20:25,OAK,13,KC,21,Home,8,34
2016121100,2016,14,2016-12-11,Sunday,13:00,PIT,27,BUF,20,Home,-7,47
2016121101,2016,14,2016-12-11,Sunday,13:00,SD,16,CAR,28,Home,12,44
2016121102,2016,14,2016-12-11,Sunday,13:00,CIN,23,CLE,10,Home,-13,33
2016121103,2016,14,2016-12-11,Sunday,13:00,CHI,17,DET,20,Home,3,37
2016121104,2016,14,2016-12-11,Sunday,13:00,HOU,22,IND,17,Home,-5,39
2016121105,2016,14,2016-12-11,Sunday,13:00,MIN,25,JAX,16,Home,-9,41
2016121106,2016,14,2016-12-11,Sunday,13:00,ARI,23,MIA,26,Home,3,49
2016121107,2016,14,2016-12-11,Sunday,13:00,WAS,27,PHI,22,Home,-5,49
2016121108,2016,14,2016-12-11,Sunday,16:25,NO,11,TB,16,Home,5,27
2016121109,2016,14,2016-12-11,Sunday,13:00,DEN,10,TEN,13,Home,3,23
2016121110,2016,14,2016-12-11,Sunday,16:05,NYJ,23,SF,17,Home,-6,40
2016121111,2016,14,2016-12-11,Sunday,16:25,SEA,10,GB,38,Home,28,48
2016121112,2016,14,2016-12-11,Sunday,16:25,ATL,42,LAR,14,Home,-28,56
2016121113,2016,14,2016-12-11,Sunday,20:30,DAL,7,NYG,10,Home,3,17
2016121200,2016,14,2016-12-12,Monday,20:30,BAL,23,NE,30,Home,7,53
2016121500,2016,15,2016-12-15,Thursday,20:25,LAR,3,SEA,24,Home,21,27
2016121700,2016,15,2016-12-17,Saturday,20:25,MIA,34,NYJ,13,Home,-21,47
2016121800,2016,15,2016-12-18,Sunday,13:00,PHI,26,BAL,27,Home,1,53
2016121801,2016,15,2016-12-18,Sunday,13:00,CLE,13,BUF,33,Home,20,46
2016121802,2016,15,2016-12-18,Sunday,13:00,GB,30,CHI,27,Home,-3,57
2016121803,2016,15,2016-12-18,Sunday,20:30,TB,20,DAL,26,Home,6,46
2016121804,2016,15,2016-12-18,Sunday,13:00,JAX,20,HOU,21,Home,1,41
2016121805,2016,15,2016-12-18,Sunday,13:00,TEN,19,KC,17,Home,-2,36
2016121806,2016,15,2016-12-18,Sunday,13:00,IND,34,MIN,6,Home,-28,40
2016121807,2016,15,2016-12-18,Sunday,13:00,DET,6,NYG,17,Home,11,23
2016121808,2016,15,2016-12-18,Sunday,16:05,NO,48,ARI,41,Home,-7,89
2016121809,2016,15,2016-12-18,Sunday,16:05,SF,13,ATL,41,Home,28,54
2016121810,2016,15,2016-12-18,Sunday,16:25,NE,16,DEN,3,Home,-13,19
2016121811,2016,15,2016-12-18,Sunday,16:25,OAK,19,SD,16,Home,-3,35
2016121812,2016,15,2016-12-18,Sunday,13:00,PIT,24,CIN,20,Home,-4,44
2016121900,2016,15,2016-12-19,Monday,20:30,CAR,26,WAS,15,Home,-11,41
2016122200,2016,16,2016-12-22,Thursday,20:25,NYG,19,PHI,24,Home,5,43
2016122400,2016,16,2016-12-24,Saturday,13:00,MIA,34,BUF,31,Home,-3,65
2016122401,2016,16,2016-12-24,Saturday,13:00,ATL,33,CAR,16,Home,-17,49
2016122402,2016,16,2016-12-24,Saturday,13:00,WAS,41,CHI,21,Home,-20,62
2016122403,2016,16,2016-12-24,Saturday,13:00,SD,17,CLE,20,Home,3,37
2016122404,2016,16,2016-12-24,Saturday,13:00,MIN,25,GB,38,Home,13,63
2016122405,2016,16,2016-12-24,Saturday,13:00,TEN,17,JAX,38,Home,21,55
2016122406,2016,16,2016-12-24,Saturday,13:00,NYJ,3,NE,41,Home,38,44
2016122407,2016,16,2016-12-24,Saturday,16:25,TB,24,NO,31,Home,7,55
2016122408,2016,16,2016-12-24,Saturday,16:05,IND,25,OAK,33,Home,8,58
2016122409,2016,16,2016-12-24,Saturday,16:25,SF,22,LAR,21,Home,-1,43
2016122410,2016,16,2016-12-24,Saturday,16:25,ARI,34,SEA,31,Home,-3,65
2016122411,2016,16,2016-12-24,Saturday,20:25,CIN,10,HOU,12,Home,2,22
2016122500,2016,16,2016-12-25,Sunday,16:30,BAL,27,PIT,31,Home,4,58
2016122501,2016,16,2016-12-25,Sunday,20:30,DEN,10,KC,33,Home,23,43
2016122600,2016,16,2016-12-26,Monday,20:30,DET,21,DAL,42,Home,21,63
2017010100,2016,17,2017-01-01,Sunday,16:25,NO,32,ATL,38,Home,6,70
2017010101,2016,17,2017-01-01,Sunday,13:00,BAL,10,CIN,27,Home,17,37
2017010102,2016,17,2017-01-01,Sunday,20:30,GB,31,DET,24,Home,-7,55
2017010103,2016,17,2017-01-01,Sunday,13:00,JAX,20,IND,24,Home,4,44
2017010104,2016,17,2017-01-01,Sunday,13:00,NE,35,MIA,14,Home,-21,49
2017010105,2016,17,2017-01-01,Sunday,13:00,CHI,10,MIN,38,Home,28,48
2017010106,2016,17,2017-01-01,Sunday,13:00,BUF,10,NYJ,30,Home,20,40
2017010107,2016,17,2017-01-01,Sunday,13:00,DAL,13,PHI,27,Home,14,40
2017010108,2016,17,2017-01-01,Sunday,13:00,CLE,24,PIT,27,Home,3,51
2017010109,2016,17,2017-01-01,Sunday,13:00,CAR,16,TB,17,Home,1,33
2017010110,2016,17,2017-01-01,Sunday,13:00,HOU,17,TEN,24,Home,7,41
2017010111,2016,17,2017-01-01,Sunday,16:25,NYG,19,WAS,10,Home,-9,29
2017010112,2016,17,2017-01-01,Sunday,16:25,OAK,6,DEN,24,Home,18,30
2017010113,2016,17,2017-01-01,Sunday,16:25,ARI,44,LAR,6,Home,-38,50
2017010114,2016,17,2017-01-01,Sunday,16:25,KC,37,SD,27,Home,-10,64
2017010115,2016,17,2017-01-01,Sunday,16:25,SEA,25,SF,23,Home,-2,48
2017010700,2016,18,2017-01-07,Saturday,16:35,OAK,14,HOU,27,Home,13,41
2017010701,2016,18,2017-01-07,Saturday,20:15,DET,6,SEA,26,Home,20,32
2017010800,2016,18,2017-01-08,Sunday,13:05,MIA,12,PIT,30,Home,18,42
2017010801,2016,18,2017-01-08,Sunday,16:40,NYG,13,GB,38,Home,25,51
2017011400,2016,19,2017-01-14,Saturday,16:35,SEA,20,ATL,36,Home,16,56
2017011401,2016,19,2017-01-14,Saturday,20:15,HOU,16,NE,34,Home,18,50
2017011500,2016,19,2017-01-15,Sunday,20:20,PIT,18,KC,16,Home,-2,34
2017011501,2016,19,2017-01-15,Sunday,16:40,GB,34,DAL,31,Home,-3,65
2017012200,2016,20,2017-01-22,Sunday,15:05,GB,21,ATL,44,Home,23,65
2017012201,2016,20,2017-01-22,Sunday,18:40,PIT,17,NE,36,Home,19,53
2017020500,2016,21,2017-02-05,Sunday,18:30,NE,34,ATL,28,Neutral,-6,62
2017090700,2017,1,2017-09-07,Thursday,20:30,KC,42,NE,27,Home,-15,69
2017091000,2017,1,2017-09-10,Sunday,13:00,NYJ,12,BUF,21,Home,9,33
2017091001,2017,1,2017-09-10,Sunday,13:00,ATL,23,CHI,17,Home,-6,40
2017091002,2017,1,2017-09-10,Sunday,13:00,BAL,20,CIN,0,Home,-20,20
2017091003,2017,1,2017-09-10,Sunday,13:00,PIT,21,CLE,18,Home,-3,39
2017091004,2017,1,2017-09-10,Sunday,13:00,ARI,23,DET,35,Home,12,58
2017091005,2017,1,2017-09-10,Sunday,13:00,JAX,29,HOU,7,Home,-22,36
2017091007,2017,1,2017-09-10,Sunday,13:00,OAK,26,TEN,16,Home,-10,42
2017091008,2017,1,2017-09-10,Sunday,13:00,PHI,30,WAS,17,Home,-13,47
2017091009,2017,1,2017-09-10,Sunday,16:05,IND,9,LAR,46,Home,37,55
2017091010,2017,1,2017-09-10,Sunday,16:25,SEA,9,GB,17,Home,8,26
2017091011,2017,1,2017-09-10,Sunday,16:25,CAR,23,SF,3,Home,-20,26
2017091012,2017,1,2017-09-10,Sunday,20:30,NYG,3,DAL,19,Home,16,22
2017091100,2017,1,2017-09-11,Monday,19:10,NO,19,MIN,29,Home,10,48
2017091101,2017,1,2017-09-11,Monday,22:20,LAC,21,DEN,24,Home,3,45
2017091400,2017,2,2017-09-14,Thursday,20:25,HOU,13,CIN,9,Home,-4,22
2017091700,2017,2,2017-09-17,Sunday,13:00,CLE,10,BAL,24,Home,14,34
2017091701,2017,2,2017-09-17,Sunday,13:00,BUF,3,CAR,9,Home,6,12
2017091702,2017,2,2017-09-17,Sunday,13:00,ARI,16,IND,13,Home,-3,29
2017091703,2017,2,2017-09-17,Sunday,13:00,TEN,37,JAX,16,Home,-21,53
2017091704,2017,2,2017-09-17,Sunday,13:00,PHI,20,KC,27,Home,7,47
2017091705,2017,2,2017-09-17,Sunday,13:00,NE,36,NO,20,Home,-16,56
2017091706,2017,2,2017-09-17,Sunday,13:00,MIN,9,PIT,26,Home,17,35
2017091707,2017,2,2017-09-17,Sunday,13:00,CHI,7,TB,29,Home,22,36
2017091708,2017,2,2017-09-17,Sunday,16:05,MIA,19,LAC,17,Home,-2,36
2017091709,2017,2,2017-09-17,Sunday,16:05,NYJ,20,OAK,45,Home,25,65
2017091710,2017,2,2017-09-17,Sunday,16:25,DAL,17,DEN,42,Home,25,59
2017091711,2017,2,2017-09-17,Sunday,16:25,WAS,27,LAR,20,Home,-7,47
2017091712,2017,2,2017-09-17,Sunday,16:25,SF,9,SEA,12,Home,3,21
2017091713,2017,2,2017-09-17,Sunday,20:30,GB,23,ATL,34,Home,11,57
2017091800,2017,2,2017-09-18,Monday,20:30,DET,24,NYG,10,Home,-14,34
2017092100,2017,3,2017-09-21,Thursday,20:25,LAR,41,SF,39,Home,-2,80
2017092400,2017,3,2017-09-24,Sunday,21:30,BAL,7,JAX,44,Neutral,37,51
2017092401,2017,3,2017-09-24,Sunday,13:00,DEN,16,BUF,26,Home,10,42
2017092402,2017,3,2017-09-24,Sunday,13:00,NO,34,CAR,13,Home,-21,47
2017092403,2017,3,2017-09-24,Sunday,13:00,PIT,17,CHI,23,Home,6,40
2017092404,2017,3,2017-09-24,Sunday,13:00,ATL,30,DET,26,Home,-4,56
2017092405,2017,3,2017-09-24,Sunday,13:00,CLE,28,IND,31,Home,3,59
2017092406,2017,3,2017-09-24,Sunday,13:00,TB,17,MIN,34,Home,17,51
2017092407,2017,3,2017-09-24,Sunday,13:00,HOU,33,NE,36,Home,3,69
2017092408,2017,3,2017-09-24,Sunday,13:00,MIA,6,NYJ,20,Home,14,26
2017092409,2017,3,2017-09-24,Sunday,13:00,NYG,24,PHI,27,Home,3,51
2017092410,2017,3,2017-09-24,Sunday,16:05,SEA,27,TEN,33,Home,6,60
2017092411,2017,3,2017-09-24,Sunday,16:25,CIN,24,GB,27,Home,3,51
2017092412,2017,3,2017-09-24,Sunday,16:25,KC,24,LAC,10,Home,-14,34
2017092413,2017,3,2017-09-24,Sunday,20:30,OAK,10,WAS,27,Home,17,37
2017092500,2017,3,2017-09-25,Monday,20:30,DAL,28,ARI,17,Home,-11,45
2017092800,2017,4,2017-09-28,Thursday,20:25,CHI,14,GB,35,Home,21,49
2017100100,2017,4,2017-10-01,Sunday,21:30,NO,20,MIA,0,Neutral,-20,20
2017100101,2017,4,2017-10-01,Sunday,13:00,BUF,23,ATL,17,Home,-6,40
2017100102,2017,4,2017-10-01,Sunday,13:00,PIT,26,BAL,9,Home,-17,35
2017100103,2017,4,2017-10-01,Sunday,13:00,CIN,31,CLE,7,Home,-24,38
2017100104,2017,4,2017-10-01,Sunday,13:00,LAR,35,DAL,30,Home,-5,65
2017100105,2017,4,2017-10-01,Sunday,13:00,TEN,14,HOU,57,Home,43,71
2017100106,2017,4,2017-10-01,Sunday,13:00,DET,14,MIN,7,Home,-7,21
2017100107,2017,4,2017-10-01,Sunday,13:00,CAR,33,NE,30,Home,-3,63
2017100108,2017,4,2017-10-01,Sunday,13:00,JAX,20,NYJ,23,Home,3,43
2017100109,2017,4,2017-10-01,Sunday,16:05,SF,15,ARI,18,Home,3,33
2017100110,2017,4,2017-10-01,Sunday,16:05,PHI,26,LAC,24,Home,-2,50
2017100111,2017,4,2017-10-01,Sunday,16:05,NYG,23,TB,25,Home,2,48
2017100112,2017,4,2017-10-01,Sunday,16:25,OAK,10,DEN,16,Home,6,26
2017100113,2017,4,2017-10-01,Sunday,20:30,IND,18,SEA,46,Home,28,64
2017100200,2017,4,2017-10-02,Monday,20:30,WAS,20,KC,29,Home,9,49
2017100500,2017,5,2017-10-05,Thursday,20:25,NE,19,TB,14,Home,-5,33
2017100800,2017,5,2017-10-08,Sunday,13:00,BUF,16,CIN,20,Home,4,36
2017100801,2017,5,2017-10-08,Sunday,13:00,NYJ,17,CLE,14,Home,-3,31
2017100802,2017,5,2017-10-08,Sunday,13:00,CAR,27,DET,24,Home,-3,51
2017100803,2017,5,2017-10-08,Sunday,13:00,SF,23,IND,26,Home,3,49
2017100804,2017,5,2017-10-08,Sunday,13:00,TEN,10,MIA,16,Home,6,26
2017100805,2017,5,2017-10-08,Sunday,13:00,LAC,27,NYG,22,Home,-5,49
2017100806,2017,5,2017-10-08,Sunday,13:00,ARI,7,PHI,34,Home,27,41
2017100807,2017,5,2017-10-08,Sunday,13:00,JAX,30,PIT,9,Home,-21,39
2017100808,2017,5,2017-10-08,Sunday,16:05,SEA,16,LAR,10,Home,-6,26
2017100809,2017,5,2017-10-08,Sunday,16:05,BAL,30,OAK,17,Home,-13,47
2017100810,2017,5,2017-10-08,Sunday,16:25,GB,35,DAL,31,Home,-4,66
2017100811,2017,5,2017-10-08,Sunday,20:30,KC,42,HOU,34,Home,-8,76
2017100900,2017,5,2017-10-09,Monday,20:30,MIN,20,CHI,17,Home,-3,37
2017101200,2017,6,2017-10-12,Thursday,20:25,PHI,28,CAR,23,Home,-5,51
2017101500,2017,6,2017-10-15,Sunday,13:00,MIA,20,ATL,17,Home,-3,37
2017101501,2017,6,2017-10-15,Sunday,13:00,CHI,27,BAL,24,Home,-3,51
2017101502,2017,6,2017-10-15,Sunday,13:00,CLE,17,HOU,33,Home,16,50
2017101503,2017,6,2017-10-15,Sunday,13:00,GB,10,MIN,23,Home,13,33
2017101504,2017,6,2017-10-15,Sunday,13:00,DET,38,NO,52,Home,14,90
2017101505,2017,6,2017-10-15,Sunday,13:00,NE,24,NYJ,17,Home,-7,41
2017101506,2017,6,2017-10-15,Sunday,13:00,SF,24,WAS,26,Home,2,50
2017101507,2017,6,2017-10-15,Sunday,16:05,TB,33,ARI,38,Home,5,71
2017101508,2017,6,2017-10-15,Sunday,16:05,LAR,27,JAX,17,Home,-10,44
2017101509,2017,6,2017-10-15,Sunday,16:25,PIT,19,KC,13,Home,-6,32
2017101510,2017,6,2017-10-15,Sunday,16:25,LAC,17,OAK,16,Home,-1,33
2017101511,2017,6,2017-10-15,Sunday,20:30,NYG,23,DEN,10,Home,-13,33
2017101600,2017,6,2017-10-16,Monday,20:30,IND,22,TEN,36,Home,14,58
2017101900,2017,7,2017-10-19,Thursday,20:25,KC,30,OAK,31,Home,1,61
2017102200,2017,7,2017-10-22,Sunday,13:00,TB,27,BUF,30,Home,3,57
2017102201,2017,7,2017-10-22,Sunday,13:00,CAR,3,CHI,17,Home,14,20
2017102202,2017,7,2017-10-22,Sunday,13:00,TEN,12,CLE,9,Home,-3,21
2017102203,2017,7,2017-10-22,Sunday,13:00,NO,26,GB,17,Home,-9,43
2017102204,2017,7,2017-10-22,Sunday,13:00,JAX,27,IND,0,Home,-27,27
2017102205,2017,7,2017-10-22,Sunday,13:00,ARI,0,LAR,33,Neutral,33,33
2017102206,2017,7,2017-10-22,Sunday,13:00,NYJ,28,MIA,31,Home,3,59
2017102207,2017,7,2017-10-22,Sunday,13:00,BAL,16,MIN,24,Home,8,40
2017102208,2017,7,2017-10-22,Sunday,16:25,CIN,14,PIT,29,Home,15,43
2017102209,2017,7,2017-10-22,Sunday,16:05,DAL,40,SF,10,Home,-30,50
2017102210,2017,7,2017-10-22,Sunday,16:25,DEN,0,LAC,21,Home,21,21
2017102211,2017,7,2017-10-22,Sunday,16:25,SEA,24,NYG,7,Home,-17,31
2017102212,2017,7,2017-10-22,Sunday,20:30,ATL,7,NE,23,Home,16,30
2017102300,2017,7,2017-10-23,Monday,20:30,WAS,24,PHI,34,Home,10,58
2017102600,2017,8,2017-10-26,Thursday,20:25,MIA,0,BAL,40,Home,40,40
2017102900,2017,8,2017-10-29,Sunday,21:30,MIN,33,CLE,16,Neutral,-17,49
2017102901,2017,8,2017-10-29,Sunday,13:00,OAK,14,BUF,34,Home,20,48
2017102902,2017,8,2017-10-29,Sunday,13:00,IND,23,CIN,24,Home,1,47
2017102903,2017,8,2017-10-29,Sunday,13:00,LAC,13,NE,21,Home,8,34
2017102904,2017,8,2017-10-29,Sunday,13:00,CHI,12,NO,20,Home,8,32
2017102905,2017,8,2017-10-29,Sunday,13:00,ATL,25,NYJ,20,Home,-5,45
2017102906,2017,8,2017-10-29,Sunday,13:00,SF,10,PHI,33,Home,23,43
2017102907,2017,8,2017-10-29,Sunday,13:00,CAR,17,TB,3,Home,-14,20
2017102908,2017,8,2017-10-29,Sunday,16:05,HOU,38,SEA,41,Home,3,79
2017102909,2017,8,2017-10-29,Sunday,16:25,DAL,33,WAS,19,Home,-14,52
2017102910,2017,8,2017-10-29,Sunday,20:30,PIT,20,DET,15,Home,-5,35
2017103000,2017,8,2017-10-30,Monday,20:30,DEN,19,KC,29,Home,10,48
2017110200,2017,9,2017-11-02,Thursday,20:25,BUF,21,NYJ,34,Home,13,55
2017110500,2017,9,2017-11-05,Sunday,13:00,ATL,17,CAR,20,Home,3,37
2017110501,2017,9,2017-11-05,Sunday,13:00,IND,20,HOU,14,Home,-6,34
2017110502,2017,9,2017-11-05,Sunday,13:00,CIN,7,JAX,23,Home,16,30
2017110503,2017,9,2017-11-05,Sunday,13:00,TB,10,NO,30,Home,20,40
2017110504,2017,9,2017-11-05,Sunday,13:00,LAR,51,NYG,17,Home,-34,68
2017110505,2017,9,2017-11-05,Sunday,13:00,DEN,23,PHI,51,Home,28,74
2017110506,2017,9,2017-11-05,Sunday,13:00,BAL,20,TEN,23,Home,3,43
2017110507,2017,9,2017-11-05,Sunday,16:05,ARI,20,SF,10,Home,-10,30
2017110508,2017,9,2017-11-05,Sunday,16:05,WAS,17,SEA,14,Home,-3,31
2017110509,2017,9,2017-11-05,Sunday,16:25,KC,17,DAL,28,Home,11,45
2017110510,2017,9,2017-11-05,Sunday,20:30,OAK,27,MIA,24,Home,-3,51
2017110600,2017,9,2017-11-06,Monday,20:30,DET,30,GB,17,Home,-13,47
2017110900,2017,10,2017-11-09,Thursday,20:25,SEA,22,ARI,16,Home,-6,38
2017111200,2017,10,2017-11-12,Sunday,13:00,NO,47,BUF,10,Home,-37,57
2017111201,2017,10,2017-11-12,Sunday,13:00,GB,23,CHI,16,Home,-7,39
2017111202,2017,10,2017-11-12,Sunday,13:00,CLE,24,DET,38,Home,14,62
2017111203,2017,10,2017-11-12,Sunday,13:00,PIT,20,IND,17,Home,-3,37
2017111204,2017,10,2017-11-12,Sunday,13:00,LAC,17,JAX,20,Home,3,37
2017111205,2017,10,2017-11-12,Sunday,13:00,NYJ,10,TB,15,Home,5,25
2017111206,2017,10,2017-11-12,Sunday,13:00,CIN,20,TEN,24,Home,4,44
2017111207,2017,10,2017-11-12,Sunday,13:00,MIN,38,WAS,30,Home,-8,68
2017111208,2017,10,2017-11-12,Sunday,16:05,HOU,7,LAR,33,Home,26,40
2017111209,2017,10,2017-11-12,Sunday,16:25,DAL,7,ATL,27,Home,20,34
2017111210,2017,10,2017-11-12,Sunday,16:25,NYG,21,SF,31,Home,10,52
2017111211,2017,10,2017-11-12,Sunday,20:30,NE,41,DEN,16,Home,-25,57
2017111300,2017,10,2017-11-13,Monday,20:30,MIA,21,CAR,45,Home,24,66
2017111600,2017,11,2017-11-16,Thursday,20:25,TEN,17,PIT,40,Home,23,57
2017111900,2017,11,2017-11-19,Sunday,13:00,DET,27,CHI,24,Home,-3,51
2017111901,2017,11,2017-11-19,Sunday,13:00,JAX,19,CLE,7,Home,-12,26
2017111902,2017,11,2017-11-19,Sunday,13:00,BAL,23,GB,0,Home,-23,23
2017111903,2017,11,2017-11-19,Sunday,13:00,ARI,21,HOU,31,Home,10,52
2017111904,2017,11,2017-11-19,Sunday,13:00,LAR,7,MIN,24,Home,17,31
2017111905,2017,11,2017-11-19,Sunday,13:00,WAS,31,NO,34,Home,3,65
2017111906,2017,11,2017-11-19,Sunday,13:00,KC,9,NYG,12,Home,3,21
2017111907,2017,11,2017-11-19,Sunday,16:05,BUF,24,LAC,54,Home,30,78
2017111908,2017,11,2017-11-19,Sunday,16:25,CIN,20,DEN,17,Home,-3,37
2017111909,2017,11,2017-11-19,Sunday,16:25,NE,33,OAK,8,Neutral,-25,41
2017111910,2017,11,2017-11-19,Sunday,20:30,PHI,37,DAL,9,Home,-28,46
2017111911,2017,11,2017-11-19,Sunday,13:00,TB,30,MIA,20,Home,-10,50
2017112000,2017,11,2017-11-20,Monday,20:30,ATL,34,SEA,31,Home,-3,65
2017112300,2017,12,2017-11-23,Thursday,12:30,MIN,30,DET,23,Home,-7,53
2017112301,2017,12,2017-11-23,Thursday,16:30,LAC,28,DAL,6,Home,-22,34
2017112302,2017,12,2017-11-23,Thursday,20:30,NYG,10,WAS,20,Home,10,30
2017112600,2017,12,2017-11-26,Sunday,13:00,TB,20,ATL,34,Home,14,54
2017112601,2017,12,2017-11-26,Sunday,13:00,CLE,16,CIN,30,Home,14,46
2017112602,2017,12,2017-11-26,Sunday,13:00,TEN,20,IND,16,Home,-4,36
2017112603,2017,12,2017-11-26,Sunday,13:00,BUF,16,KC,10,Home,-6,26
2017112604,2017,12,2017-11-26,Sunday,13:00,MIA,17,NE,35,Home,18,52
2017112605,2017,12,2017-11-26,Sunday,13:00,CAR,35,NYJ,27,Home,-8,62
2017112606,2017,12,2017-11-26,Sunday,13:00,CHI,3,PHI,31,Home,28,34
2017112607,2017,12,2017-11-26,Sunday,16:25,NO,20,LAR,26,Home,6,46
2017112608,2017,12,2017-11-26,Sunday,16:05,SEA,24,SF,13,Home,-11,37
2017112609,2017,12,2017-11-26,Sunday,16:25,JAX,24,ARI,27,Home,3,51
2017112610,2017,12,2017-11-26,Sunday,16:25,DEN,14,OAK,21,Home,7,35
2017112611,2017,12,2017-11-26,Sunday,20:30,GB,28,PIT,31,Home,3,59
2017112700,2017,12,2017-11-27,Monday,20:30,HOU,16,BAL,23,Home,7,39
2017113000,2017,13,2017-11-30,Thursday,20:25,WAS,14,DAL,38,Home,24,52
2017120300,2017,13,2017-12-03,Sunday,13:00,MIN,14,ATL,9,Home,-5,23
2017120301,2017,13,2017-12-03,Sunday,13:00,DET,20,BAL,44,Home,24,64
2017120302,2017,13,2017-12-03,Sunday,13:00,NE,23,BUF,3,Home,-20,26
2017120303,2017,13,2017-12-03,Sunday,13:00,SF,15,CHI,14,Home,-1,29
2017120304,2017,13,2017-12-03,Sunday,13:00,TB,20,GB,26,Home,6,46
2017120305,2017,13,2017-12-03,Sunday,13:00,IND,10,JAX,30,Home,20,40
2017120306,2017,13,2017-12-03,Sunday,13:00,DEN,9,MIA,35,Home,26,44
2017120307,2017,13,2017-12-03,Sunday,16:25,CAR,21,NO,31,Home,10,52
2017120308,2017,13,2017-12-03,Sunday,13:00,KC,31,NYJ,38,Home,7,69
2017120309,2017,13,2017-12-03,Sunday,13:00,HOU,13,TEN,24,Home,11,37
2017120310,2017,13,2017-12-03,Sunday,16:05,CLE,10,LAC,19,Home,9,29
2017120311,2017,13,2017-12-03,Sunday,16:25,LAR,32,ARI,16,Home,-16,48
2017120312,2017,13,2017-12-03,Sunday,16:25,NYG,17,OAK,24,Home,7,41
2017120313,2017,13,2017-12-03,Sunday,20:30,PHI,10,SEA,24,Home,14,34
2017120400,2017,13,2017-12-04,Monday,20:30,PIT,23,CIN,20,Home,-3,43
2017120700,2017,14,2017-12-07,Thursday,20:25,NO,17,ATL,20,Home,3,37
2017121000,2017,14,2017-12-10,Sunday,13:00,IND,7,BUF,13,Home,6,20
2017121001,2017,14,2017-12-10,Sunday,13:00,MIN,24,CAR,31,Home,7,55
2017121002,2017,14,2017-12-10,Sunday,13:00,CHI,33,CIN,7,Home,-26,40
2017121003,2017,14,2017-12-10,Sunday,13:00,GB,27,CLE,21,Home,-6,48
2017121004,2017,14,2017-12-10,Sunday,13:00,SF,26,HOU,16,Home,-10,42
2017121005,2017,14,2017-12-10,Sunday,16:25,SEA,24,JAX,30,Home,6,54
2017121006,2017,14,2017-12-10,Sunday,13:00,OAK,15,KC,26,Home,11,41
2017121007,2017,14,2017-12-10,Sunday,13:00,DET,24,TB,21,Home,-3,45
2017121008,2017,14,2017-12-10,Sunday,16:05,TEN,7,ARI,12,Home,5,19
2017121009,2017,14,2017-12-10,Sunday,16:05,NYJ,0,DEN,23,Home,23,23
2017121010,2017,14,2017-12-10,Sunday,16:05,WAS,13,LAC,30,Home,17,43
2017121011,2017,14,2017-12-10,Sunday,16:25,PHI,43,LAR,35,Home,-8,78
2017121012,2017,14,2017-12-10,Sunday,13:00,DAL,30,NYG,10,Home,-20,40
2017121013,2017,14,2017-12-10,Sunday,20:30,BAL,38,PIT,39,Home,1,77
2017121100,2017,14,2017-12-11,Monday,20:30,NE,20,MIA,27,Home,7,47
2017121400,2017,15,2017-12-14,Thursday,20:25,DEN,25,IND,13,Home,-12,38
2017121600,2017,15,2017-12-16,Saturday,16:30,CHI,10,DET,20,Home,10,30
2017121601,2017,15,2017-12-16,Saturday,20:25,LAC,13,KC,30,Home,17,43
2017121700,2017,15,2017-12-17,Sunday,13:00,MIA,16,BUF,24,Home,8,40
2017121701,2017,15,2017-12-17,Sunday,13:00,GB,24,CAR,31,Home,7,55
2017121702,2017,15,2017-12-17,Sunday,13:00,BAL,27,CLE,10,Home,-17,37
2017121703,2017,15,2017-12-17,Sunday,13:00,HOU,7,JAX,45,Home,38,52
2017121704,2017,15,2017-12-17,Sunday,13:00,CIN,7,MIN,34,Home,27,41
2017121705,2017,15,2017-12-17,Sunday,13:00,NYJ,19,NO,31,Home,12,50
2017121706,2017,15,2017-12-17,Sunday,13:00,PHI,34,NYG,29,Home,-5,63
2017121707,2017,15,2017-12-17,Sunday,13:00,ARI,15,WAS,20,Home,5,35
2017121708,2017,15,2017-12-17,Sunday,16:05,LAR,42,SEA,7,Home,-35,49
2017121709,2017,15,2017-12-17,Sunday,16:25,NE,27,PIT,24,Home,-3,51
2017121710,2017,15,2017-12-17,Sunday,16:25,TEN,23,SF,25,Home,2,48
2017121711,2017,15,2017-12-17,Sunday,20:30,DAL,20,OAK,17,Home,-3,37
2017121800,2017,15,2017-12-18,Monday,20:30,ATL,24,TB,21,Home,-3,45
2017122300,2017,16,2017-12-23,Saturday,16:30,IND,16,BAL,23,Home,7,39
2017122301,2017,16,2017-12-23,Saturday,20:30,MIN,16,GB,0,Home,-16,16
2017122400,2017,16,2017-12-24,Sunday,13:00,TB,19,CAR,22,Home,3,41
2017122401,2017,16,2017-12-24,Sunday,13:00,CLE,3,CHI,20,Home,17,23
2017122402,2017,16,2017-12-24,Sunday,13:00,DET,17,CIN,26,Home,9,43
2017122403,2017,16,2017-12-24,Sunday,13:00,MIA,13,KC,29,Home,16,42
2017122404,2017,16,2017-12-24,Sunday,13:00,BUF,16,NE,37,Home,21,53
2017122405,2017,16,2017-12-24,Sunday,13:00,ATL,13,NO,23,Home,10,36
2017122406,2017,16,2017-12-24,Sunday,13:00,LAC,14,NYJ,7,Home,-7,21
2017122407,2017,16,2017-12-24,Sunday,13:00,LAR,27,TEN,23,Home,-4,50
2017122408,2017,16,2017-12-24,Sunday,13:00,DEN,11,WAS,27,Home,16,38
2017122409,2017,16,2017-12-24,Sunday,16:05,JAX,33,SF,44,Home,11,77
2017122410,2017,16,2017-12-24,Sunday,16:25,NYG,0,ARI,23,Home,23,23
2017122411,2017,16,2017-12-24,Sunday,16:25,SEA,21,DAL,12,Home,-9,33
2017122500,2017,16,2017-12-25,Monday,16:30,PIT,34,HOU,6,Home,-28,40
2017122501,2017,16,2017-12-25,Monday,20:30,OAK,10,PHI,19,Home,9,29
2017123100,2017,17,2017-12-31,Sunday,16:25,CAR,10,ATL,22,Home,12,32
2017123101,2017,17,2017-12-31,Sunday,16:25,CIN,31,BAL,27,Home,-4,58
2017123102,2017,17,2017-12-31,Sunday,13:00,GB,11,DET,35,Home,24,46
2017123103,2017,17,2017-12-31,Sunday,13:00,HOU,13,IND,22,Home,9,35
2017123104,2017,17,2017-12-31,Sunday,16:25,BUF,22,MIA,16,Home,-6,38
2017123105,2017,17,2017-12-31,Sunday,13:00,CHI,10,MIN,23,Home,13,33
2017123106,2017,17,2017-12-31,Sunday,13:00,NYJ,6,NE,26,Home,20,32
2017123107,2017,17,2017-12-31,Sunday,13:00,WAS,10,NYG,18,Home,8,28
2017123108,2017,17,2017-12-31,Sunday,13:00,DAL,6,PHI,0,Home,-6,6
2017123109,2017,17,2017-12-31,Sunday,13:00,CLE,24,PIT,28,Home,4,52
2017123110,2017,17,2017-12-31,Sunday,16:25,NO,24,TB,31,Home,7,55
2017123111,2017,17,2017-12-31,Sunday,16:25,JAX,10,TEN,15,Home,5,25
2017123112,2017,17,2017-12-31,Sunday,16:25,KC,27,DEN,24,Home,-3,51
2017123113,2017,17,2017-12-31,Sunday,16:25,OAK,10,LAC,30,Home,20,40
2017123114,2017,17,2017-12-31,Sunday,16:25,SF,34,LAR,13,Home,-21,47
2017123115,2017,17,2017-12-31,Sunday,16:25,ARI,26,SEA,24,Home,-2,50
2018010600,2017,18,2018-01-06,Saturday,16:36,TEN,22,KC,21,Home,-1,43
2018010601,2017,18,2018-01-06,Saturday,20:15,ATL,26,LAR,13,Home,-13,39
2018010700,2017,18,2018-01-07,Sunday,13:05,BUF,3,JAX,10,Home,7,13
2018010701,2017,18,2018-01-07,Sunday,16:40,CAR,26,NO,31,Home,5,57
2018011300,2017,19,2018-01-13,Saturday,16:35,ATL,10,PHI,15,Home,5,25
2018011301,2017,19,2018-01-13,Saturday,20:15,TEN,14,NE,35,Home,21,49
2018011400,2017,19,2018-01-14,Sunday,13:05,JAX,45,PIT,42,Home,-3,87
2018011401,2017,19,2018-01-14,Sunday,16:40,NO,24,MIN,29,Home,5,53
2018012100,2017,20,2018-01-21,Sunday,15:05,JAX,20,NE,24,Home,4,44
2018012101,2017,20,2018-01-21,Sunday,18:41,MIN,7,PHI,38,Home,31,45
2018020400,2017,21,2018-02-04,Sunday,18:31,PHI,41,NE,33,Neutral,-8,74
2018090600,2018,1,2018-09-06,Thursday,20:20,ATL,12,PHI,18,Home,6,30
2018090900,2018,1,2018-09-09,Sunday,13:00,BUF,3,BAL,47,Home,44,50
2018090901,2018,1,2018-09-09,Sunday,13:00,PIT,21,CLE,21,Home,0,42
2018090902,2018,1,2018-09-09,Sunday,13:00,CIN,34,IND,23,Home,-11,57
2018090903,2018,1,2018-09-09,Sunday,13:00,TEN,20,MIA,27,Home,7,47
2018090904,2018,1,2018-09-09,Sunday,13:00,SF,16,MIN,24,Home,8,40
2018090905,2018,1,2018-09-09,Sunday,13:00,HOU,20,NE,27,Home,7,47
2018090906,2018,1,2018-09-09,Sunday,13:00,TB,48,NO,40,Home,-8,88
2018090907,2018,1,2018-09-09,Sunday,13:00,JAX,20,NYG,15,Home,-5,35
2018090908,2018,1,2018-09-09,Sunday,16:05,KC,38,LAC,28,Home,-10,66
2018090909,2018,1,2018-09-09,Sunday,16:25,WAS,24,ARI,6,Home,-18,30
2018090910,2018,1,2018-09-09,Sunday,16:25,DAL,8,CAR,16,Home,8,24
2018090911,2018,1,2018-09-09,Sunday,16:25,SEA,24,DEN,27,Home,3,51
2018090912,2018,1,2018-09-09,Sunday,20:20,CHI,23,GB,24,Home,1,47
2018091000,2018,1,2018-09-10,Monday,19:10,NYJ,48,DET,17,Home,-31,65
2018091001,2018,1,2018-09-10,Monday,22:20,LAR,33,OAK,13,Home,-20,46
2018091300,2018,2,2018-09-13,Thursday,20:20,BAL,23,CIN,34,Home,11,57
2018091600,2018,2,2018-09-16,Sunday,13:00,CAR,24,ATL,31,Home,7,55
2018091601,2018,2,2018-09-16,Sunday,13:00,LAC,31,BUF,20,Home,-11,51
2018091602,2018,2,2018-09-16,Sunday,13:00,MIN,29,GB,29,Home,0,58
2018091603,2018,2,2018-09-16,Sunday,13:00,CLE,18,NO,21,Home,3,39
2018091604,2018,2,2018-09-16,Sunday,13:00,MIA,20,NYJ,12,Home,-8,32
2018091605,2018,2,2018-09-16,Sunday,13:00,KC,42,PIT,37,Home,-5,79
2018091606,2018,2,2018-09-16,Sunday,13:00,PHI,21,TB,27,Home,6,48
2018091607,2018,2,2018-09-16,Sunday,13:00,HOU,17,TEN,20,Home,3,37
2018091608,2018,2,2018-09-16,Sunday,13:00,IND,21,WAS,9,Home,-12,30
2018091609,2018,2,2018-09-16,Sunday,16:05,ARI,0,LAR,34,Home,34,34
2018091610,2018,2,2018-09-16,Sunday,16:05,DET,27,SF,30,Home,3,57
2018091611,2018,2,2018-09-16,Sunday,16:25,OAK,19,DEN,20,Home,1,39
2018091612,2018,2,2018-09-16,Sunday,16:25,NE,20,JAX,31,Home,11,51
2018091613,2018,2,2018-09-16,Sunday,20:20,NYG,13,DAL,20,Home,7,33
2018091700,2018,2,2018-09-17,Monday,20:15,SEA,17,CHI,24,Home,7,41
2018092000,2018,3,2018-09-20,Thursday,20:20,NYJ,17,CLE,21,Home,4,38
2018092300,2018,3,2018-09-23,Sunday,13:00,NO,43,ATL,37,Home,-6,80
2018092301,2018,3,2018-09-23,Sunday,13:00,DEN,14,BAL,27,Home,13,41
2018092302,2018,3,2018-09-23,Sunday,13:00,CIN,21,CAR,31,Home,10,52
2018092303,2018,3,2018-09-23,Sunday,13:00,NYG,27,HOU,22,Home,-5,49
2018092304,2018,3,2018-09-23,Sunday,13:00,TEN,9,JAX,6,Home,-3,15
2018092305,2018,3,2018-09-23,Sunday,13:00,SF,27,KC,38,Home,11,65
2018092306,2018,3,2018-09-23,Sunday,13:00,OAK,20,MIA,28,Home,8,48
2018092307,2018,3,2018-09-23,Sunday,13:00,BUF,27,MIN,6,Home,-21,33
2018092308,2018,3,2018-09-23,Sunday,13:00,IND,16,PHI,20,Home,4,36
2018092309,2018,3,2018-09-23,Sunday,13:00,GB,17,WAS,31,Home,14,48
2018092310,2018,3,2018-09-23,Sunday,16:05,LAC,23,LAR,35,Home,12,58
2018092311,2018,3,2018-09-23,Sunday,16:25,CHI,16,ARI,14,Home,-2,30
2018092312,2018,3,2018-09-23,Sunday,16:25,DAL,13,SEA,24,Home,11,37
2018092313,2018,3,2018-09-23,Sunday,20:20,NE,10,DET,26,Home,16,36
2018092400,2018,3,2018-09-24,Monday,20:15,PIT,30,TB,27,Home,-3,57
2018092700,2018,4,2018-09-27,Thursday,20:20,MIN,31,LAR,38,Home,7,69
2018093000,2018,4,2018-09-30,Sunday,13:00,CIN,37,ATL,36,Home,-1,73
2018093001,2018,4,2018-09-30,Sunday,13:00,TB,10,CHI,48,Home,38,58
2018093002,2018,4,2018-09-30,Sunday,13:00,DET,24,DAL,26,Home,2,50
2018093003,2018,4,2018-09-30,Sunday,13:00,BUF,0,GB,22,Home,22,22
2018093004,2018,4,2018-09-30,Sunday,13:00,HOU,37,IND,34,Home,-3,71
2018093005,2018,4,2018-09-30,Sunday,13:00,NYJ,12,JAX,31,Home,19,43
2018093006,2018,4,2018-09-30,Sunday,13:00,MIA,7,NE,38,Home,31,45
2018093007,2018,4,2018-09-30,Sunday,13:00,PHI,23,TEN,26,Home,3,49
2018093008,2018,4,2018-09-30,Sunday,16:05,SEA,20,ARI,17,Home,-3,37
2018093009,2018,4,2018-09-30,Sunday,16:05,CLE,42,OAK,45,Home,3,87
2018093010,2018,4,2018-09-30,Sunday,16:25,SF,27,LAC,29,Home,2,56
2018093011,2018,4,2018-09-30,Sunday,16:25,NO,33,NYG,18,Home,-15,51
2018093012,2018,4,2018-09-30,Sunday,20:20,BAL,26,PIT,14,Home,-12,40
2018100100,2018,4,2018-10-01,Monday,20:15,KC,27,DEN,23,Home,-4,50
2018100400,2018,5,2018-10-04,Thursday,20:20,IND,24,NE,38,Home,14,62
2018100700,2018,5,2018-10-07,Sunday,13:00,TEN,12,BUF,13,Home,1,25
2018100701,2018,5,2018-10-07,Sunday,13:00,NYG,31,CAR,33,Home,2,64
2018100702,2018,5,2018-10-07,Sunday,13:00,MIA,17,CIN,27,Home,10,44
2018100703,2018,5,2018-10-07,Sunday,13:00,BAL,9,CLE,12,Home,3,21
2018100704,2018,5,2018-10-07,Sunday,13:00,GB,23,DET,31,Home,8,54
2018100705,2018,5,2018-10-07,Sunday,13:00,JAX,14,KC,30,Home,16,44
2018100706,2018,5,2018-10-07,Sunday,13:00,DEN,16,NYJ,34,Home,18,50
2018100707,2018,5,2018-10-07,Sunday,13:00,ATL,17,PIT,41,Home,24,58
2018100708,2018,5,2018-10-07,Sunday,16:05,OAK,10,LAC,26,Home,16,36
2018100709,2018,5,2018-10-07,Sunday,16:25,MIN,23,PHI,21,Home,-2,44
2018100710,2018,5,2018-10-07,Sunday,16:25,ARI,28,SF,18,Home,-10,46
2018100711,2018,5,2018-10-07,Sunday,16:25,LAR,33,SEA,31,Home,-2,64
2018100712,2018,5,2018-10-07,Sunday,20:20,DAL,16,HOU,19,Home,3,35
2018100800,2018,5,2018-10-08,Monday,20:15,WAS,19,NO,43,Home,24,62
2018101100,2018,6,2018-10-11,Thursday,20:20,PHI,34,NYG,13,Home,-21,47
2018101400,2018,6,2018-10-14,Sunday,13:00,TB,29,ATL,34,Home,5,63
2018101401,2018,6,2018-10-14,Sunday,13:00,PIT,28,CIN,21,Home,-7,49
2018101402,2018,6,2018-10-14,Sunday,13:00,LAC,38,CLE,14,Home,-24,52
2018101403,2018,6,2018-10-14,Sunday,13:00,BUF,13,HOU,20,Home,7,33
2018101404,2018,6,2018-10-14,Sunday,13:00,CHI,28,MIA,31,Home,3,59
2018101405,2018,6,2018-10-14,Sunday,13:00,ARI,17,MIN,27,Home,10,44
2018101406,2018,6,2018-10-14,Sunday,13:00,IND,34,NYJ,42,Home,8,76
2018101407,2018,6,2018-10-14,Sunday,13:00,SEA,27,OAK,3,Neutral,-24,30
2018101408,2018,6,2018-10-14,Sunday,13:00,CAR,17,WAS,23,Home,6,40
2018101409,2018,6,2018-10-14,Sunday,16:05,LAR,23,DEN,20,Home,-3,43
2018101410,2018,6,2018-10-14,Sunday,16:25,JAX,7,DAL,40,Home,33,47
2018101411,2018,6,2018-10-14,Sunday,16:25,BAL,21,TEN,0,Home,-21,21
2018101412,2018,6,2018-10-14,Sunday,20:20,KC,40,NE,43,Home,3,83
2018101500,2018,6,2018-10-15,Monday,20:15,SF,30,GB,33,Home,3,63
2018101800,2018,7,2018-10-18,Thursday,20:20,DEN,45,ARI,10,Home,-35,55
2018102100,2018,7,2018-10-21,Sunday,21:30,TEN,19,LAC,20,Neutral,1,39
2018102101,2018,7,2018-10-21,Sunday,16:05,NO,24,BAL,23,Home,-1,47
2018102102,2018,7,2018-10-21,Sunday,13:00,NE,38,CHI,31,Home,-7,69
2018102103,2018,7,2018-10-21,Sunday,13:00,BUF,5,IND,37,Home,32,42
2018102104,2018,7,2018-10-21,Sunday,13:00,HOU,20,JAX,7,Home,-13,27
2018102105,2018,7,2018-10-21,Sunday,20:20,CIN,10,KC,45,Home,35,55
2018102106,2018,7,2018-10-21,Sunday,13:00,DET,32,MIA,21,Home,-11,53
2018102107,2018,7,2018-10-21,Sunday,13:00,MIN,37,NYJ,17,Home,-20,54
2018102108,2018,7,2018-10-21,Sunday,13:00,CAR,21,PHI,17,Home,-4,38
2018102109,2018,7,2018-10-21,Sunday,13:00,CLE,23,TB,26,Home,3,49
2018102110,2018,7,2018-10-21,Sunday,16:25,DAL,17,WAS,20,Home,3,37
2018102111,2018,7,2018-10-21,Sunday,16:25,LAR,39,SF,10,Home,-29,49
2018102200,2018,7,2018-10-22,Monday,20:15,NYG,20,ATL,23,Home,3,43
2018102500,2018,8,2018-10-25,Thursday,20:20,MIA,23,HOU,42,Home,19,65
2018102800,2018,8,2018-10-28,Sunday,21:30,PHI,24,JAX,18,Neutral,-6,42
2018102801,2018,8,2018-10-28,Sunday,13:00,BAL,21,CAR,36,Home,15,57
2018102802,2018,8,2018-10-28,Sunday,13:00,NYJ,10,CHI,24,Home,14,34
2018102803,2018,8,2018-10-28,Sunday,13:00,TB,34,CIN,37,Home,3,71
2018102804,2018,8,2018-10-28,Sunday,13:00,SEA,28,DET,14,Home,-14,42
2018102805,2018,8,2018-10-28,Sunday,13:00,DEN,23,KC,30,Home,7,53
2018102806,2018,8,2018-10-28,Sunday,13:00,WAS,20,NYG,13,Home,-7,33
2018102807,2018,8,2018-10-28,Sunday,13:00,CLE,18,PIT,33,Home,15,51
2018102808,2018,8,2018-10-28,Sunday,16:05,IND,42,OAK,28,Home,-14,70
2018102809,2018,8,2018-10-28,Sunday,16:25,SF,15,ARI,18,Home,3,33
2018102810,2018,8,2018-10-28,Sunday,16:25,GB,27,LAR,29,Home,2,56
2018102811,2018,8,2018-10-28,Sunday,20:20,NO,30,MIN,20,Home,-10,50
2018102900,2018,8,2018-10-29,Monday,20:15,NE,25,BUF,6,Home,-19,31
2018110100,2018,9,2018-11-01,Thursday,20:20,OAK,3,SF,34,Home,31,37
2018110400,2018,9,2018-11-04,Sunday,13:00,PIT,23,BAL,16,Home,-7,39
2018110401,2018,9,2018-11-04,Sunday,13:00,CHI,41,BUF,9,Home,-32,50
2018110402,2018,9,2018-11-04,Sunday,13:00,TB,28,CAR,42,Home,14,70
2018110403,2018,9,2018-11-04,Sunday,13:00,KC,37,CLE,21,Home,-16,58
2018110404,2018,9,2018-11-04,Sunday,13:00,NYJ,6,MIA,13,Home,7,19
2018110405,2018,9,2018-11-04,Sunday,13:00,DET,9,MIN,24,Home,15,33
2018110406,2018,9,2018-11-04,Sunday,13:00,ATL,38,WAS,14,Home,-24,52
2018110407,2018,9,2018-11-04,Sunday,16:05,HOU,19,DEN,17,Home,-2,36
2018110408,2018,9,2018-11-04,Sunday,16:05,LAC,25,SEA,17,Home,-8,42
2018110409,2018,9,2018-11-04,Sunday,16:25,LAR,35,NO,45,Home,10,80
2018110410,2018,9,2018-11-04,Sunday,20:20,GB,17,NE,31,Home,14,48
2018110500,2018,9,2018-11-05,Monday,20:15,TEN,28,DAL,14,Home,-14,42
2018110800,2018,10,2018-11-08,Thursday,20:20,CAR,21,PIT,52,Home,31,73
2018111100,2018,10,2018-11-11,Sunday,13:00,DET,22,CHI,34,Home,12,56
2018111101,2018,10,2018-11-11,Sunday,13:00,NO,51,CIN,14,Home,-37,65
2018111102,2018,10,2018-11-11,Sunday,13:00,ATL,16,CLE,28,Home,12,44
2018111103,2018,10,2018-11-11,Sunday,16:25,MIA,12,GB,31,Home,19,43
2018111104,2018,10,2018-11-11,Sunday,13:00,JAX,26,IND,29,Home,3,55
2018111105,2018,10,2018-11-11,Sunday,13:00,ARI,14,KC,26,Home,12,40
2018111106,2018,10,2018-11-11,Sunday,13:00,BUF,41,NYJ,10,Home,-31,51
2018111107,2018,10,2018-11-11,Sunday,13:00,WAS,16,TB,3,Home,-13,19
2018111108,2018,10,2018-11-11,Sunday,13:00,NE,10,TEN,34,Home,24,44
2018111109,2018,10,2018-11-11,Sunday,16:05,LAC,20,OAK,6,Home,-14,26
2018111110,2018,10,2018-11-11,Sunday,16:25,SEA,31,LAR,36,Home,5,67
2018111111,2018,10,2018-11-11,Sunday,20:20,DAL,27,PHI,20,Home,-7,47
2018111200,2018,10,2018-11-12,Monday,20:15,NYG,27,SF,23,Home,-4,50
2018111500,2018,11,2018-11-15,Thursday,20:20,GB,24,SEA,27,Home,3,51
2018111800,2018,11,2018-11-18,Sunday,13:00,DAL,22,ATL,19,Home,-3,41
2018111801,2018,11,2018-11-18,Sunday,13:00,CIN,21,BAL,24,Home,3,45
2018111802,2018,11,2018-11-18,Sunday,20:20,MIN,20,CHI,25,Home,5,45
2018111803,2018,11,2018-11-18,Sunday,13:00,CAR,19,DET,20,Home,1,39
2018111804,2018,11,2018-11-18,Sunday,13:00,TEN,10,IND,38,Home,28,48
2018111805,2018,11,2018-11-18,Sunday,13:00,TB,35,NYG,38,Home,3,73
2018111806,2018,11,2018-11-18,Sunday,13:00,HOU,23,WAS,21,Home,-2,44
2018111807,2018,11,2018-11-18,Sunday,16:05,OAK,23,ARI,21,Home,-2,44
2018111808,2018,11,2018-11-18,Sunday,16:05,DEN,23,LAC,22,Home,-1,45
2018111809,2018,11,2018-11-18,Sunday,16:25,PHI,7,NO,48,Home,41,55
2018111810,2018,11,2018-11-18,Sunday,13:00,PIT,20,JAX,16,Home,-4,36
2018111900,2018,11,2018-11-19,Monday,20:15,KC,51,LAR,54,Home,3,105
2018112200,2018,12,2018-11-22,Thursday,12:30,CHI,23,DET,16,Home,-7,39
2018112201,2018,12,2018-11-22,Thursday,16:30,WAS,23,DAL,31,Home,8,54
2018112202,2018,12,2018-11-22,Thursday,20:20,ATL,17,NO,31,Home,14,48
2018112500,2018,12,2018-11-25,Sunday,13:00,OAK,17,BAL,34,Home,17,51
2018112501,2018,12,2018-11-25,Sunday,13:00,JAX,21,BUF,24,Home,3,45
2018112502,2018,12,2018-11-25,Sunday,13:00,SEA,30,CAR,27,Home,-3,57
2018112503,2018,12,2018-11-25,Sunday,13:00,CLE,35,CIN,20,Home,-15,55
2018112504,2018,12,2018-11-25,Sunday,16:25,MIA,24,IND,27,Home,3,51
2018112505,2018,12,2018-11-25,Sunday,13:00,NE,27,NYJ,13,Home,-14,40
2018112506,2018,12,2018-11-25,Sunday,13:00,NYG,22,PHI,25,Home,3,47
2018112507,2018,12,2018-11-25,Sunday,13:00,SF,9,TB,27,Home,18,36
2018112508,2018,12,2018-11-25,Sunday,16:05,ARI,10,LAC,45,Home,35,55
2018112509,2018,12,2018-11-25,Sunday,16:25,PIT,17,DEN,24,Home,7,41
2018112510,2018,12,2018-11-25,Sunday,20:20,GB,17,MIN,24,Home,7,41
2018112600,2018,12,2018-11-26,Monday,20:15,TEN,17,HOU,34,Home,17,51
2018112900,2018,13,2018-11-29,Thursday,20:20,NO,10,DAL,13,Home,3,23
2018120200,2018,13,2018-12-02,Sunday,13:00,BAL,26,ATL,16,Home,-10,42
2018120201,2018,13,2018-12-02,Sunday,13:00,DEN,24,CIN,10,Home,-14,34
2018120202,2018,13,2018-12-02,Sunday,13:00,LAR,30,DET,16,Home,-14,46
2018120203,2018,13,2018-12-02,Sunday,13:00,ARI,20,GB,17,Home,-3,37
2018120204,2018,13,2018-12-02,Sunday,13:00,CLE,13,HOU,29,Home,16,42
2018120205,2018,13,2018-12-02,Sunday,13:00,IND,0,JAX,6,Home,6,6
2018120206,2018,13,2018-12-02,Sunday,13:00,BUF,17,MIA,21,Home,4,38
2018120207,2018,13,2018-12-02,Sunday,13:00,CHI,27,NYG,30,Home,3,57
2018120208,2018,13,2018-12-02,Sunday,20:20,LAC,33,PIT,30,Home,-3,63
2018120209,2018,13,2018-12-02,Sunday,13:00,CAR,17,TB,24,Home,7,41
2018120210,2018,13,2018-12-02,Sunday,16:05,KC,40,OAK,33,Home,-7,73
2018120211,2018,13,2018-12-02,Sunday,16:05,NYJ,22,TEN,26,Home,4,48
2018120212,2018,13,2018-12-02,Sunday,16:25,MIN,10,NE,24,Home,14,34
2018120213,2018,13,2018-12-02,Sunday,16:25,SF,16,SEA,43,Home,27,59
2018120300,2018,13,2018-12-03,Monday,20:15,WAS,13,PHI,28,Home,15,41
2018120600,2018,14,2018-12-06,Thursday,20:20,JAX,9,TEN,30,Home,21,39
2018120900,2018,14,2018-12-09,Sunday,13:00,NYJ,27,BUF,23,Home,-4,50
2018120901,2018,14,2018-12-09,Sunday,20:20,LAR,6,CHI,15,Home,9,21
2018120902,2018,14,2018-12-09,Sunday,13:00,CAR,20,CLE,26,Home,6,46
2018120903,2018,14,2018-12-09,Sunday,13:00,ATL,20,GB,34,Home,14,54
2018120904,2018,14,2018-12-09,Sunday,13:00,IND,24,HOU,21,Home,-3,45
2018120905,2018,14,2018-12-09,Sunday,13:00,BAL,24,KC,27,Home,3,51
2018120906,2018,14,2018-12-09,Sunday,13:00,NE,33,MIA,34,Home,1,67
2018120907,2018,14,2018-12-09,Sunday,13:00,NO,28,TB,14,Home,-14,42
2018120908,2018,14,2018-12-09,Sunday,13:00,NYG,40,WAS,16,Home,-24,56
2018120909,2018,14,2018-12-09,Sunday,16:05,CIN,21,LAC,26,Home,5,47
2018120910,2018,14,2018-12-09,Sunday,16:05,DEN,14,SF,20,Home,6,34
2018120911,2018,14,2018-12-09,Sunday,16:25,DET,17,ARI,3,Home,-14,20
2018120912,2018,14,2018-12-09,Sunday,16:25,PHI,23,DAL,29,Home,6,52
2018120913,2018,14,2018-12-09,Sunday,16:25,PIT,21,OAK,24,Home,3,45
2018121000,2018,14,2018-12-10,Monday,20:15,MIN,7,SEA,21,Home,14,28
2018121300,2018,15,2018-12-13,Thursday,20:20,LAC,29,KC,28,Home,-1,57
2018121500,2018,15,2018-12-15,Saturday,16:30,HOU,29,NYJ,22,Home,-7,51
2018121501,2018,15,2018-12-15,Saturday,20:20,CLE,17,DEN,16,Home,-1,33
2018121600,2018,15,2018-12-16,Sunday,13:00,ARI,14,ATL,40,Home,26,54
2018121601,2018,15,2018-12-16,Sunday,13:00,TB,12,BAL,20,Home,8,32
2018121602,2018,15,2018-12-16,Sunday,13:00,DET,13,BUF,14,Home,1,27
2018121603,2018,15,2018-12-16,Sunday,13:00,GB,17,CHI,24,Home,7,41
2018121604,2018,15,2018-12-16,Sunday,13:00,OAK,16,CIN,30,Home,14,46
2018121605,2018,15,2018-12-16,Sunday,13:00,DAL,0,IND,23,Home,23,23
2018121606,2018,15,2018-12-16,Sunday,13:00,WAS,16,JAX,13,Home,-3,29
2018121607,2018,15,2018-12-16,Sunday,13:00,MIA,17,MIN,41,Home,24,58
2018121608,2018,15,2018-12-16,Sunday,13:00,TEN,17,NYG,0,Home,-17,17
2018121609,2018,15,2018-12-16,Sunday,16:05,SEA,23,SF,26,Home,3,49
2018121610,2018,15,2018-12-16,Sunday,16:25,NE,10,PIT,17,Home,7,27
2018121611,2018,15,2018-12-16,Sunday,20:20,PHI,30,LAR,23,Home,-7,53
2018121700,2018,15,2018-12-17,Monday,20:15,NO,12,CAR,9,Home,-3,21
2018122200,2018,16,2018-12-22,Saturday,16:30,WAS,16,TEN,25,Home,9,41
2018122201,2018,16,2018-12-22,Saturday,20:20,BAL,22,LAC,10,Home,-12,32
2018122300,2018,16,2018-12-23,Sunday,13:00,NYG,27,IND,28,Home,1,55
2018122302,2018,16,2018-12-23,Sunday,13:00,JAX,17,MIA,7,Home,-10,24
2018122304,2018,16,2018-12-23,Sunday,13:00,ATL,24,CAR,10,Home,-14,34
2018122305,2018,16,2018-12-23,Sunday,13:00,CIN,18,CLE,26,Home,8,44
2018122306,2018,16,2018-12-23,Sunday,13:00,TB,20,DAL,27,Home,7,47
2018122307,2018,16,2018-12-23,Sunday,13:00,MIN,27,DET,9,Home,-18,36
2018122308,2018,16,2018-12-23,Sunday,13:00,BUF,12,NE,24,Home,12,36
2018122309,2018,16,2018-12-23,Sunday,13:00,GB,44,NYJ,38,Home,-6,82
2018122310,2018,16,2018-12-23,Sunday,13:00,HOU,30,PHI,32,Home,2,62
2018122311,2018,16,2018-12-23,Sunday,16:05,LAR,31,ARI,9,Home,-22,40
2018122312,2018,16,2018-12-23,Sunday,16:05,CHI,14,SF,9,Home,-5,23
2018122313,2018,16,2018-12-23,Sunday,16:25,PIT,28,NO,31,Home,3,59
2018122314,2018,16,2018-12-23,Sunday,20:20,KC,31,SEA,38,Home,7,69
2018122400,2018,16,2018-12-24,Monday,20:15,DEN,14,OAK,27,Home,13,41
2018123000,2018,17,2018-12-30,Sunday,16:25,CLE,24,BAL,26,Home,2,50
2018123001,2018,17,2018-12-30,Sunday,13:00,MIA,17,BUF,42,Home,25,59
2018123002,2018,17,2018-12-30,Sunday,13:00,DET,31,GB,0,Home,-31,31
2018123003,2018,17,2018-12-30,Sunday,13:00,JAX,3,HOU,20,Home,17,23
2018123004,2018,17,2018-12-30,Sunday,16:25,OAK,3,KC,35,Home,32,38
2018123005,2018,17,2018-12-30,Sunday,16:25,CHI,24,MIN,10,Home,-14,34
2018123006,2018,17,2018-12-30,Sunday,13:00,NYJ,3,NE,38,Home,35,41
2018123007,2018,17,2018-12-30,Sunday,13:00,CAR,33,NO,14,Home,-19,47
2018123008,2018,17,2018-12-30,Sunday,13:00,DAL,36,NYG,35,Home,-1,71
2018123009,2018,17,2018-12-30,Sunday,16:25,CIN,13,PIT,16,Home,3,29
2018123010,2018,17,2018-12-30,Sunday,13:00,ATL,34,TB,32,Home,-2,66
2018123011,2018,17,2018-12-30,Sunday,20:20,IND,33,TEN,17,Home,-16,50
2018123012,2018,17,2018-12-30,Sunday,16:25,PHI,24,WAS,0,Home,-24,24
2018123013,2018,17,2018-12-30,Sunday,16:25,LAC,23,DEN,9,Home,-14,32
2018123014,2018,17,2018-12-30,Sunday,16:25,SF,32,LAR,48,Home,16,80
2018123015,2018,17,2018-12-30,Sunday,16:25,ARI,24,SEA,27,Home,3,51
2019010500,2018,18,2019-01-05,Saturday,16:35,IND,21,HOU,7,Home,-14,28
2019010501,2018,18,2019-01-05,Saturday,20:15,SEA,22,DAL,24,Home,2,46
2019010600,2018,18,2019-01-06,Sunday,13:05,LAC,23,BAL,17,Home,-6,40
2019010601,2018,18,2019-01-06,Sunday,16:40,PHI,16,CHI,15,Home,-1,31
2019011200,2018,19,2019-01-12,Saturday,16:35,IND,13,KC,31,Home,18,44
2019011201,2018,19,2019-01-12,Saturday,20:15,DAL,22,LAR,30,Home,8,52
2019011300,2018,19,2019-01-13,Sunday,13:05,LAC,28,NE,41,Home,13,69
2019011301,2018,19,2019-01-13,Sunday,16:40,PHI,14,NO,20,Home,6,34
2019012000,2018,20,2019-01-20,Sunday,15:05,LAR,26,NO,23,Home,-3,49
2019012001,2018,20,2019-01-20,Sunday,18:40,NE,37,KC,31,Home,-6,68
2019020300,2018,21,2019-02-03,Sunday,18:30,NE,13,LAR,3,Neutral,-10,16
2019090500,2019,1,2019-09-05,Thursday,20:20,GB,,CHI,,Home,,
2019090800,2019,1,2019-09-08,Sunday,13:00,LAR,,CAR,,Home,,
2019090801,2019,1,2019-09-08,Sunday,13:00,TEN,,CLE,,Home,,
2019090802,2019,1,2019-09-08,Sunday,13:00,KC,,JAX,,Home,,
2019090803,2019,1,2019-09-08,Sunday,13:00,BAL,,MIA,,Home,,
2019090804,2019,1,2019-09-08,Sunday,13:00,ATL,,MIN,,Home,,
2019090805,2019,1,2019-09-08,Sunday,13:00,BUF,,NYJ,,Home,,
2019090806,2019,1,2019-09-08,Sunday,13:00,WAS,,PHI,,Home,,
2019090807,2019,1,2019-09-08,Sunday,16:05,IND,,LAC,,Home,,
2019090808,2019,1,2019-09-08,Sunday,16:05,CIN,,SEA,,Home,,
2019090809,2019,1,2019-09-08,Sunday,16:25,DET,,ARI,,Home,,
2019090810,2019,1,2019-09-08,Sunday,16:25,NYG,,DAL,,Home,,
2019090811,2019,1,2019-09-08,Sunday,16:25,SF,,TB,,Home,,
2019090812,2019,1,2019-09-08,Sunday,20:20,PIT,,NE,,Home,,
2019090900,2019,1,2019-09-09,Monday,19:10,HOU,,NO,,Home,,
2019090901,2019,1,2019-09-09,Monday,22:20,DEN,,OAK,,Home,,
2019091200,2019,2,2019-09-12,Thursday,20:20,TB,,CAR,,Home,,
2019091500,2019,2,2019-09-15,Sunday,13:00,ARI,,BAL,,Home,,
2019091501,2019,2,2019-09-15,Sunday,13:00,SF,,CIN,,Home,,
2019091502,2019,2,2019-09-15,Sunday,13:00,LAC,,DET,,Home,,
2019091503,2019,2,2019-09-15,Sunday,13:00,MIN,,GB,,Home,,
2019091504,2019,2,2019-09-15,Sunday,13:00,JAX,,HOU,,Home,,
2019091505,2019,2,2019-09-15,Sunday,13:00,NE,,MIA,,Home,,
2019091506,2019,2,2019-09-15,Sunday,13:00,BUF,,NYG,,Home,,
2019091507,2019,2,2019-09-15,Sunday,13:00,SEA,,PIT,,Home,,
2019091508,2019,2,2019-09-15,Sunday,13:00,IND,,TEN,,Home,,
2019091509,2019,2,2019-09-15,Sunday,13:00,DAL,,WAS,,Home,,
2019091510,2019,2,2019-09-15,Sunday,16:05,KC,,OAK,,Home,,
2019091511,2019,2,2019-09-15,Sunday,16:25,CHI,,DEN,,Home,,
2019091512,2019,2,2019-09-15,Sunday,16:25,NO,,LAR,,Home,,
2019091513,2019,2,2019-09-15,Sunday,20:20,PHI,,ATL,,Home,,
2019091600,2019,2,2019-09-16,Monday,20:15,CLE,,NYJ,,Home,,
2019091900,2019,3,2019-09-19,Thursday,20:20,TEN,,JAX,,Home,,
2019092200,2019,3,2019-09-22,Sunday,13:00,CIN,,BUF,,Home,,
2019092201,2019,3,2019-09-22,Sunday,13:00,MIA,,DAL,,Home,,
2019092202,2019,3,2019-09-22,Sunday,13:00,DEN,,GB,,Home,,
2019092203,2019,3,2019-09-22,Sunday,13:00,ATL,,IND,,Home,,
2019092204,2019,3,2019-09-22,Sunday,13:00,BAL,,KC,,Home,,
2019092205,2019,3,2019-09-22,Sunday,13:00,OAK,,MIN,,Home,,
2019092206,2019,3,2019-09-22,Sunday,13:00,NYJ,,NE,,Home,,
2019092207,2019,3,2019-09-22,Sunday,13:00,DET,,PHI,,Home,,
2019092208,2019,3,2019-09-22,Sunday,16:05,CAR,,ARI,,Home,,
2019092209,2019,3,2019-09-22,Sunday,16:05,NYG,,TB,,Home,,
2019092210,2019,3,2019-09-22,Sunday,16:25,HOU,,LAC,,Home,,
2019092211,2019,3,2019-09-22,Sunday,16:25,NO,,SEA,,Home,,
2019092212,2019,3,2019-09-22,Sunday,16:25,PIT,,SF,,Home,,
2019092213,2019,3,2019-09-22,Sunday,20:20,LAR,,CLE,,Home,,
2019092300,2019,3,2019-09-23,Monday,20:15,CHI,,WAS,,Home,,
2019092600,2019,4,2019-09-26,Thursday,20:20,PHI,,GB,,Home,,
2019092900,2019,4,2019-09-29,Sunday,13:00,TEN,,ATL,,Home,,
2019092901,2019,4,2019-09-29,Sunday,13:00,CLE,,BAL,,Home,,
2019092902,2019,4,2019-09-29,Sunday,13:00,NE,,BUF,,Home,,
2019092903,2019,4,2019-09-29,Sunday,13:00,KC,,DET,,Home,,
2019092904,2019,4,2019-09-29,Sunday,13:00,CAR,,HOU,,Home,,
2019092905,2019,4,2019-09-29,Sunday,13:00,OAK,,IND,,Home,,
2019092906,2019,4,2019-09-29,Sunday,13:00,LAC,,MIA,,Home,,
2019092907,2019,4,2019-09-29,Sunday,13:00,WAS,,NYG,,Home,,
2019092908,2019,4,2019-09-29,Sunday,16:05,SEA,,ARI,,Home,,
2019092909,2019,4,2019-09-29,Sunday,16:05,TB,,LAR,,Home,,
2019092910,2019,4,2019-09-29,Sunday,16:25,MIN,,CHI,,Home,,
2019092911,2019,4,2019-09-29,Sunday,16:25,JAX,,DEN,,Home,,
2019092912,2019,4,2019-09-29,Sunday,20:20,DAL,,NO,,Home,,
2019093000,2019,4,2019-09-30,Monday,20:15,CIN,,PIT,,Home,,
2019100300,2019,5,2019-10-03,Thursday,20:20,LAR,,SEA,,Home,,
2019100600,2019,5,2019-10-06,Sunday,13:00,JAX,,CAR,,Home,,
2019100601,2019,5,2019-10-06,Sunday,13:00,ARI,,CIN,,Home,,
2019100602,2019,5,2019-10-06,Sunday,13:00,ATL,,HOU,,Home,,
2019100603,2019,5,2019-10-06,Sunday,13:00,TB,,NO,,Home,,
2019100604,2019,5,2019-10-06,Sunday,13:00,MIN,,NYG,,Home,,
2019100605,2019,5,2019-10-06,Sunday,13:00,CHI,,OAK,,Neutral,,
2019100606,2019,5,2019-10-06,Sunday,13:00,NYJ,,PHI,,Home,,
2019100607,2019,5,2019-10-06,Sunday,13:00,BAL,,PIT,,Home,,
2019100608,2019,5,2019-10-06,Sunday,13:00,BUF,,TEN,,Home,,
2019100609,2019,5,2019-10-06,Sunday,13:00,NE,,WAS,,Home,,
2019100610,2019,5,2019-10-06,Sunday,16:05,DEN,,LAC,,Home,,
2019100611,2019,5,2019-10-06,Sunday,16:25,GB,,DAL,,Home,,
2019100612,2019,5,2019-10-06,Sunday,20:20,IND,,KC,,Home,,
2019100700,2019,5,2019-10-07,Monday,20:15,CLE,,SF,,Home,,
2019101000,2019,6,2019-10-10,Thursday,20:20,NYG,,NE,,Home,,
2019101300,2019,6,2019-10-13,Sunday,09:30,CAR,,TB,,Neutral,,
2019101301,2019,6,2019-10-13,Sunday,13:00,CIN,,BAL,,Home,,
2019101302,2019,6,2019-10-13,Sunday,13:00,SEA,,CLE,,Home,,
2019101303,2019,6,2019-10-13,Sunday,13:00,NO,,JAX,,Home,,
2019101304,2019,6,2019-10-13,Sunday,13:00,HOU,,KC,,Home,,
2019101305,2019,6,2019-10-13,Sunday,13:00,WAS,,MIA,,Home,,
2019101306,2019,6,2019-10-13,Sunday,13:00,PHI,,MIN,,Home,,
2019101307,2019,6,2019-10-13,Sunday,16:05,ATL,,ARI,,Home,,
2019101308,2019,6,2019-10-13,Sunday,16:05,SF,,LAR,,Home,,
2019101309,2019,6,2019-10-13,Sunday,16:25,TEN,,DEN,,Home,,
2019101310,2019,6,2019-10-13,Sunday,16:25,DAL,,NYJ,,Home,,
2019101311,2019,6,2019-10-13,Sunday,20:20,PIT,,LAC,,Home,,
2019101400,2019,6,2019-10-14,Monday,20:15,DET,,GB,,Home,,
2019101700,2019,7,2019-10-17,Thursday,20:20,KC,,DEN,,Home,,
2019102000,2019,7,2019-10-20,Sunday,13:00,LAR,,ATL,,Home,,
2019102001,2019,7,2019-10-20,Sunday,13:00,MIA,,BUF,,Home,,
2019102002,2019,7,2019-10-20,Sunday,13:00,JAX,,CIN,,Home,,
2019102003,2019,7,2019-10-20,Sunday,13:00,MIN,,DET,,Home,,
2019102004,2019,7,2019-10-20,Sunday,13:00,OAK,,GB,,Home,,
2019102005,2019,7,2019-10-20,Sunday,13:00,HOU,,IND,,Home,,
2019102006,2019,7,2019-10-20,Sunday,13:00,ARI,,NYG,,Home,,
2019102007,2019,7,2019-10-20,Sunday,13:00,SF,,WAS,,Home,,
2019102008,2019,7,2019-10-20,Sunday,16:05,LAC,,TEN,,Home,,
2019102009,2019,7,2019-10-20,Sunday,16:25,NO,,CHI,,Home,,
2019102010,2019,7,2019-10-20,Sunday,16:25,BAL,,SEA,,Home,,
2019102011,2019,7,2019-10-20,Sunday,20:20,PHI,,DAL,,Home,,
2019102100,2019,7,2019-10-21,Monday,20:15,NE,,NYJ,,Home,,
2019102400,2019,8,2019-10-24,Thursday,20:20,WAS,,MIN,,Home,,
2019102700,2019,8,2019-10-27,Sunday,13:00,SEA,,ATL,,Home,,
2019102701,2019,8,2019-10-27,Sunday,13:00,PHI,,BUF,,Home,,
2019102702,2019,8,2019-10-27,Sunday,13:00,LAC,,CHI,,Home,,
2019102703,2019,8,2019-10-27,Sunday,13:00,NYG,,DET,,Home,,
2019102704,2019,8,2019-10-27,Sunday,13:00,OAK,,HOU,,Home,,
2019102705,2019,8,2019-10-27,Sunday,13:00,NYJ,,JAX,,Home,,
2019102706,2019,8,2019-10-27,Sunday,13:00,CIN,,LAR,,Neutral,,
2019102707,2019,8,2019-10-27,Sunday,13:00,ARI,,NO,,Home,,
2019102708,2019,8,2019-10-27,Sunday,13:00,TB,,TEN,,Home,,
2019102709,2019,8,2019-10-27,Sunday,16:05,CAR,,SF,,Home,,
2019102710,2019,8,2019-10-27,Sunday,16:25,DEN,,IND,,Home,,
2019102711,2019,8,2019-10-27,Sunday,16:25,CLE,,NE,,Home,,
2019102712,2019,8,2019-10-27,Sunday,20:20,GB,,KC,,Home,,
2019102800,2019,8,2019-10-28,Monday,20:15,MIA,,PIT,,Home,,
2019103100,2019,9,2019-10-31,Thursday,20:20,SF,,ARI,,Home,,
2019110300,2019,9,2019-11-03,Sunday,09:30,HOU,,JAX,,Neutral,,
2019110301,2019,9,2019-11-03,Sunday,13:00,WAS,,BUF,,Home,,
2019110302,2019,9,2019-11-03,Sunday,13:00,TEN,,CAR,,Home,,
2019110303,2019,9,2019-11-03,Sunday,13:00,MIN,,KC,,Home,,
2019110304,2019,9,2019-11-03,Sunday,13:00,NYJ,,MIA,,Home,,
2019110305,2019,9,2019-11-03,Sunday,13:00,CHI,,PHI,,Home,,
2019110306,2019,9,2019-11-03,Sunday,13:00,IND,,PIT,,Home,,
2019110307,2019,9,2019-11-03,Sunday,16:05,DET,,OAK,,Home,,
2019110308,2019,9,2019-11-03,Sunday,16:05,TB,,SEA,,Home,,
2019110309,2019,9,2019-11-03,Sunday,16:25,CLE,,DEN,,Home,,
2019110310,2019,9,2019-11-03,Sunday,16:25,GB,,LAC,,Home,,
2019110311,2019,9,2019-11-03,Sunday,20:20,NE,,BAL,,Home,,
2019110400,2019,9,2019-11-04,Monday,20:15,DAL,,NYG,,Home,,
2019110700,2019,10,2019-11-07,Thursday,20:20,LAC,,OAK,,Home,,
2019111000,2019,10,2019-11-10,Sunday,13:00,DET,,CHI,,Home,,
2019111001,2019,10,2019-11-10,Sunday,13:00,BAL,,CIN,,Home,,
2019111002,2019,10,2019-11-10,Sunday,13:00,BUF,,CLE,,Home,,
2019111003,2019,10,2019-11-10,Sunday,13:00,CAR,,GB,,Home,,
2019111004,2019,10,2019-11-10,Sunday,13:00,ATL,,NO,,Home,,
2019111005,2019,10,2019-11-10,Sunday,13:00,NYG,,NYJ,,Home,,
2019111006,2019,10,2019-11-10,Sunday,13:00,ARI,,TB,,Home,,
2019111007,2019,10,2019-11-10,Sunday,13:00,KC,,TEN,,Home,,
2019111008,2019,10,2019-11-10,Sunday,16:05,MIA,,IND,,Home,,
2019111009,2019,10,2019-11-10,Sunday,16:25,LAR,,PIT,,Home,,
2019111010,2019,10,2019-11-10,Sunday,20:20,MIN,,DAL,,Home,,
2019111100,2019,10,2019-11-11,Monday,20:15,SEA,,SF,,Home,,
2019111400,2019,11,2019-11-14,Thursday,20:20,PIT,,CLE,,Home,,
2019111700,2019,11,2019-11-17,Sunday,13:00,HOU,,BAL,,Home,,
2019111701,2019,11,2019-11-17,Sunday,13:00,ATL,,CAR,,Home,,
2019111702,2019,11,2019-11-17,Sunday,13:00,DAL,,DET,,Home,,
2019111703,2019,11,2019-11-17,Sunday,13:00,JAX,,IND,,Home,,
2019111704,2019,11,2019-11-17,Sunday,13:00,BUF,,MIA,,Home,,
2019111705,2019,11,2019-11-17,Sunday,13:00,DEN,,MIN,,Home,,
2019111706,2019,11,2019-11-17,Sunday,13:00,NO,,TB,,Home,,
2019111707,2019,11,2019-11-17,Sunday,13:00,NYJ,,WAS,,Home,,
2019111708,2019,11,2019-11-17,Sunday,16:05,ARI,,SF,,Home,,
2019111709,2019,11,2019-11-17,Sunday,16:25,CIN,,OAK,,Home,,
2019111710,2019,11,2019-11-17,Sunday,16:25,NE,,PHI,,Home,,
2019111711,2019,11,2019-11-17,Sunday,20:20,CHI,,LAR,,Home,,
2019111800,2019,11,2019-11-18,Monday,20:15,KC,,LAC,,Neutral,,
2019112100,2019,12,2019-11-21,Thursday,20:20,IND,,HOU,,Home,,
2019112400,2019,12,2019-11-24,Sunday,13:00,TB,,ATL,,Home,,
2019112401,2019,12,2019-11-24,Sunday,13:00,DEN,,BUF,,Home,,
2019112402,2019,12,2019-11-24,Sunday,13:00,NYG,,CHI,,Home,,
2019112403,2019,12,2019-11-24,Sunday,13:00,PIT,,CIN,,Home,,
2019112404,2019,12,2019-11-24,Sunday,13:00,MIA,,CLE,,Home,,
2019112405,2019,12,2019-11-24,Sunday,13:00,CAR,,NO,,Home,,
2019112406,2019,12,2019-11-24,Sunday,13:00,OAK,,NYJ,,Home,,
2019112407,2019,12,2019-11-24,Sunday,13:00,DET,,WAS,,Home,,
2019112408,2019,12,2019-11-24,Sunday,16:05,JAX,,TEN,,Home,,
2019112409,2019,12,2019-11-24,Sunday,16:25,DAL,,NE,,Home,,
2019112410,2019,12,2019-11-24,Sunday,16:25,GB,,SF,,Home,,
2019112411,2019,12,2019-11-24,Sunday,20:20,SEA,,PHI,,Home,,
2019112500,2019,12,2019-11-25,Monday,20:15,BAL,,LAR,,Home,,
2019112800,2019,13,2019-11-28,Thursday,12:30,CHI,,DET,,Home,,
2019112801,2019,13,2019-11-28,Thursday,16:30,BUF,,DAL,,Home,,
2019112802,2019,13,2019-11-28,Thursday,20:20,NO,,ATL,,Home,,
2019120100,2019,13,2019-12-01,Sunday,13:00,SF,,BAL,,Home,,
2019120101,2019,13,2019-12-01,Sunday,13:00,WAS,,CAR,,Home,,
2019120102,2019,13,2019-12-01,Sunday,13:00,NYJ,,CIN,,Home,,
2019120103,2019,13,2019-12-01,Sunday,13:00,TEN,,IND,,Home,,
2019120104,2019,13,2019-12-01,Sunday,13:00,TB,,JAX,,Home,,
2019120105,2019,13,2019-12-01,Sunday,13:00,OAK,,KC,,Home,,
2019120106,2019,13,2019-12-01,Sunday,13:00,PHI,,MIA,,Home,,
2019120107,2019,13,2019-12-01,Sunday,13:00,GB,,NYG,,Home,,
2019120108,2019,13,2019-12-01,Sunday,16:05,LAR,,ARI,,Home,,
2019120109,2019,13,2019-12-01,Sunday,16:25,LAC,,DEN,,Home,,
2019120110,2019,13,2019-12-01,Sunday,16:25,CLE,,PIT,,Home,,
2019120111,2019,13,2019-12-01,Sunday,20:20,NE,,HOU,,Home,,
2019120200,2019,13,2019-12-02,Monday,20:15,MIN,,SEA,,Home,,
2019120500,2019,14,2019-12-05,Thursday,20:20,DAL,,CHI,,Home,,
2019120800,2019,14,2019-12-08,Sunday,13:00,CAR,,ATL,,Home,,
2019120801,2019,14,2019-12-08,Sunday,13:00,BAL,,BUF,,Home,,
2019120802,2019,14,2019-12-08,Sunday,13:00,CIN,,CLE,,Home,,
2019120803,2019,14,2019-12-08,Sunday,13:00,WAS,,GB,,Home,,
2019120804,2019,14,2019-12-08,Sunday,13:00,DEN,,HOU,,Home,,
2019120805,2019,14,2019-12-08,Sunday,13:00,DET,,MIN,,Home,,
2019120806,2019,14,2019-12-08,Sunday,13:00,SF,,NO,,Home,,
2019120807,2019,14,2019-12-08,Sunday,13:00,MIA,,NYJ,,Home,,
2019120808,2019,14,2019-12-08,Sunday,13:00,IND,,TB,,Home,,
2019120809,2019,14,2019-12-08,Sunday,16:05,LAC,,JAX,,Home,,
2019120810,2019,14,2019-12-08,Sunday,16:25,PIT,,ARI,,Home,,
2019120811,2019,14,2019-12-08,Sunday,16:25,KC,,NE,,Home,,
2019120812,2019,14,2019-12-08,Sunday,16:25,TEN,,OAK,,Home,,
2019120813,2019,14,2019-12-08,Sunday,20:20,SEA,,LAR,,Home,,
2019120900,2019,14,2019-12-09,Monday,20:15,NYG,,PHI,,Home,,
2019121200,2019,15,2019-12-12,Thursday,20:20,NYJ,,BAL,,Home,,
2019121500,2019,15,2019-12-15,Sunday,13:00,SEA,,CAR,,Home,,
2019121501,2019,15,2019-12-15,Sunday,13:00,NE,,CIN,,Home,,
2019121502,2019,15,2019-12-15,Sunday,13:00,TB,,DET,,Home,,
2019121503,2019,15,2019-12-15,Sunday,13:00,CHI,,GB,,Home,,
2019121504,2019,15,2019-12-15,Sunday,13:00,DEN,,KC,,Home,,
2019121505,2019,15,2019-12-15,Sunday,13:00,MIA,,NYG,,Home,,
2019121506,2019,15,2019-12-15,Sunday,13:00,BUF,,PIT,,Home,,
2019121507,2019,15,2019-12-15,Sunday,13:00,HOU,,TEN,,Home,,
2019121508,2019,15,2019-12-15,Sunday,13:00,PHI,,WAS,,Home,,
2019121509,2019,15,2019-12-15,Sunday,16:05,CLE,,ARI,,Home,,
2019121510,2019,15,2019-12-15,Sunday,16:05,JAX,,OAK,,Home,,
2019121511,2019,15,2019-12-15,Sunday,16:25,LAR,,DAL,,Home,,
2019121512,2019,15,2019-12-15,Sunday,16:25,ATL,,SF,,Home,,
2019121513,2019,15,2019-12-15,Sunday,20:20,MIN,,LAC,,Home,,
2019121600,2019,15,2019-12-16,Monday,20:15,IND,,NO,,Home,,
2019122200,2019,16,2019-12-22,Sunday,13:00,DET,,DEN,,Home,,
2019122201,2019,16,2019-12-22,Sunday,13:00,OAK,,LAC,,Home,,
2019122202,2019,16,2019-12-22,Sunday,13:00,BUF,,NE,,Home,,
2019122203,2019,16,2019-12-22,Sunday,13:00,LAR,,SF,,Home,,
2019122204,2019,16,2019-12-22,Sunday,13:00,HOU,,TB,,Home,,
2019122205,2019,16,2019-12-22,Sunday,13:00,JAX,,ATL,,Home,,
2019122206,2019,16,2019-12-22,Sunday,13:00,BAL,,CLE,,Home,,
2019122207,2019,16,2019-12-22,Sunday,13:00,CAR,,IND,,Home,,
2019122208,2019,16,2019-12-22,Sunday,13:00,CIN,,MIA,,Home,,
2019122209,2019,16,2019-12-22,Sunday,13:00,PIT,,NYJ,,Home,,
2019122210,2019,16,2019-12-22,Sunday,13:00,NO,,TEN,,Home,,
2019122211,2019,16,2019-12-22,Sunday,13:00,NYG,,WAS,,Home,,
2019122212,2019,16,2019-12-22,Sunday,16:25,DAL,,PHI,,Home,,
2019122213,2019,16,2019-12-22,Sunday,16:25,ARI,,SEA,,Home,,
2019122214,2019,16,2019-12-22,Sunday,20:20,KC,,CHI,,Home,,
2019122300,2019,16,2019-12-23,Monday,20:15,GB,,MIN,,Home,,
2019122900,2019,17,2019-12-29,Sunday,13:00,PIT,,BAL,,Home,,
2019122901,2019,17,2019-12-29,Sunday,13:00,NYJ,,BUF,,Home,,
2019122902,2019,17,2019-12-29,Sunday,13:00,NO,,CAR,,Home,,
2019122903,2019,17,2019-12-29,Sunday,13:00,CLE,,CIN,,Home,,
2019122904,2019,17,2019-12-29,Sunday,13:00,WAS,,DAL,,Home,,
2019122905,2019,17,2019-12-29,Sunday,13:00,GB,,DET,,Home,,
2019122906,2019,17,2019-12-29,Sunday,13:00,TEN,,HOU,,Home,,
2019122907,2019,17,2019-12-29,Sunday,13:00,IND,,JAX,,Home,,
2019122908,2019,17,2019-12-29,Sunday,13:00,LAC,,KC,,Home,,
2019122909,2019,17,2019-12-29,Sunday,13:00,CHI,,MIN,,Home,,
2019122910,2019,17,2019-12-29,Sunday,13:00,MIA,,NE,,Home,,
2019122911,2019,17,2019-12-29,Sunday,13:00,PHI,,NYG,,Home,,
2019122912,2019,17,2019-12-29,Sunday,13:00,ATL,,TB,,Home,,
2019122913,2019,17,2019-12-29,Sunday,16:25,OAK,,DEN,,Home,,
2019122914,2019,17,2019-12-29,Sunday,16:25,ARI,,LAR,,Home,,
2019122915,2019,17,2019-12-29,Sunday,16:25,SF,,SEA,,Home,,
